radio,1 1,2 2,3 3,4 4,5 5,6 6,7 7,8 8 y mas,TOTAL
20010101,32,9,5,5,8,1,1,4,65
20010201,42,32,34,24,15,8,4,2,161
20010202,31,29,22,21,6,11,5,3,128
20010203,23,21,23,15,10,6,0,6,104
20010204,31,23,32,24,23,13,8,9,163
20010205,16,21,20,16,14,5,0,3,95
20010206,46,39,39,33,27,10,10,11,215
20010207,41,38,25,20,13,8,2,4,151
20010208,37,23,21,21,18,17,4,4,145
20010209,29,28,35,29,15,13,5,2,156
20010210,14,19,16,12,10,9,3,5,88
20010211,36,44,48,40,19,7,3,3,200
20010212,63,87,68,70,43,25,6,4,366
20010213,43,34,29,25,18,8,2,3,162
20010214,73,76,48,33,17,8,2,4,261
20010215,90,65,45,33,22,13,5,5,278
20010216,119,133,97,47,31,13,2,2,444
20010217,48,45,48,40,23,14,4,5,227
20010218,26,37,27,26,13,10,5,4,148
20010219,49,51,45,33,9,9,2,2,200
20010301,41,39,33,33,29,14,1,1,191
20010302,26,40,32,33,16,8,4,2,161
20010303,42,39,46,32,14,14,3,10,200
20010304,30,26,24,21,15,8,4,4,132
20010305,85,74,112,77,25,9,25,5,412
20010306,79,66,68,67,34,19,5,3,341
20010307,28,51,29,24,10,3,2,1,148
20010308,47,55,70,33,28,17,3,4,257
20010309,88,88,84,61,34,18,5,2,380
20010310,46,77,58,49,18,9,1,3,261
20010311,67,63,62,37,18,18,0,2,267
20010312,33,47,26,43,20,9,1,2,181
20010313,15,25,31,25,14,5,1,2,118
20010314,28,27,30,33,14,14,1,0,147
20010315,79,82,70,42,19,8,4,6,310
20010316,47,79,56,36,22,8,1,5,254
20010317,32,47,42,28,18,8,3,4,182
20010318,31,52,54,37,29,15,7,6,231
20010319,75,79,69,68,27,13,8,4,343
20010320,17,16,37,19,8,11,4,3,115
20010321,24,35,22,12,7,8,0,1,109
20010322,32,53,43,30,19,13,12,3,205
20010323,59,56,58,31,31,15,14,3,267
20010401,251,197,103,65,30,12,4,1,663
20010402,219,230,84,56,18,9,0,0,616
20010403,163,143,83,46,23,7,4,0,469
20010404,161,191,114,85,40,10,1,2,604
20010405,70,126,83,58,28,13,2,4,384
20010406,95,172,122,63,24,5,4,1,486
20010407,171,152,100,66,41,14,4,1,549
20010408,136,121,98,58,22,13,2,1,451
20010501,79,82,35,35,16,8,1,1,257
20010502,98,66,35,20,11,7,3,0,240
20010503,183,122,48,34,12,4,1,1,405
20010504,155,155,77,55,28,17,1,2,490
20010505,77,68,44,23,18,10,0,2,242
20010506,157,111,44,31,14,7,0,1,365
20010507,95,95,31,34,8,6,1,0,270
20010601,86,111,59,39,21,7,2,1,326
20010602,55,78,31,29,10,4,1,2,210
20010603,123,164,69,33,29,6,2,0,426
20010604,177,114,60,30,14,0,2,0,397
20010605,79,48,29,8,5,0,0,0,169
20010606,81,91,37,29,9,4,1,0,252
20010607,92,64,32,24,10,2,1,2,227
20010608,132,103,32,21,6,0,0,2,296
20010609,110,145,68,54,28,12,2,0,419
20010610,88,61,28,10,2,1,2,1,193
20010701,111,84,40,17,8,3,0,1,264
20010702,56,39,10,8,3,1,0,0,117
20010703,57,44,13,5,4,1,2,0,126
20010704,158,72,30,14,2,1,0,1,278
20010705,81,45,13,7,0,0,0,1,147
20010706,37,25,9,4,4,1,0,0,80
20010707,129,81,24,11,2,2,0,0,249
20010708,127,69,27,12,4,1,0,0,240
20010709,93,60,12,13,5,0,0,0,183
20010710,144,59,21,4,2,1,1,0,232
20010711,92,33,7,6,2,0,0,0,140
20010712,88,50,23,10,3,1,0,0,175
20010713,35,18,6,2,3,0,0,0,64
20010801,87,65,23,7,6,0,0,0,188
20010802,270,172,56,40,25,4,0,0,567
20010803,188,132,65,22,25,8,4,4,448
20010804,151,85,37,11,8,2,1,0,295
20010805,119,67,17,6,4,1,0,0,214
20010806,290,165,72,30,10,4,1,0,572
20010807,206,202,65,49,31,6,0,2,561
20010808,79,56,19,22,4,3,4,2,189
20010809,91,81,43,31,11,0,0,0,257
20010810,93,47,30,11,5,0,0,0,186
20010901,76,54,21,8,1,0,0,1,161
20010902,86,55,29,17,2,3,0,1,193
20010903,101,49,21,16,7,0,0,1,195
20010904,64,37,20,8,4,1,0,0,134
20010905,80,57,22,22,7,3,0,1,192
20010906,92,49,25,8,1,0,0,0,175
20010907,154,86,25,14,6,3,0,0,288
20010908,80,42,16,7,3,1,0,0,149
20010909,123,72,19,10,10,2,1,0,237
20010910,59,37,6,3,3,0,0,0,108
20010911,51,46,12,5,2,0,0,0,116
20010912,42,16,12,4,2,0,0,0,76
20010913,30,60,40,44,20,7,0,0,201
20010914,86,38,9,11,4,0,0,0,148
20010915,71,28,12,5,0,2,0,0,118
20010916,149,89,57,28,11,3,0,0,337
20010917,118,51,21,12,2,2,1,0,207
20010918,90,47,15,10,5,2,0,0,169
20010919,29,17,8,4,3,0,0,0,61
20011001,47,34,16,14,5,4,0,0,120
20011002,153,81,32,10,1,0,0,1,278
20011003,248,154,57,43,10,1,0,2,515
20011004,96,78,28,17,3,0,0,1,223
20011005,92,74,34,20,13,2,0,1,236
20011006,97,104,35,20,5,3,0,1,265
20011007,77,40,24,8,9,1,0,0,159
20011008,76,49,15,8,3,2,0,0,153
20011009,67,48,22,13,7,4,0,0,161
20011010,116,69,53,38,9,8,2,1,296
20011011,192,93,38,20,8,0,0,0,351
20011012,129,103,32,15,10,2,0,0,291
20011013,169,109,38,18,3,2,0,0,339
20011014,55,26,16,10,2,2,0,0,111
20011101,121,64,21,8,3,1,0,1,219
20011102,186,68,19,6,5,0,0,0,284
20011103,126,41,18,6,4,3,0,0,198
20011104,163,103,36,25,5,3,1,0,336
20011105,106,77,33,22,9,2,1,1,251
20011106,110,60,25,10,3,0,1,0,209
20011107,154,85,36,13,7,1,0,0,296
20011108,153,116,49,26,6,3,0,0,353
20011109,81,75,41,15,4,1,1,1,219
20011110,128,77,42,13,7,4,1,0,272
20011111,51,41,13,13,6,2,0,0,126
20011112,174,114,54,44,12,3,2,4,407
20011113,121,97,38,26,7,2,0,0,291
20011114,133,87,43,16,8,2,0,0,289
20011201,48,34,17,11,3,3,0,0,116
20011202,60,49,13,5,0,2,0,0,129
20011203,172,91,35,12,4,0,0,0,314
20011204,133,40,21,9,1,4,1,0,209
20011205,115,82,34,28,7,6,1,2,275
20011206,81,55,28,26,8,3,0,1,202
20011207,154,106,43,22,13,5,1,3,347
20011208,81,37,6,4,0,0,1,0,129
20011209,173,79,49,27,9,4,0,1,342
20011210,51,31,12,6,1,0,0,0,101
20011211,71,27,20,9,6,3,0,0,136
20011212,54,19,11,3,3,0,0,0,90
20011301,32,55,40,19,15,2,0,0,163
20011302,17,26,11,4,2,0,0,0,60
20011303,7,9,3,1,0,0,0,0,20
20011304,41,58,24,10,1,2,0,0,136
20011305,52,68,29,5,0,0,0,0,154
20011306,44,30,17,8,1,0,0,0,100
20011307,71,104,43,18,5,0,0,0,241
20011308,59,60,22,12,3,0,0,0,156
20011309,34,61,38,18,3,3,0,0,157
20011310,48,86,47,29,15,8,2,0,235
20011311,58,42,24,15,2,0,0,1,142
20011312,47,49,26,12,3,1,0,0,138
20011313,40,33,21,10,0,0,0,0,104
20011314,144,145,149,107,66,33,10,5,659
20011315,0,0,0,0,0,0,0,0,0
20011401,118,69,35,13,8,2,2,0,247
20011402,55,50,45,18,27,17,7,7,226
20011403,95,56,20,13,9,2,1,0,196
20011404,19,13,4,2,1,0,0,0,39
20011405,109,48,35,18,10,2,0,4,226
20011406,98,98,42,30,16,6,2,1,293
20011407,94,79,25,12,3,2,0,0,215
20011408,80,61,28,17,6,3,1,0,196
20011409,94,80,40,19,7,6,0,0,246
20011410,99,67,29,17,5,3,0,0,220
20011411,108,79,37,13,8,5,2,1,253
20011412,81,67,38,19,5,5,2,0,217
20011501,67,60,25,13,5,0,0,0,170
20011502,105,79,40,13,9,2,0,1,249
20011503,80,58,37,17,7,0,0,1,200
20011504,128,113,33,43,10,3,4,1,335
20011505,66,59,31,19,7,5,0,0,187
20011506,130,91,43,27,9,3,2,0,305
20011507,112,83,47,13,11,2,1,1,270
20011508,96,89,50,41,20,8,1,5,310
20011509,119,95,61,44,18,10,2,3,352
20011510,119,81,48,25,13,3,1,1,291
20011511,131,74,47,19,6,4,0,0,281
20011601,86,66,19,12,4,1,1,0,189
20011602,81,45,15,13,4,5,1,0,164
20011603,240,109,34,23,6,0,0,1,413
20011604,216,93,25,10,4,0,0,0,348
20011605,74,61,37,18,13,3,1,1,208
20011606,85,63,29,20,19,6,3,3,228
20011607,204,159,68,29,10,2,0,3,475
20011608,79,70,32,21,5,6,4,3,220
20011609,38,60,35,19,6,1,1,0,160
20011610,111,104,43,26,4,2,1,0,291
20011611,84,77,29,15,7,5,0,0,217
20011612,47,43,16,16,5,5,2,5,139
20011701,155,100,61,41,22,9,0,1,389
20011702,118,93,51,22,13,3,1,2,303
20011703,126,99,46,23,20,8,0,2,324
20011704,121,94,42,20,5,5,0,0,287
20011705,101,70,32,33,16,0,4,0,256
20011706,166,125,45,17,6,6,0,2,367
20011707,137,114,49,15,6,1,1,0,323
20011708,118,76,43,16,5,4,4,1,267
20011709,115,78,28,12,3,0,3,0,239
20011710,113,90,35,31,8,2,0,0,279
20011711,84,76,34,18,4,2,0,0,218
20011801,220,131,48,32,6,3,0,2,442
20011802,179,100,41,25,7,4,0,1,357
20011803,118,96,40,22,11,1,2,2,292
20011804,146,94,54,26,13,5,1,2,341
20011805,116,81,41,24,7,4,0,1,274
20011806,182,140,94,50,21,14,2,4,507
20011807,110,88,61,39,10,5,4,0,317
20011808,104,109,43,26,14,3,2,0,301
20011809,119,97,44,24,11,6,0,2,303
20011901,183,112,71,35,13,6,2,2,424
20011902,191,151,93,38,16,9,0,0,498
20011903,38,51,24,18,9,2,2,1,145
20011904,120,89,42,23,14,6,3,6,303
20011905,109,82,43,25,8,3,1,0,271
20011906,104,58,35,8,7,4,0,0,216
20011907,117,114,47,28,13,5,1,0,325
20011908,67,43,25,10,6,7,1,1,160
20011909,84,75,33,21,9,0,1,0,223
20012001,84,83,43,36,11,2,0,0,259
20012002,110,86,47,33,13,4,3,2,298
20012003,66,75,54,34,4,4,0,1,238
20012004,118,118,53,29,15,7,1,2,343
20012005,155,108,46,31,7,4,0,1,352
20012006,139,98,48,32,7,11,0,1,336
20012007,55,84,34,28,1,2,0,3,207
20012008,77,71,26,21,17,3,1,2,218
20012009,81,73,52,24,10,6,1,0,247
20012010,96,82,49,40,24,19,3,3,316
20012101,98,84,46,16,15,5,0,2,266
20012102,88,66,58,32,16,5,0,1,266
20012103,49,61,35,12,7,4,1,1,170
20012104,170,156,85,56,22,5,2,4,500
20012105,96,78,38,36,14,10,2,1,275
20012106,104,85,37,25,10,1,0,2,264
20012107,111,98,62,40,10,8,3,0,332
20012108,86,73,45,24,5,4,1,2,240
20012109,135,95,48,32,14,1,2,1,328
20012110,181,99,44,30,13,4,3,2,376
20012201,100,87,41,19,11,2,0,1,261
20012202,193,139,47,30,9,2,0,2,422
20012203,143,108,59,34,20,4,3,0,371
20012204,89,60,31,17,5,3,1,1,207
20012205,73,65,30,12,5,0,1,0,186
20012206,114,63,46,18,17,1,0,0,259
20012207,118,81,34,22,6,4,2,1,268
20012208,142,80,27,15,9,1,2,0,276
20012209,119,120,62,55,13,6,2,0,377
20012210,230,191,85,41,24,8,1,2,582
20012301,101,86,49,19,13,3,0,1,272
20012302,72,70,44,21,4,6,0,2,219
20012303,161,114,54,32,8,2,1,1,373
20012304,43,42,16,11,8,8,0,3,131
20012305,78,74,43,21,10,2,0,0,228
20012306,80,62,42,20,5,4,1,0,214
20012307,123,68,31,20,11,8,1,3,265
20012308,132,90,47,30,8,7,1,0,315
20012309,143,148,64,29,11,7,2,1,405
20012310,56,45,22,14,7,4,1,1,150
20012401,54,30,13,8,4,3,0,1,113
20012402,74,41,21,6,1,1,0,1,145
20012403,79,61,32,12,8,7,0,1,200
20012404,78,51,25,9,4,1,0,0,168
20012405,71,50,26,13,7,0,0,1,168
20012406,160,119,49,27,7,3,0,0,365
20012407,103,79,38,27,6,6,1,1,261
20012408,55,65,41,14,5,3,0,1,184
20012501,50,64,33,14,6,4,2,2,175
20012502,69,59,26,18,7,0,0,0,179
20012503,100,71,23,20,6,0,0,1,221
20012504,161,135,77,39,15,2,1,0,430
20012505,89,81,31,14,7,2,1,1,226
20012506,144,104,47,32,16,5,3,0,351
20012507,78,60,32,15,5,1,2,0,193
20012508,154,91,48,15,9,3,1,0,321
20012509,51,57,37,31,21,8,6,1,212
20012510,69,71,40,30,11,6,0,0,227
20012511,104,74,32,18,15,8,0,1,252
20012601,108,75,42,14,4,3,2,1,249
20012602,124,106,47,25,11,4,3,0,320
20012603,90,66,33,22,5,1,0,0,217
20012604,80,77,46,29,9,2,0,1,244
20012605,130,77,46,35,14,7,0,1,310
20012606,78,73,31,18,8,6,0,0,214
20012607,53,41,27,11,7,3,0,0,142
20012608,75,80,33,15,6,3,1,0,213
20012609,108,95,63,31,10,6,0,3,316
20012701,70,68,54,23,14,3,1,1,234
20012702,110,72,40,32,10,7,0,4,275
20012703,88,92,50,29,13,11,4,6,293
20012704,117,100,47,32,11,8,5,5,325
20012705,111,81,54,20,12,6,2,2,288
20012706,102,116,60,45,18,14,2,2,359
20012707,65,55,57,42,17,18,5,6,265
20012708,100,70,42,28,10,3,0,2,255
20012709,131,84,53,30,12,13,1,0,324
20012710,107,74,27,27,10,2,1,0,248
20012801,80,63,43,23,4,5,2,0,220
20012802,143,92,57,30,10,9,3,1,345
20012803,64,61,59,26,21,9,0,1,241
20012804,117,77,48,28,4,5,0,1,280
20012805,125,113,58,29,20,3,4,2,354
20012806,110,78,35,33,22,2,1,0,281
20012807,105,97,55,35,12,7,3,0,314
20012808,38,36,21,6,5,1,1,2,110
20012809,78,73,52,33,13,8,3,2,262
20012810,105,99,70,46,13,14,1,5,353
20012811,83,77,42,26,10,9,1,1,249
20012812,82,63,38,31,13,5,2,1,235
20012813,94,74,40,30,14,6,1,2,261
20012901,111,108,92,61,32,13,3,0,420
20012902,98,77,42,24,12,7,3,3,266
20012903,67,71,55,46,22,7,1,7,276
20012904,55,98,59,32,13,13,2,0,272
20012905,110,70,55,36,19,10,5,1,306
20012906,62,72,59,67,43,16,4,0,323
20012907,137,79,56,33,12,5,1,5,328
20012908,77,86,38,34,13,7,3,2,260
20012909,135,96,65,41,30,8,0,1,376
20020101,6,1,3,4,4,1,2,0,21
20020102,17,19,29,26,17,10,7,8,133
20020201,90,91,29,25,13,2,1,1,252
20020202,103,131,50,44,22,9,2,1,362
20020203,62,79,42,26,13,6,1,0,229
20020204,49,65,40,29,12,7,2,1,205
20020205,74,91,54,25,12,1,2,0,259
20020206,53,76,31,17,15,4,1,0,197
20020207,58,43,18,14,5,1,0,2,141
20020208,90,95,43,28,21,5,0,0,282
20020301,138,132,57,47,17,7,1,0,399
20020302,211,124,38,25,8,3,2,0,411
20020303,25,31,17,16,8,2,1,0,100
20020304,83,55,30,14,6,0,0,0,188
20020305,111,85,51,24,13,3,2,4,293
20020306,122,96,28,22,4,1,1,0,274
20020307,107,103,52,51,30,9,0,1,353
20020308,60,78,31,40,15,10,0,0,234
20020401,73,120,47,41,15,16,0,1,313
20020402,46,34,17,7,4,0,0,1,109
20020403,37,49,38,13,10,1,0,1,149
20020404,60,76,26,21,11,1,0,0,195
20020405,88,92,38,33,20,10,1,2,284
20020406,47,74,46,27,10,8,0,0,212
20020407,100,89,23,16,4,3,0,0,235
20020408,163,135,62,40,18,8,0,1,427
20020409,91,114,54,46,22,5,1,0,333
20020410,180,138,57,34,14,7,0,0,430
20020501,86,98,34,21,11,3,2,1,256
20020502,84,87,63,35,32,14,1,3,319
20020503,81,92,37,30,7,6,2,0,255
20020504,74,69,34,29,9,8,3,0,226
20020505,91,115,52,44,13,5,3,1,324
20020506,98,111,53,35,16,13,1,1,328
20020507,107,95,49,51,14,6,3,4,329
20020508,135,88,53,38,8,5,0,1,328
20020509,96,88,38,26,16,4,2,1,271
20020601,65,48,24,11,14,7,5,1,175
20020602,200,189,78,54,31,14,2,4,572
20020603,51,77,37,34,15,6,3,3,226
20020604,100,107,43,46,24,8,2,3,333
20020605,45,53,34,28,16,6,1,0,183
20020606,137,90,48,23,15,2,3,2,320
20020607,73,52,22,12,8,6,1,1,175
20020608,69,64,25,30,19,8,1,3,219
20020609,131,95,30,12,6,2,0,0,276
20020610,104,57,29,25,8,3,2,0,228
20020701,179,189,85,65,31,13,8,3,573
20020702,197,156,56,46,23,10,3,2,493
20020703,109,111,64,40,22,13,2,0,361
20020704,84,85,36,24,23,8,5,2,267
20020705,101,75,26,22,14,5,1,0,244
20020706,101,94,34,22,14,3,1,2,271
20020707,167,125,53,38,17,7,1,1,409
20020708,68,49,31,16,5,2,0,1,172
20020709,120,101,36,12,4,5,0,0,278
20020801,167,99,43,21,12,4,0,1,347
20020802,113,93,40,37,12,6,3,2,306
20020803,208,148,49,38,9,1,2,2,457
20020804,160,160,63,57,27,7,2,2,478
20020805,178,110,54,40,22,7,1,1,413
20020806,249,230,85,35,18,5,2,1,625
20020807,283,238,87,61,17,16,4,1,707
20020808,121,107,55,36,29,8,0,1,357
20020901,165,141,67,19,3,3,0,1,399
20020902,75,62,32,29,15,3,1,1,218
20020903,219,127,56,30,12,6,1,0,451
20020904,180,143,55,47,18,15,2,1,461
20020905,188,168,62,41,21,7,1,0,488
20020906,197,160,43,25,7,5,2,2,441
20020907,219,142,57,36,11,5,1,1,472
20020908,260,201,94,50,31,13,0,0,649
20020909,232,166,63,62,15,10,2,0,550
20021001,259,145,62,36,8,7,2,0,519
20021002,193,114,36,17,5,1,0,0,366
20021003,86,61,34,18,7,3,0,0,209
20021004,124,108,62,29,10,8,2,1,344
20021005,211,115,43,45,10,2,0,0,426
20021006,133,94,47,32,13,2,0,0,321
20021007,233,158,61,20,10,1,0,0,483
20021008,201,146,46,33,10,6,1,0,443
20021009,121,97,43,25,12,0,1,0,299
20021101,293,180,80,45,17,5,0,1,621
20021102,77,78,36,29,19,2,0,0,241
20021103,301,196,79,55,28,11,1,1,672
20021104,255,236,77,72,22,5,1,0,668
20021105,79,65,9,10,4,1,1,0,169
20021106,165,87,31,15,7,0,0,0,305
20021201,179,136,68,37,11,3,1,0,435
20021202,167,123,58,39,15,0,0,0,402
20021203,192,128,74,46,15,1,0,1,457
20021204,351,221,82,40,9,1,0,0,704
20021205,242,214,91,48,13,7,0,0,615
20021206,222,147,76,34,15,1,2,1,498
20021301,252,208,71,46,12,6,0,0,595
20021302,148,155,56,39,16,2,0,2,418
20021303,237,175,54,31,14,5,0,0,516
20021304,232,191,66,41,19,2,3,1,555
20021305,270,184,93,65,22,10,3,0,647
20021306,176,121,45,23,14,2,0,1,382
20021307,314,177,72,45,16,6,3,1,634
20021401,110,77,27,22,11,0,0,1,248
20021402,140,103,38,17,6,0,1,1,306
20021403,71,63,20,16,3,1,1,0,175
20021404,168,108,37,36,16,4,0,0,369
20021405,181,156,68,62,20,9,2,1,499
20021406,212,200,78,30,8,3,1,0,532
20021407,175,103,30,26,11,3,0,0,348
20021408,194,116,30,26,10,3,1,0,380
20021409,198,181,100,73,35,15,1,2,605
20021410,262,165,56,38,9,4,0,3,537
20021501,88,92,44,22,13,5,2,0,266
20021502,167,121,48,27,15,10,0,0,388
20021503,252,182,72,76,36,9,2,1,630
20021504,133,95,45,19,15,2,1,0,310
20021505,112,83,29,30,8,5,0,0,267
20021506,120,81,40,30,8,6,1,0,286
20021507,151,120,44,35,11,5,0,1,367
20021508,117,131,51,29,8,2,0,1,339
20021601,153,90,38,22,14,2,1,1,321
20021602,116,90,48,28,18,6,2,0,308
20021603,117,97,23,34,22,12,0,0,305
20021604,128,100,32,15,7,2,0,0,284
20021605,153,128,42,38,18,4,3,0,386
20021606,110,124,42,26,9,7,0,0,318
20021607,141,116,50,35,14,2,1,0,359
20021608,79,59,22,23,8,5,0,0,196
20021701,225,191,82,33,27,10,2,1,571
20021702,158,115,46,28,20,10,3,2,382
20021703,184,163,55,33,14,4,0,1,454
20021704,81,48,15,12,8,1,3,0,168
20021705,149,89,24,19,5,1,0,3,290
20021706,201,124,55,47,20,4,0,1,452
20021707,255,184,78,38,20,2,0,0,577
20021708,227,160,56,37,5,3,1,0,489
20021709,148,128,47,24,15,3,1,0,366
20021801,224,133,48,30,11,10,1,1,458
20021802,196,193,71,60,21,5,0,2,548
20021803,204,114,40,25,7,6,1,0,397
20021804,125,75,34,26,4,2,0,1,267
20021805,91,75,47,24,9,3,0,1,250
20021806,149,123,57,20,11,6,1,0,367
20021807,111,101,33,24,4,4,0,0,277
20021808,147,107,40,28,8,4,0,1,335
20021901,154,112,67,38,17,3,0,2,393
20021902,107,113,45,16,14,7,1,3,306
20021903,93,105,53,26,20,5,3,0,305
20021904,204,175,68,33,12,3,3,1,499
20021905,159,103,53,34,7,1,2,2,361
20021906,210,149,40,19,4,1,1,0,424
20021907,138,109,30,34,7,5,0,1,324
20021908,159,114,57,29,7,6,4,1,377
20022001,178,146,69,44,15,4,1,0,457
20022002,207,167,40,24,10,1,0,0,449
20022003,181,124,42,16,5,3,1,0,372
20022004,153,137,44,29,11,8,1,3,386
20022005,118,70,39,10,9,2,1,2,251
20022006,186,104,33,24,6,3,0,0,356
20022007,102,75,31,21,10,6,2,0,247
20022008,130,83,47,23,11,7,0,0,301
20022101,163,147,60,53,28,10,0,1,462
20022102,150,162,61,49,15,4,1,0,442
20022103,140,127,54,32,11,1,3,1,369
20022104,219,182,74,37,16,2,0,0,530
20022105,235,151,74,34,9,5,0,0,508
20022106,227,151,64,27,8,2,1,1,481
20022201,178,112,42,24,8,2,2,0,368
20022202,127,85,47,17,3,1,1,0,281
20022203,80,63,28,24,8,1,1,0,205
20022204,239,141,57,30,13,2,1,0,483
20022205,198,185,80,46,15,3,0,1,528
20022206,265,190,58,33,4,5,2,0,557
20022301,178,140,66,35,11,4,0,1,435
20022302,216,164,74,39,11,8,0,0,512
20022303,167,159,50,49,11,4,0,1,441
20022304,144,124,56,36,17,2,1,1,381
20022305,98,103,45,35,13,1,0,0,295
20022306,76,75,34,12,6,0,0,0,203
20022307,101,83,28,21,3,1,0,0,237
20022308,39,74,50,14,8,2,0,0,187
20022309,185,161,56,41,16,4,0,0,463
20022401,138,163,73,56,15,5,0,0,450
20022402,146,123,57,35,12,4,0,0,377
20022403,108,103,58,37,18,8,3,0,335
20022404,194,155,73,28,13,0,1,0,464
20022405,247,158,57,34,8,2,0,0,506
20022406,180,153,72,52,10,0,0,1,468
20022501,149,108,30,16,7,1,0,1,312
20022502,168,110,39,24,2,6,0,0,349
20022503,81,59,27,9,0,1,0,0,177
20022504,219,135,36,27,8,2,0,0,427
20022505,230,143,58,29,8,1,0,0,469
20022506,190,111,29,18,4,2,1,0,355
20022507,165,128,47,29,14,1,2,0,386
20022508,204,174,68,49,16,12,0,0,523
20022509,185,131,66,20,5,3,1,0,411
20022510,128,89,46,22,12,1,1,0,299
20022511,233,150,65,34,13,5,1,0,501
20030101,210,140,68,41,17,9,0,3,488
20030102,168,123,82,25,14,5,0,2,419
20030103,202,147,49,46,11,8,3,1,467
20030104,111,83,28,17,5,0,2,2,248
20030105,116,117,64,48,17,7,2,3,374
20030106,93,62,38,25,21,13,4,6,262
20030107,125,86,54,48,18,15,1,0,347
20030108,65,48,28,24,17,2,3,1,188
20030109,94,75,31,18,8,1,0,0,227
20030110,66,61,29,24,6,5,1,0,192
20030111,108,68,29,14,4,5,2,0,230
20030201,111,108,51,29,9,9,3,3,323
20030202,138,105,44,33,10,1,0,2,333
20030203,156,98,36,27,9,7,3,0,336
20030204,102,91,47,24,16,2,1,5,288
20030205,141,110,52,29,17,10,4,6,369
20030206,103,116,66,46,21,9,2,4,367
20030207,148,130,67,37,9,13,7,9,420
20030208,124,97,62,32,19,12,4,4,354
20030209,102,85,50,35,16,9,2,12,311
20030210,87,54,19,14,6,8,1,4,193
20030211,91,78,35,32,14,3,1,3,257
20030212,136,96,61,43,15,12,1,1,365
20030301,166,160,75,34,16,11,9,5,476
20030302,135,128,57,23,17,4,3,6,373
20030303,84,89,39,26,12,4,3,3,260
20030304,60,66,47,26,7,5,2,0,213
20030305,95,84,35,17,3,2,3,6,245
20030306,105,101,40,25,11,13,2,5,302
20030307,81,100,56,34,20,9,5,3,308
20030308,69,86,43,23,17,14,4,7,263
20030309,95,28,20,9,5,1,1,0,159
20030310,159,87,57,45,22,13,5,5,393
20030311,97,36,62,60,38,0,12,0,305
20030401,149,104,54,31,9,2,4,1,354
20030402,74,74,34,16,9,5,1,3,216
20030403,98,101,40,28,9,3,0,0,279
20030404,105,90,76,35,10,5,4,1,326
20030405,106,87,37,26,17,9,3,3,288
20030406,119,104,40,30,10,2,1,2,308
20030407,86,83,41,34,14,3,2,7,270
20030408,76,66,54,44,17,9,2,3,271
20030501,143,119,58,33,12,3,4,1,373
20030502,86,118,44,26,12,5,0,0,291
20030503,187,146,82,40,7,2,3,2,469
20030504,106,85,37,21,9,2,2,0,262
20030505,156,111,37,16,5,4,0,1,330
20030506,94,69,24,19,3,3,2,1,215
20030507,150,118,47,34,15,1,1,2,368
20030601,140,121,56,25,9,2,0,1,354
20030602,71,61,23,13,5,2,0,0,175
20030603,140,96,37,25,12,2,0,0,312
20030604,152,94,40,23,8,3,0,0,320
20030605,147,96,43,27,8,2,4,2,329
20030606,113,81,42,11,3,3,0,2,255
20030607,96,116,63,23,12,1,0,1,312
20030701,46,40,26,16,7,1,0,0,136
20030702,157,146,59,36,10,5,2,0,415
20030703,199,143,62,31,9,8,1,0,453
20030704,168,128,38,26,7,1,1,0,369
20030705,132,94,25,13,1,2,1,0,268
20030706,136,76,42,19,8,0,1,1,283
20030707,255,155,45,31,12,5,1,0,504
20030708,59,51,20,22,5,1,1,0,159
20030709,176,123,53,37,9,5,0,1,404
20030801,141,103,35,25,10,5,1,1,321
20030802,66,55,37,26,16,8,2,2,212
20030803,103,101,59,49,19,7,1,2,341
20030804,53,82,36,30,10,2,3,1,217
20030805,75,67,34,25,10,4,0,1,216
20030806,71,53,39,26,7,5,2,0,203
20030807,54,45,27,24,7,3,2,4,166
20030808,55,67,42,22,13,5,1,2,207
20030809,102,89,51,39,17,2,1,3,304
20030810,112,64,38,29,6,7,0,0,256
20030901,148,122,56,32,18,8,0,4,388
20030902,69,70,33,20,7,4,1,2,206
20030903,126,119,42,33,10,5,2,5,342
20030904,124,127,70,50,25,14,3,1,414
20030905,68,64,41,18,8,13,5,5,222
20030906,65,57,34,22,13,4,0,1,196
20030907,92,86,48,30,13,17,2,4,292
20030908,117,107,46,23,13,4,1,1,312
20030909,137,125,49,44,14,2,0,0,371
20030910,120,91,44,41,18,9,1,2,326
20031001,151,133,49,28,7,7,0,2,377
20031002,100,93,55,43,15,12,2,3,323
20031003,83,78,39,32,14,7,0,4,257
20031004,98,83,50,37,18,9,3,0,298
20031005,73,58,35,23,8,5,0,0,202
20031006,124,103,74,46,28,11,0,4,390
20031007,122,114,51,36,11,4,0,2,340
20031008,94,88,51,25,8,5,1,2,274
20031101,133,118,63,36,8,4,2,3,367
20031102,197,141,64,34,14,3,1,0,454
20031103,147,117,58,34,16,8,2,2,384
20031104,147,118,48,44,17,10,2,0,386
20031105,108,96,67,34,6,4,1,0,316
20031106,194,118,60,29,10,4,0,0,415
20031107,203,140,57,27,9,1,0,0,437
20031108,115,95,40,19,10,3,1,1,284
20031201,155,112,49,22,8,3,1,0,350
20031202,161,144,67,36,13,5,2,0,428
20031203,156,92,30,18,10,2,2,0,310
20031204,116,76,32,15,7,3,0,0,249
20031205,227,160,60,28,11,3,2,0,491
20031206,20,16,16,4,5,2,2,1,66
20031207,206,143,65,32,12,5,2,1,466
20031208,150,79,33,15,10,3,1,0,291
20031209,93,72,27,15,4,3,0,0,214
20031210,134,97,63,41,15,10,2,1,363
20031301,90,103,58,34,17,3,0,0,305
20031302,137,111,50,37,16,4,0,1,356
20031303,153,133,69,24,9,4,1,0,393
20031304,64,66,44,20,10,2,1,1,208
20031305,162,96,40,14,8,4,4,1,329
20031306,122,84,60,35,15,3,2,2,323
20031307,79,86,40,30,14,1,1,0,251
20031308,95,79,35,24,5,2,1,0,241
20031309,167,110,50,27,12,3,0,0,369
20031310,131,81,43,41,9,8,2,0,315
20031311,93,83,45,26,10,9,0,1,267
20031401,146,96,54,29,13,4,2,2,346
20031402,167,118,60,45,21,4,0,3,418
20031403,158,139,83,36,23,11,3,1,454
20031404,88,95,51,39,14,9,3,0,299
20031405,127,117,55,38,13,9,2,4,365
20031406,199,160,75,51,20,4,3,2,514
20031407,80,77,40,43,11,7,0,1,259
20031408,116,102,48,29,13,3,2,3,316
20031409,14,14,7,2,4,2,0,0,43
20031410,132,93,45,27,8,4,4,0,313
20031501,103,85,42,34,9,9,0,0,282
20031502,145,124,65,42,15,7,0,1,399
20031503,80,86,54,33,9,6,1,2,271
20031504,104,114,54,41,19,1,1,0,334
20031505,166,127,51,26,7,5,0,0,382
20031506,141,110,58,35,9,4,3,2,362
20031507,252,184,85,57,12,8,2,0,600
20031508,248,204,90,62,10,2,0,1,617
20031509,46,39,20,5,5,1,0,0,116
20031601,136,109,68,33,18,6,0,5,375
20031602,167,169,90,52,18,8,0,0,504
20031603,134,122,60,45,22,3,1,1,388
20031604,54,62,26,17,13,3,3,0,178
20031605,80,82,53,29,12,10,0,1,267
20031606,90,79,46,35,8,11,2,4,275
20031607,89,90,71,31,17,8,4,2,312
20031608,113,110,58,37,15,5,1,0,339
20031609,179,151,82,65,19,7,3,1,507
20031701,78,73,48,43,14,9,2,0,267
20031702,102,91,59,45,18,6,3,1,325
20031703,74,70,36,19,5,2,1,1,208
20031704,104,77,52,54,24,10,3,8,332
20031705,131,86,48,37,12,4,3,3,324
20031706,117,103,55,34,9,7,1,1,327
20031707,94,104,77,37,15,10,2,5,344
20031708,112,110,82,39,20,10,5,5,383
20031709,76,91,52,37,13,8,1,3,281
20031801,88,91,32,26,13,4,2,0,256
20031802,104,85,44,40,12,11,4,2,302
20031803,60,61,25,20,14,6,2,1,189
20031804,143,128,57,39,9,1,0,0,377
20031805,52,57,39,13,4,4,1,1,171
20031806,80,66,50,35,12,9,0,3,255
20031807,101,85,38,30,11,8,0,2,275
20031808,100,80,40,23,6,3,1,1,254
20031809,132,123,67,55,14,3,0,1,395
20031810,55,58,35,34,12,9,4,1,208
20031811,72,84,42,31,15,3,2,0,249
20031901,155,191,89,52,15,9,2,3,516
20031902,66,49,18,16,3,0,0,0,152
20031903,122,109,48,21,7,3,0,0,310
20031904,99,83,50,41,9,6,3,4,295
20031905,117,93,69,39,14,9,2,1,344
20031906,109,112,56,35,15,4,2,3,336
20031907,144,131,68,36,22,4,5,3,413
20031908,162,171,71,57,21,13,2,2,499
20031909,114,81,53,38,12,3,1,2,304
20031910,87,65,44,32,6,1,1,0,236
20032001,163,82,35,26,6,5,1,0,318
20032002,187,166,50,28,6,5,0,2,444
20032003,150,96,36,24,7,1,0,1,315
20032004,112,96,46,20,7,6,1,2,290
20032005,90,77,35,20,8,1,1,0,232
20032006,51,54,38,32,5,5,3,1,189
20032007,131,101,53,40,12,11,0,1,349
20032008,150,120,56,39,7,6,2,0,380
20032009,170,154,76,35,15,6,0,2,458
20032010,94,107,49,26,5,4,0,2,287
20032011,109,73,23,23,6,3,1,1,239
20032101,100,128,77,44,18,6,1,2,376
20032102,124,134,76,38,15,9,0,1,397
20032103,90,113,66,25,10,3,1,0,308
20032104,134,102,56,34,11,9,1,0,347
20032105,66,75,37,31,6,3,0,1,219
20032106,164,121,50,29,15,7,0,1,387
20032107,79,66,35,16,3,0,0,0,199
20032108,113,99,49,38,10,5,0,0,314
20032109,67,64,28,14,9,6,0,0,188
20032110,148,116,76,46,16,7,4,3,416
20032201,113,105,72,36,9,3,1,3,342
20032202,103,97,45,33,10,1,4,1,294
20032203,69,48,31,22,5,6,0,0,181
20032204,90,94,32,21,6,1,0,2,246
20032205,140,99,67,33,15,4,0,1,359
20032206,109,79,47,44,15,6,0,2,302
20032207,131,79,67,35,11,3,1,3,330
20032208,123,97,70,52,21,11,0,1,375
20032209,118,101,59,57,17,18,3,0,373
20032301,94,104,72,40,10,4,4,2,330
20032302,112,115,61,39,12,4,1,3,347
20032303,114,133,67,41,7,5,0,0,367
20032304,66,61,28,18,10,4,2,2,191
20032305,104,109,41,18,17,2,0,0,291
20032306,67,70,49,36,14,3,1,2,242
20032307,86,80,50,38,14,4,0,2,274
20032308,105,92,59,40,31,9,0,0,336
20032309,67,98,78,53,26,13,4,3,342
20032310,101,111,87,57,23,13,3,2,397
20032401,116,92,57,26,6,4,1,1,303
20032402,94,99,67,39,24,10,2,1,336
20032403,89,93,52,25,11,5,1,0,276
20032404,112,87,64,30,12,6,0,0,311
20032405,78,63,50,20,6,6,0,2,225
20032406,105,113,71,56,19,7,2,2,375
20032407,90,96,67,32,9,3,0,0,297
20032408,115,89,44,46,17,6,2,1,320
20032409,58,46,47,24,6,3,0,1,185
20032501,141,160,113,75,19,2,0,0,510
20032502,97,80,62,32,12,9,2,1,295
20032503,62,54,41,28,8,12,0,2,207
20032504,95,80,43,33,12,5,2,2,272
20032505,91,82,50,52,15,1,3,2,296
20032506,77,95,66,55,27,12,5,0,337
20032507,74,78,35,25,10,1,4,1,228
20032508,295,189,118,73,27,9,1,4,716
20032509,100,98,67,33,12,7,1,1,319
20032601,149,126,70,34,14,1,3,1,398
20032602,111,137,65,81,32,8,2,4,440
20032603,111,109,65,30,7,9,3,0,334
20032604,77,75,33,27,12,3,0,0,227
20032605,107,108,56,48,9,7,4,2,341
20032606,76,66,57,28,8,9,2,0,246
20032607,77,97,62,46,22,4,2,2,312
20032608,79,73,44,30,13,5,2,0,246
20032609,71,75,58,62,14,11,1,0,292
20032701,136,106,75,54,19,7,2,1,400
20032702,86,100,66,47,23,6,0,2,330
20032703,98,101,77,43,18,13,5,0,355
20032704,76,84,70,49,25,6,1,2,313
20032705,95,89,67,43,16,3,1,3,317
20032706,72,75,71,49,29,8,2,0,306
20032707,91,115,77,53,20,10,0,1,367
20040101,42,61,50,48,26,14,2,4,247
20040102,57,73,41,39,30,16,2,5,263
20040103,51,50,43,34,19,10,3,5,215
20040104,27,50,54,45,39,13,5,3,236
20040105,30,37,55,51,32,23,1,5,234
20040106,29,44,34,44,27,14,8,6,206
20040107,34,43,27,34,17,7,2,4,168
20040108,43,49,48,44,30,9,0,2,225
20040109,49,55,49,38,20,5,4,4,224
20040110,23,46,23,37,18,5,2,3,157
20040111,52,44,32,39,16,10,1,6,200
20040112,36,51,39,30,16,7,3,1,183
20040113,28,31,30,23,15,7,1,1,136
20040114,40,53,48,44,29,16,6,0,236
20040201,53,87,58,45,18,9,4,0,274
20040202,56,84,59,43,27,7,0,6,282
20040203,127,100,63,46,23,15,5,4,383
20040204,52,70,57,58,21,9,6,0,273
20040205,63,55,47,33,19,12,0,2,231
20040206,54,92,40,42,19,8,2,0,257
20040207,66,94,63,49,21,10,5,6,314
20040208,38,55,42,32,16,5,0,1,189
20040209,41,56,41,32,24,11,3,1,209
20040210,55,71,55,59,38,22,5,11,316
20040301,67,98,68,71,21,10,3,4,342
20040302,69,72,62,58,17,7,6,6,297
20040303,43,56,43,51,16,10,1,1,221
20040304,54,80,60,55,29,12,3,5,298
20040305,63,99,74,76,31,11,4,3,361
20040306,47,84,66,48,27,15,4,5,296
20040307,35,67,52,42,19,10,2,2,229
20040308,49,69,61,56,24,8,2,6,275
20040309,23,49,48,33,16,9,1,4,183
20040310,63,90,44,51,30,13,1,1,293
20040311,65,86,67,56,15,6,5,7,307
20040312,58,95,60,64,34,17,7,6,341
20040313,34,61,35,34,18,9,2,4,197
20040401,49,74,50,33,18,10,0,2,236
20040402,63,105,62,51,10,3,1,0,295
20040403,64,90,75,50,28,7,3,3,320
20040404,63,77,72,71,29,11,5,2,330
20040405,79,101,70,74,26,13,3,0,366
20040406,75,65,63,45,25,7,4,2,286
20040407,81,95,65,54,18,11,2,3,329
20040408,62,91,56,44,24,8,2,1,288
20040409,58,65,64,51,30,11,4,2,285
20040410,72,101,41,40,12,5,2,0,273
20040411,74,106,61,56,32,8,2,5,344
20040501,112,116,64,45,20,10,2,0,369
20040502,71,93,42,28,17,8,0,1,260
20040503,89,102,79,45,12,2,1,1,331
20040504,75,79,57,44,19,1,2,2,279
20040505,74,59,44,19,4,3,0,0,203
20040506,89,106,75,43,21,11,2,2,349
20040507,38,75,60,52,17,6,0,3,251
20040508,50,70,43,47,19,9,7,2,247
20040509,116,129,112,125,63,37,27,25,634
20040510,84,80,75,77,46,17,7,11,397
20040511,71,88,62,59,40,8,4,8,340
20040601,130,119,77,58,28,15,3,1,431
20040602,91,93,72,40,15,5,3,1,320
20040603,66,78,71,49,10,8,2,1,285
20040604,49,91,71,62,32,9,2,4,320
20040605,76,82,43,36,18,15,4,1,275
20040606,93,125,76,54,21,5,1,0,375
20040607,90,103,46,41,18,8,2,2,310
20040608,51,93,77,56,24,9,5,2,317
20040609,68,83,52,47,18,4,1,1,274
20040610,62,64,44,37,5,3,0,0,215
20040611,49,81,57,34,14,11,0,0,246
20040701,72,89,68,45,19,4,5,2,304
20040702,54,99,67,52,15,2,1,0,290
20040703,74,91,57,43,20,10,4,3,302
20040704,198,262,172,114,34,23,10,1,814
20040705,76,82,64,52,16,6,1,0,297
20040706,64,63,52,62,31,12,1,2,287
20040707,80,100,75,39,10,7,2,1,314
20040708,88,84,61,28,16,7,1,1,286
20040709,69,85,53,46,11,6,2,1,273
20040710,111,87,50,27,9,2,0,1,287
20040711,58,52,45,33,10,8,2,4,212
20040712,81,68,47,39,20,15,1,1,272
20040801,97,102,51,29,15,10,0,0,304
20040802,80,97,74,38,15,6,0,1,311
20040803,56,77,55,32,9,7,1,3,240
20040804,73,77,64,43,19,10,5,2,293
20040805,80,91,63,27,7,0,0,0,268
20040806,69,86,51,37,21,7,3,0,274
20040807,174,202,174,159,75,35,7,11,837
20040808,21,16,16,18,15,9,0,2,97
20040809,65,91,65,61,31,21,8,8,350
20040810,45,47,50,44,29,16,4,3,238
20040811,43,66,64,57,28,14,3,6,281
20040901,88,92,93,92,48,32,8,10,463
20040902,55,58,59,39,22,11,6,4,254
20040903,45,48,34,30,18,5,3,3,186
20040904,34,51,36,30,15,7,3,0,176
20040905,37,54,41,29,18,9,0,1,189
20040906,44,78,62,52,25,10,5,3,279
20040907,40,77,63,44,22,11,3,3,263
20041001,4,6,6,3,3,0,0,1,23
20041002,159,145,153,92,56,41,2,13,661
20041003,84,124,103,74,68,29,14,11,507
20041004,26,15,26,21,11,12,5,8,124
20041005,107,126,91,75,56,33,19,12,519
20041006,57,62,67,56,30,18,5,11,306
20041007,52,50,57,54,30,16,5,9,273
20041008,69,105,122,96,54,32,7,7,492
20041009,109,119,137,110,65,54,13,17,624
20041101,74,55,61,54,26,16,4,3,293
20041102,73,101,74,52,21,5,1,0,327
20041103,58,83,60,46,20,10,3,2,282
20041104,65,71,55,35,15,8,0,1,250
20041105,57,53,32,29,9,2,3,0,185
20041106,56,86,73,56,32,11,3,3,320
20041107,54,75,83,49,37,17,4,9,328
20041108,63,75,61,73,23,16,0,2,313
20041109,50,57,55,42,30,26,3,6,269
20041201,83,50,43,22,16,9,2,4,229
20041202,59,71,37,31,9,6,2,1,216
20041203,94,95,51,35,20,6,1,0,302
20041204,89,126,67,47,22,14,2,4,371
20041205,55,69,48,34,17,4,1,3,231
20041206,45,57,47,47,26,20,5,2,249
20041207,41,27,32,23,16,13,2,3,157
20041208,65,60,29,22,5,3,0,0,184
20041209,95,102,57,33,15,9,0,1,312
20041210,51,82,50,48,22,19,4,8,284
20041211,62,93,54,39,8,2,2,0,260
20041212,60,62,45,36,14,4,2,0,223
20041301,85,115,81,51,11,11,1,2,357
20041302,60,70,53,40,9,6,1,1,240
20041303,69,72,62,30,10,6,3,1,253
20041304,76,86,34,22,7,0,0,1,226
20041305,94,137,84,48,24,4,0,0,391
20041306,50,48,41,39,19,2,2,3,204
20041307,124,134,81,46,11,4,0,0,400
20041308,51,63,31,14,9,5,0,1,174
20041309,39,70,31,19,8,2,1,0,170
20041310,55,66,36,32,10,3,0,0,202
20041311,102,154,91,65,25,8,1,2,448
20041401,95,78,54,22,15,2,3,3,272
20041402,92,84,33,33,9,5,2,1,259
20041403,94,87,40,33,16,6,0,1,277
20041404,165,156,98,48,21,7,0,0,495
20041405,106,100,49,31,9,5,1,1,302
20041406,61,66,39,32,6,3,0,1,208
20041407,68,90,59,43,19,8,0,2,289
20041408,123,127,77,53,14,10,6,0,410
20041409,64,88,41,50,13,6,0,0,262
20041501,85,61,57,36,14,4,0,2,259
20041502,224,226,101,55,15,3,0,0,624
20041503,151,170,94,54,11,2,0,1,483
20041504,86,91,60,35,14,6,3,2,297
20041505,54,79,39,28,14,4,1,0,219
20041506,78,66,42,30,12,7,4,1,240
20041507,83,86,56,33,9,5,2,0,274
20041508,83,74,45,43,18,6,1,0,270
20041509,55,89,50,34,15,9,1,1,254
20041510,49,51,28,33,13,9,1,4,188
20041601,62,82,60,25,17,9,0,4,259
20041602,368,302,140,76,26,13,4,0,929
20041603,80,131,96,66,45,16,2,2,438
20041604,81,85,50,28,14,3,3,3,267
20041605,141,126,66,46,18,8,4,3,412
20041606,93,65,46,34,5,3,0,2,248
20041607,43,42,34,22,9,4,1,1,156
20041608,56,54,47,23,27,8,2,2,219
20041609,134,113,94,53,22,8,4,3,431
20041610,64,79,50,49,20,13,3,2,280
20041701,37,90,34,44,14,2,0,0,221
20041702,83,68,32,31,15,7,1,3,240
20041703,58,62,37,32,16,8,1,3,217
20041704,96,96,52,35,12,4,1,0,296
20041705,94,123,55,36,14,4,1,1,328
20041706,100,96,39,32,10,2,0,1,280
20041707,69,92,44,36,7,5,1,1,255
20041708,98,89,62,53,33,14,3,6,358
20041709,116,106,57,38,17,1,1,1,337
20041710,54,62,66,47,21,19,5,6,280
20041801,36,4,1,2,1,0,0,1,45
20041901,70,73,49,30,16,13,2,2,255
20041902,57,64,48,55,26,7,2,0,259
20041903,86,86,48,58,26,8,6,5,323
20041904,85,81,73,69,40,17,4,6,375
20041905,75,70,61,36,20,15,3,6,286
20041906,78,73,74,63,38,24,3,10,363
20041907,73,50,49,45,33,21,5,11,287
20041908,84,104,92,80,38,27,14,20,459
20041909,69,66,68,47,41,29,9,10,339
20041910,85,71,50,33,16,4,1,3,263
20042001,72,90,55,53,30,16,8,0,324
20042002,72,60,48,47,17,6,2,5,257
20042003,58,66,60,46,26,16,6,3,281
20042004,50,65,44,33,18,9,1,1,221
20042005,26,44,36,46,24,27,3,5,211
20042006,82,65,62,47,25,16,3,5,305
20042007,66,69,53,59,22,13,4,4,290
20042008,39,59,51,39,27,15,4,9,243
20042009,63,82,56,46,23,16,2,5,293
20042010,76,84,71,63,36,18,8,8,364
20042011,75,84,68,45,28,18,3,2,323
20042012,142,124,91,79,26,5,2,2,471
20042101,54,77,44,30,21,11,1,7,245
20042102,60,56,53,47,24,14,2,7,263
20042103,58,49,44,28,16,7,1,4,207
20042104,59,49,44,51,22,12,8,4,249
20042105,65,63,38,37,18,13,1,3,238
20042106,67,70,55,47,16,13,2,0,270
20042107,59,69,56,38,25,18,2,8,275
20042108,49,75,50,48,33,18,9,12,294
20042109,46,54,45,42,37,17,6,6,253
20042110,52,43,53,45,18,14,5,4,234
20042111,55,57,58,50,28,22,4,7,281
20042112,56,40,31,29,11,16,3,4,190
20042201,90,75,45,30,11,4,1,1,257
20042202,91,79,54,45,22,2,1,3,297
20042203,90,108,72,59,14,7,1,1,352
20042204,103,167,100,78,33,10,2,2,495
20042205,72,74,65,37,22,10,0,4,284
20042206,63,97,48,40,4,3,0,0,255
20042207,133,129,75,43,19,2,0,1,402
20042208,86,106,78,42,34,10,3,4,363
20042209,64,76,51,43,15,7,0,3,259
20042210,65,76,39,26,16,5,1,1,229
20042211,90,77,57,34,20,9,2,1,290
20042212,48,60,41,43,17,7,1,1,218
20042301,43,76,52,50,30,18,1,2,272
20042302,51,81,56,57,24,14,3,2,288
20042303,47,69,43,48,27,11,8,5,258
20042304,50,56,60,53,23,13,5,5,265
20042305,79,61,37,30,12,6,1,1,227
20042306,102,105,53,22,17,2,2,1,304
20042307,62,66,29,45,12,13,4,2,233
20042308,50,78,72,50,23,11,4,0,288
20042309,31,28,34,27,16,9,3,2,150
20042310,47,69,47,40,34,13,4,5,259
20042311,64,43,39,24,21,9,4,2,206
20042312,46,60,46,40,17,16,4,3,232
20042401,74,88,82,74,39,32,9,17,415
20042402,94,97,106,105,66,39,15,16,538
20042403,91,74,57,53,44,30,13,11,373
20042404,84,98,99,96,80,33,17,27,534
20042405,87,87,71,57,37,44,9,14,406
20042406,40,68,81,67,48,47,15,11,377
20042501,99,146,144,122,84,63,13,17,688
20042502,79,116,137,117,86,60,14,15,624
20042503,179,186,228,196,139,72,13,80,1093
20042504,102,104,109,95,59,64,24,16,573
20042601,20,48,54,53,40,30,6,10,261
20042602,30,50,47,45,32,29,21,29,283
20042603,47,60,56,73,58,28,11,7,340
20050101,111,72,39,23,6,2,0,0,253
20050102,140,151,60,46,11,3,0,0,411
20050103,145,116,49,31,9,4,4,3,361
20050104,120,93,49,35,13,3,1,0,314
20050105,136,171,88,51,15,9,1,1,472
20050106,93,69,16,19,8,2,2,0,209
20050107,117,102,46,26,5,5,1,0,302
20050108,105,107,58,37,11,4,0,1,323
20050109,147,117,47,26,8,3,1,0,349
20050110,119,95,55,30,8,5,0,0,312
20050201,119,122,51,31,9,3,0,1,336
20050202,103,77,43,23,15,9,0,0,270
20050203,128,102,58,25,10,1,0,1,325
20050204,183,159,63,37,16,2,0,1,461
20050205,86,72,28,27,6,1,0,2,222
20050206,91,69,49,27,16,4,0,2,258
20050207,113,68,24,23,9,5,3,1,246
20050208,120,130,77,80,20,6,0,0,433
20050209,99,109,56,49,14,6,3,3,339
20050210,104,102,41,39,12,1,0,2,301
20050211,148,127,65,34,13,6,1,0,394
20050301,100,114,55,34,11,1,1,4,320
20050302,172,168,92,54,8,10,2,1,507
20050303,94,31,21,16,6,7,2,0,177
20050304,72,82,39,25,9,5,1,2,235
20050305,129,108,52,33,14,0,0,0,336
20050306,124,89,45,32,8,4,1,0,303
20050307,138,94,29,31,4,1,0,0,297
20050308,61,57,17,18,7,1,1,1,163
20050309,129,102,43,30,3,1,1,0,309
20050310,89,73,37,27,10,4,1,0,241
20050311,141,124,63,41,8,7,1,1,386
20050401,156,147,65,36,10,4,2,0,420
20050402,120,127,57,36,6,0,1,0,347
20050403,118,109,43,30,13,3,2,1,319
20050404,161,96,43,25,13,2,1,0,341
20050405,129,107,48,32,12,1,1,1,331
20050406,213,154,72,45,15,3,1,1,504
20050407,82,95,36,31,7,1,0,1,253
20050408,179,204,67,44,15,3,2,2,516
20050409,128,101,55,31,13,4,3,2,337
20050501,126,94,62,51,13,1,0,1,348
20050502,182,194,122,64,22,7,1,0,592
20050503,164,112,55,30,8,1,0,0,370
20050504,88,72,60,43,18,6,1,0,288
20050505,81,59,53,30,14,5,1,1,244
20050506,123,102,43,36,8,2,1,0,315
20050507,173,126,67,36,15,4,1,0,422
20050508,113,112,47,31,19,1,1,0,324
20050601,79,111,48,45,16,3,1,1,304
20050602,143,137,76,66,10,3,2,0,437
20050603,181,143,61,41,10,1,1,0,438
20050604,215,226,98,89,28,4,0,0,660
20050605,215,201,82,42,11,2,4,1,558
20050606,139,124,82,42,16,3,0,1,407
20050607,157,142,55,42,16,5,0,1,418
20050608,109,132,65,55,16,6,0,2,385
20050701,193,159,101,55,12,6,2,1,529
20050702,71,68,34,32,9,2,4,2,222
20050703,84,90,51,37,9,5,0,0,276
20050704,231,185,91,65,21,8,1,3,605
20050705,261,184,96,56,13,4,3,1,618
20050706,138,80,39,28,10,4,1,0,300
20050707,76,60,28,21,7,3,1,0,196
20050708,148,114,59,45,22,5,1,0,394
20050801,195,187,87,60,11,4,2,1,547
20050802,105,106,64,33,10,2,0,0,320
20050803,138,186,96,55,20,5,2,2,504
20050804,169,158,57,48,16,4,1,1,454
20050805,58,49,36,25,6,0,1,0,175
20050806,154,139,52,34,13,1,0,1,394
20050807,149,139,67,30,9,3,0,2,399
20050808,127,89,67,50,10,10,0,0,353
20050809,108,113,66,31,12,3,0,0,333
20050901,152,173,70,59,11,7,0,0,472
20050902,101,100,52,27,6,1,0,0,287
20050903,92,93,46,27,9,1,0,0,268
20050904,76,84,31,26,10,1,3,1,232
20050905,89,81,50,29,7,4,0,0,260
20050906,81,78,41,27,10,5,0,3,245
20050907,78,73,34,25,5,1,4,0,220
20050908,178,145,71,43,14,3,0,0,454
20050909,167,139,77,38,11,4,1,1,438
20050910,118,97,60,35,18,11,1,1,341
20051001,189,185,84,56,19,5,0,0,538
20051002,230,181,81,37,15,4,0,0,548
20051003,49,57,26,22,2,6,0,2,164
20051004,75,107,36,22,12,2,0,0,254
20051005,134,77,33,14,10,1,0,0,269
20051006,91,102,67,31,14,6,0,3,314
20051007,198,166,95,50,27,10,1,1,548
20051008,125,94,49,33,7,1,0,0,309
20051009,119,119,53,37,12,3,1,0,344
20051010,93,97,31,24,7,2,0,2,256
20051101,211,163,97,38,17,4,2,4,536
20051102,131,120,62,54,16,4,1,1,389
20051103,67,100,51,48,10,3,2,0,281
20051104,137,104,51,26,8,4,0,1,331
20051105,91,115,53,42,14,6,0,0,321
20051106,94,111,52,41,15,2,0,0,315
20051107,165,137,85,63,14,4,1,1,470
20051108,119,87,48,35,21,8,0,3,321
20051109,148,158,81,49,18,2,3,0,459
20051110,85,137,69,44,14,4,1,0,354
20051201,128,81,40,30,9,4,1,0,293
20051202,295,277,141,94,26,6,1,0,840
20051203,166,132,70,44,11,3,0,0,426
20051204,112,103,58,37,14,3,1,0,328
20051205,78,66,30,18,4,1,1,0,198
20051206,319,239,121,66,18,3,3,0,769
20051207,85,109,63,44,20,12,1,2,336
20051301,134,141,66,43,7,4,1,0,396
20051302,103,117,57,29,10,5,0,0,321
20051303,139,118,60,39,6,3,0,0,365
20051304,130,109,47,25,15,3,0,1,330
20051305,105,96,77,34,8,9,2,1,332
20051306,126,118,69,46,14,2,1,1,377
20051307,107,118,48,31,15,4,0,0,323
20051308,134,145,72,53,14,3,0,0,421
20051309,137,128,72,53,17,9,4,2,422
20051401,89,80,49,45,9,0,1,1,274
20051402,159,120,48,13,7,0,0,0,347
20051403,213,153,95,58,12,7,1,1,540
20051404,128,157,71,53,9,2,1,0,421
20051405,321,259,108,74,19,4,2,0,787
20051406,209,180,73,56,17,2,0,1,538
20051407,59,62,22,14,7,1,3,0,168
20051408,78,97,43,42,10,4,1,0,275
20051409,162,146,55,40,16,3,3,1,426
20051501,201,168,77,51,15,7,1,1,521
20051502,190,192,85,52,6,3,2,0,530
20051503,94,89,41,29,10,3,1,0,267
20051504,232,167,94,51,18,5,0,1,568
20051505,193,153,59,36,8,3,2,0,454
20051506,114,99,53,40,13,10,0,1,330
20051507,112,94,50,36,14,7,0,0,313
20051508,125,107,41,35,14,6,1,2,331
20051509,58,43,31,24,6,2,3,1,168
20051601,161,132,53,45,9,4,0,0,404
20051602,107,85,51,22,17,4,0,0,286
20051603,83,62,33,21,12,3,0,0,214
20051604,113,102,67,57,34,9,5,2,389
20051605,131,116,62,47,13,5,2,0,376
20051606,105,103,43,31,15,9,2,1,309
20051607,68,92,37,31,13,6,1,1,249
20051608,97,95,70,65,28,17,1,3,376
20051609,139,112,70,42,16,10,5,0,394
20051610,127,109,83,40,19,3,3,4,388
20051611,112,136,89,60,19,5,2,1,424
20051701,89,89,51,34,20,5,0,2,290
20051702,114,123,51,40,16,7,0,2,353
20051703,93,102,60,44,12,5,0,1,317
20051704,72,86,51,45,19,19,2,4,298
20051705,78,111,60,39,15,6,0,0,309
20051706,102,123,59,40,13,3,1,0,341
20051707,69,98,66,65,22,6,2,1,329
20051708,114,124,70,49,14,6,3,5,385
20051709,89,84,39,28,7,5,1,0,253
20051710,62,74,69,53,19,2,1,0,280
20051711,176,128,67,45,8,2,2,0,428
20051801,139,138,82,44,17,2,0,1,423
20051802,124,104,65,55,18,6,0,3,375
20051803,100,103,60,46,24,8,2,0,343
20051804,78,73,44,45,18,12,4,3,277
20051805,105,102,60,42,18,3,0,6,336
20051806,64,58,45,46,19,4,4,2,242
20051807,92,100,61,39,10,6,1,0,309
20051808,38,41,23,25,15,6,0,1,149
20051809,66,84,48,45,17,4,2,1,267
20051810,107,112,58,41,16,7,1,2,344
20051811,109,107,60,30,7,0,1,1,315
20051901,100,105,59,52,19,4,1,4,344
20051902,75,90,56,42,15,3,0,1,282
20051903,138,130,65,48,16,7,2,1,407
20051904,121,113,69,53,30,9,1,1,397
20051905,108,110,54,40,17,3,1,1,334
20051906,100,107,57,43,16,4,2,1,330
20051907,68,70,24,23,10,4,0,0,199
20051908,155,148,57,52,13,3,1,0,429
20051909,109,103,48,26,7,0,1,0,294
20051910,124,117,71,40,7,3,2,0,364
20051911,127,131,90,66,17,5,0,1,437
20052001,95,98,57,40,18,7,1,0,316
20052002,142,135,61,46,19,5,2,0,410
20052003,104,80,80,72,30,16,1,2,385
20052004,70,109,69,42,11,7,4,2,314
20052005,78,94,69,50,23,14,3,1,332
20052006,38,84,78,53,25,5,2,3,288
20052007,59,79,76,59,28,9,3,2,315
20052008,61,95,61,56,28,9,4,3,317
20052009,77,100,62,55,20,8,4,0,326
20052010,91,116,88,61,17,4,2,1,380
20052011,64,84,70,53,16,11,2,2,302
20052012,58,79,69,51,30,8,1,1,297
20052101,130,109,71,47,17,3,0,1,378
20052102,116,104,42,54,22,7,2,3,350
20052103,57,73,30,38,6,5,0,0,209
20052104,105,124,62,43,22,8,5,1,370
20052105,71,85,57,42,6,5,0,0,266
20052106,122,114,58,29,8,5,1,0,337
20052107,51,86,49,34,20,13,2,2,257
20052108,47,83,47,39,20,10,0,2,248
20052109,40,66,49,46,21,10,2,2,236
20052110,81,85,34,33,13,4,2,1,253
20052111,49,75,48,41,16,9,5,2,245
20052201,53,70,59,49,15,9,4,1,260
20052202,60,85,56,54,25,6,2,4,292
20052203,78,81,45,36,11,9,0,0,260
20052204,78,122,77,60,15,5,4,1,362
20052205,59,77,48,53,25,9,1,5,277
20052206,78,77,73,56,32,13,1,2,332
20052207,268,209,130,79,29,5,3,1,724
20052208,50,63,45,57,21,7,1,2,246
20052209,43,65,66,53,25,19,4,3,278
20052210,49,92,56,62,21,11,4,1,296
20052211,63,98,72,47,21,13,2,4,320
20052212,68,88,77,60,18,8,4,3,326
20052213,32,59,60,37,19,5,4,2,218
20060101,52,70,49,35,25,9,0,2,242
20060102,95,121,62,50,9,5,0,3,345
20060103,96,106,69,50,15,10,1,0,347
20060104,76,84,59,39,9,5,1,1,274
20060105,106,129,97,59,32,7,0,1,431
20060106,92,103,71,52,20,7,2,1,348
20060107,59,75,55,49,13,6,3,0,260
20060108,80,76,64,53,21,11,2,3,310
20060109,34,65,41,43,25,14,4,1,227
20060110,21,47,40,21,13,2,1,0,145
20060111,58,73,51,43,23,4,1,0,253
20060112,111,97,41,31,6,5,0,1,292
20060201,73,113,94,71,23,11,1,1,387
20060202,80,84,63,81,20,4,2,0,334
20060203,69,80,41,36,11,4,2,0,243
20060204,52,79,46,42,21,6,0,1,247
20060205,47,62,54,44,8,9,0,2,226
20060206,73,116,71,57,22,1,1,1,342
20060207,133,111,53,30,14,4,0,1,346
20060208,80,95,70,80,28,13,2,0,368
20060209,63,62,68,38,16,3,1,1,252
20060210,71,90,69,70,28,4,1,1,334
20060211,135,149,105,73,39,3,1,3,508
20060301,81,123,80,58,19,2,1,3,367
20060302,58,100,57,54,27,6,1,0,303
20060303,98,93,60,63,24,6,4,1,349
20060304,66,74,46,36,13,6,2,0,243
20060305,59,69,53,59,12,4,3,1,260
20060306,99,102,66,69,17,3,0,0,356
20060307,95,146,62,49,11,4,2,1,370
20060308,85,105,54,34,24,2,1,0,305
20060309,119,138,80,82,23,3,5,1,451
20060310,143,139,51,44,12,3,1,0,393
20060401,59,54,33,37,14,8,2,1,208
20060402,41,56,54,44,25,7,0,0,227
20060403,102,95,56,64,17,5,0,0,339
20060404,83,114,60,43,9,6,3,1,319
20060405,70,89,60,47,17,5,0,0,288
20060406,102,94,55,42,23,6,0,0,322
20060407,46,69,58,38,24,6,1,0,242
20060408,103,129,56,62,15,4,1,0,370
20060409,77,117,60,37,23,7,1,0,322
20060410,83,131,66,43,8,7,1,0,339
20060411,115,119,58,35,14,3,1,0,345
20060501,159,134,59,21,7,3,0,0,383
20060502,156,142,75,61,10,7,2,0,453
20060503,146,118,53,43,11,1,0,0,372
20060504,99,98,57,27,10,1,1,0,293
20060505,127,117,66,57,13,7,4,1,392
20060506,95,102,54,43,8,1,0,1,304
20060507,100,126,58,31,16,2,1,0,334
20060508,66,72,26,31,7,2,1,0,205
20060509,59,88,38,43,7,1,1,0,237
20060510,107,141,86,48,16,8,0,1,407
20060511,138,134,77,44,17,4,2,0,416
20060512,52,49,30,17,7,2,2,0,159
20060601,225,171,70,64,12,3,1,0,546
20060602,215,288,159,91,30,9,0,0,792
20060603,176,165,99,45,20,4,0,0,509
20060604,81,76,38,22,8,0,1,0,226
20060605,58,69,27,34,10,3,0,0,201
20060606,106,119,50,42,11,4,1,0,333
20060607,130,120,49,37,10,3,0,1,350
20060608,141,112,82,52,15,3,1,2,408
20060609,125,114,68,42,7,0,0,0,356
20060701,118,80,34,36,8,2,1,1,280
20060702,147,100,35,45,11,3,1,1,343
20060703,80,105,43,37,11,1,1,0,278
20060704,106,126,76,43,17,3,0,1,372
20060705,119,120,72,32,15,1,0,0,359
20060706,93,87,40,25,10,4,1,0,260
20060707,141,128,61,47,13,6,2,1,399
20060708,97,86,57,44,15,7,1,0,307
20060709,93,111,64,35,12,5,0,0,320
20060710,105,103,53,47,11,5,2,0,326
20060711,115,95,43,25,12,2,1,0,293
20060712,107,71,54,34,15,5,0,0,286
20060713,87,79,38,29,2,1,0,0,236
20060801,105,112,76,45,11,5,0,1,355
20060802,157,148,70,54,25,3,0,0,457
20060803,68,85,57,29,14,5,1,1,260
20060804,115,99,43,34,7,1,1,0,300
20060805,90,99,38,14,7,3,0,0,251
20060806,147,161,103,78,36,6,2,0,533
20060807,127,99,50,34,6,0,2,1,319
20060808,167,174,91,56,13,8,0,0,509
20060809,121,82,36,19,6,2,0,0,266
20060810,132,116,44,33,7,0,2,0,334
20060901,117,98,46,31,5,0,0,0,297
20060902,80,90,49,25,8,5,3,0,260
20060903,97,105,43,34,9,2,1,2,293
20060904,122,143,84,59,17,4,1,0,430
20060905,64,64,26,9,6,1,0,0,170
20060906,116,128,73,48,15,1,0,0,381
20060907,92,78,38,31,7,2,1,0,249
20060908,79,61,29,23,3,1,0,0,196
20060909,113,108,72,56,11,1,0,1,362
20060910,105,106,51,48,11,3,0,0,324
20061001,114,116,45,20,6,2,0,0,303
20061002,131,86,43,18,6,0,2,2,288
20061003,139,132,70,34,7,1,0,0,383
20061004,127,123,45,25,7,6,1,3,337
20061005,167,167,69,44,9,5,0,0,461
20061006,166,151,82,44,8,3,0,1,455
20061007,167,111,32,21,2,2,0,0,335
20061008,199,187,96,58,22,5,0,1,568
20061009,108,68,37,22,8,3,0,0,246
20061010,184,147,75,47,8,2,0,0,463
20061101,119,136,83,69,14,7,0,1,429
20061102,73,89,37,33,9,0,0,1,242
20061103,99,126,66,62,14,0,0,1,368
20061104,104,114,65,45,15,0,0,0,343
20061105,78,76,46,38,7,2,2,0,249
20061106,84,113,58,37,13,2,1,1,309
20061107,133,112,62,41,7,1,1,0,357
20061108,134,123,60,41,11,0,0,0,369
20061109,89,91,59,32,13,4,0,0,288
20061110,87,75,35,26,13,3,1,0,240
20061201,95,95,37,23,5,0,0,1,256
20061202,68,75,48,23,11,1,0,2,228
20061203,107,95,45,29,7,4,0,1,288
20061204,98,55,19,13,5,3,0,0,193
20061205,134,119,73,44,11,2,1,0,384
20061206,67,85,47,33,9,1,0,1,243
20061207,154,114,40,25,13,3,0,0,349
20061208,86,92,57,47,16,5,0,0,303
20061209,132,128,53,29,13,4,3,0,362
20061210,72,80,41,36,5,2,0,0,236
20061211,137,109,65,48,9,3,0,1,372
20061212,63,69,34,29,12,1,0,0,208
20061301,100,97,64,30,14,1,1,0,307
20061302,184,220,91,65,19,5,1,1,586
20061303,81,108,64,36,8,3,1,1,302
20061304,129,162,96,80,21,5,0,4,497
20061305,94,145,68,40,11,2,0,1,361
20061306,102,93,44,25,3,0,0,0,267
20061307,113,120,62,52,18,4,0,0,369
20061308,128,162,101,81,19,1,3,2,497
20061309,140,159,78,42,6,1,0,0,426
20061401,121,128,65,56,9,1,1,1,382
20061402,63,81,46,41,17,1,1,0,250
20061403,153,143,47,27,10,3,1,0,384
20061404,218,177,69,57,8,2,0,0,531
20061405,98,151,62,67,22,5,2,0,407
20061406,138,153,93,77,14,6,2,1,484
20061407,76,76,44,28,11,2,0,0,237
20061408,52,70,49,38,8,1,0,0,218
20061409,66,106,65,49,18,2,2,1,309
20061410,109,130,87,49,16,1,0,0,392
20061501,97,78,51,41,13,1,2,1,284
20061502,277,250,122,96,16,6,1,2,770
20061503,118,112,65,42,16,4,1,0,358
20061504,70,84,45,52,13,6,0,0,270
20061505,95,106,61,44,10,3,1,0,320
20061506,60,77,50,68,21,6,0,1,283
20061507,95,106,53,53,16,9,0,3,335
20061508,151,147,87,48,11,1,0,0,445
20061509,70,77,39,29,12,0,0,0,227
20061510,88,99,58,48,8,4,0,0,305
20061601,78,95,63,30,11,4,1,1,283
20061602,83,92,47,43,16,3,0,0,284
20061603,91,148,84,48,19,2,1,0,393
20061604,106,94,48,55,5,1,1,0,310
20061605,84,149,83,46,27,2,2,0,393
20061606,122,136,70,65,17,5,0,0,415
20061607,69,135,81,72,20,9,1,1,388
20061608,136,174,118,102,21,8,1,0,560
20061609,105,120,85,63,37,6,2,0,418
20061610,140,170,95,82,11,0,1,0,499
20061611,132,112,83,44,12,5,1,1,390
20061701,158,152,61,35,8,1,1,0,416
20061702,160,137,59,40,17,3,2,1,419
20061703,94,119,44,37,8,2,2,3,309
20061704,134,129,52,28,15,2,0,0,360
20061705,324,276,133,82,19,3,2,0,839
20061706,178,194,72,51,11,1,0,0,507
20061707,89,101,44,33,9,1,0,0,277
20061801,75,86,51,35,13,3,0,0,263
20061802,74,101,46,26,8,1,0,0,256
20061803,119,104,55,22,11,1,1,0,313
20061804,86,104,64,47,7,1,0,0,309
20061805,141,135,68,38,5,2,0,1,390
20061806,124,159,85,54,23,8,1,0,454
20061807,169,200,78,52,20,7,0,0,526
20061808,185,183,75,57,7,3,2,0,512
20061809,149,140,54,36,12,4,0,0,395
20061901,116,139,57,51,17,3,1,1,385
20061902,210,211,91,89,35,4,0,1,641
20061903,208,198,103,67,24,3,0,0,603
20061904,165,139,68,59,15,0,4,3,453
20061905,92,102,54,41,12,2,1,1,305
20061906,132,146,85,53,18,3,0,2,439
20061907,163,139,62,64,13,3,0,0,444
20061908,158,145,75,37,11,4,1,0,431
20062001,71,63,36,37,5,1,1,0,214
20062002,82,98,43,26,7,2,0,0,258
20062003,168,132,75,51,18,2,1,0,447
20062004,101,83,37,23,10,2,0,0,256
20062005,143,120,52,51,15,3,0,0,384
20062006,134,124,59,51,11,1,0,0,380
20062007,62,97,51,31,10,1,2,0,254
20062008,128,149,89,94,18,4,0,1,483
20062009,87,105,52,55,12,5,1,0,317
20062010,126,126,68,48,14,1,2,0,385
20062101,103,110,42,23,11,4,0,0,293
20062102,155,156,68,49,21,2,0,1,452
20062103,148,153,74,56,19,2,0,2,454
20062104,80,84,48,36,6,8,0,0,262
20062105,92,114,50,59,12,3,0,0,330
20062106,74,80,39,27,7,3,1,0,231
20062107,118,117,60,54,21,5,2,1,378
20062108,106,162,96,74,24,2,0,1,465
20062109,71,96,60,48,12,4,3,0,294
20062110,121,126,60,42,11,7,1,0,368
20062111,101,124,72,62,27,0,0,1,387
20070101,56,65,37,37,14,13,1,0,223
20070102,66,89,59,53,17,11,6,5,306
20070103,74,98,65,41,25,6,2,5,316
20070104,52,80,40,38,27,13,1,4,255
20070105,51,52,26,18,14,6,2,3,172
20070106,58,85,52,37,19,10,5,3,269
20070107,51,56,28,27,15,4,1,3,185
20070108,124,110,46,23,12,2,0,2,319
20070109,102,91,40,37,10,4,3,4,291
20070110,135,124,76,63,13,7,1,0,419
20070201,60,79,61,48,24,13,2,2,289
20070202,86,116,60,74,13,20,0,1,370
20070203,79,79,54,54,24,9,2,2,303
20070204,186,144,130,128,51,19,0,2,660
20070205,106,100,57,49,23,18,3,2,358
20070206,103,111,75,69,20,12,2,4,396
20070207,47,70,46,49,20,4,3,6,245
20070208,93,101,38,49,9,2,3,1,296
20070209,112,122,73,45,33,4,3,2,394
20070301,96,100,46,47,8,3,0,1,301
20070302,105,115,76,53,20,9,1,2,381
20070303,144,148,97,54,21,11,1,1,477
20070304,76,111,77,71,43,8,6,3,395
20070305,79,97,51,58,15,9,0,0,309
20070306,77,116,67,45,25,8,0,0,338
20070307,109,138,83,73,33,7,3,2,448
20070308,103,100,41,38,19,5,1,0,307
20070309,67,81,60,39,15,6,5,0,273
20070310,126,124,81,57,25,10,2,0,425
20070401,199,216,60,43,10,6,0,0,534
20070402,89,131,65,22,26,1,0,0,334
20070403,147,148,78,56,15,6,0,0,450
20070404,167,190,110,57,23,10,2,1,560
20070405,155,139,44,35,16,8,0,0,397
20070406,94,143,86,63,32,7,10,1,436
20070407,130,149,69,92,21,6,0,5,472
20070408,114,127,74,54,19,6,2,0,396
20070409,40,73,47,43,15,3,0,2,223
20070410,113,98,73,58,19,4,0,0,365
20070501,98,141,57,31,13,1,0,0,341
20070502,63,87,40,36,14,2,1,0,243
20070503,102,92,62,54,11,5,2,0,328
20070504,154,143,85,52,20,1,1,1,457
20070505,131,153,72,69,27,7,2,1,462
20070506,88,94,43,29,11,4,0,0,269
20070507,65,95,52,38,17,2,0,0,269
20070508,152,86,41,43,17,6,0,0,345
20070509,141,145,81,63,20,7,3,0,460
20070601,106,116,71,49,21,8,1,0,372
20070602,65,107,61,43,16,6,0,1,299
20070603,53,85,47,39,10,5,2,2,243
20070604,81,110,66,29,12,4,1,2,305
20070605,142,146,69,40,9,7,1,0,414
20070606,144,110,62,46,18,14,0,0,394
20070607,119,120,74,46,16,4,0,0,379
20070608,53,70,28,28,4,2,0,0,185
20070609,94,96,44,42,12,1,0,0,289
20070701,62,72,58,30,16,3,4,0,245
20070702,57,60,51,23,11,2,0,0,204
20070703,124,124,107,22,17,13,2,0,409
20070704,109,74,42,27,7,6,1,0,266
20070705,125,73,40,29,18,1,1,0,287
20070706,97,110,77,52,17,7,4,1,365
20070707,68,90,36,32,12,5,2,3,248
20070708,71,66,43,31,6,2,0,1,220
20070709,138,139,58,48,17,7,0,3,410
20070710,106,136,54,49,9,0,0,1,355
20070711,102,89,49,30,10,1,0,1,282
20070801,135,108,43,32,6,1,0,1,326
20070802,114,104,66,46,19,2,4,1,356
20070803,84,85,33,34,8,2,0,1,247
20070804,124,109,63,44,10,5,2,1,358
20070805,94,117,88,61,21,8,1,2,392
20070806,113,109,74,54,15,6,1,1,373
20070807,109,118,48,32,11,1,0,0,319
20070808,124,128,72,29,12,2,0,1,368
20070901,66,83,52,36,14,7,1,0,259
20070902,91,86,54,32,11,1,1,0,276
20070903,70,74,43,32,4,2,1,0,226
20070904,182,124,64,27,12,6,0,0,415
20070905,47,69,42,28,7,3,0,1,197
20070906,94,114,71,59,10,6,2,0,356
20070907,99,117,59,42,10,2,0,0,329
20070908,129,122,79,49,12,4,1,1,397
20070909,99,96,48,34,13,7,1,0,298
20070910,99,105,56,28,13,5,1,0,307
20070911,92,90,43,24,8,5,0,1,263
20071001,79,107,55,43,12,6,1,0,303
20071002,69,66,26,20,3,1,0,0,185
20071003,82,85,41,31,8,3,2,2,254
20071004,87,102,52,34,15,4,0,1,295
20071005,52,80,55,37,7,6,2,1,240
20071006,112,129,63,37,8,2,0,0,351
20071007,128,112,56,27,14,2,0,0,339
20071008,117,140,60,75,25,8,2,1,428
20071009,96,112,50,35,12,2,0,0,307
20071010,76,125,69,43,15,4,0,0,332
20071101,114,113,49,31,7,1,0,0,315
20071102,150,127,66,42,10,6,1,0,402
20071103,105,132,63,46,18,3,0,0,367
20071104,98,129,64,60,26,1,1,1,380
20071105,57,85,42,32,12,0,1,0,229
20071106,59,127,44,25,11,1,0,0,267
20071107,165,165,77,58,25,5,1,0,496
20071108,138,166,80,53,11,3,0,1,452
20071109,104,108,67,57,25,4,1,0,366
20071110,60,83,40,41,17,6,2,0,249
20071201,118,141,77,64,15,4,3,0,422
20071202,57,61,46,33,14,4,1,0,216
20071203,72,84,58,34,21,6,1,2,278
20071204,79,97,77,49,9,6,1,1,319
20071205,77,88,61,55,12,4,0,0,297
20071206,83,100,50,44,15,7,2,1,302
20071207,38,76,38,39,17,6,2,2,218
20071208,39,69,41,34,23,5,2,0,213
20071209,58,79,64,53,21,14,0,1,290
20071301,109,106,55,29,13,5,1,2,320
20071302,81,90,68,34,15,5,1,0,294
20071303,126,139,76,53,17,3,0,1,415
20071304,48,68,47,33,15,5,0,0,216
20071305,70,118,75,48,14,2,2,0,329
20071306,52,75,55,50,24,6,3,0,265
20071307,48,71,35,28,18,2,0,0,202
20071308,35,51,54,29,13,10,1,1,194
20071309,19,52,39,37,11,6,2,0,166
20071310,36,69,46,30,7,5,0,0,193
20071311,35,70,67,50,17,10,3,1,253
20071312,24,56,56,50,29,6,1,0,222
20071313,41,49,43,36,15,8,2,2,196
20071314,36,61,41,53,21,4,2,2,220
20071315,45,43,44,37,8,7,0,1,185
20071401,70,108,57,42,20,11,1,4,313
20071402,72,82,50,63,17,7,5,2,298
20071403,59,80,44,44,17,11,0,2,257
20071404,57,73,55,53,10,6,2,2,258
20071405,52,70,64,69,27,9,2,2,295
20071406,68,101,77,79,33,8,9,4,379
20071407,40,58,69,64,21,7,8,5,272
20071408,45,78,61,67,28,15,3,3,300
20071409,72,68,52,56,24,13,1,3,289
20071410,28,66,52,47,25,9,3,3,233
20071411,62,82,73,67,28,9,1,1,323
20071412,73,80,93,66,19,5,2,1,339
20071413,51,65,60,37,18,10,5,5,251
20071501,32,64,54,38,20,9,6,2,225
20071502,66,102,74,61,28,20,4,5,360
20071503,60,82,62,50,36,20,3,3,316
20071504,49,65,46,41,20,7,2,2,232
20071505,44,62,42,49,16,15,3,2,233
20071506,99,93,66,43,22,7,1,3,334
20071507,79,81,63,39,16,4,0,3,285
20071508,74,81,57,44,22,7,4,4,293
20071509,76,102,79,66,44,18,7,5,397
20071510,62,76,69,58,32,19,5,6,327
20071511,62,89,73,71,43,22,3,4,367
20071601,39,68,58,54,20,7,2,0,248
20071602,42,64,55,46,23,14,3,6,253
20071603,31,73,61,56,29,12,2,0,264
20071604,45,69,46,38,22,14,3,4,241
20071605,53,69,59,54,25,12,2,0,274
20071606,73,96,72,60,35,9,3,4,352
20071607,60,96,65,50,23,14,4,8,320
20071608,57,78,79,77,34,21,3,3,352
20071609,53,92,65,61,33,20,6,5,335
20071701,63,68,79,88,69,47,15,10,439
20071702,107,94,107,81,47,45,12,7,500
20071703,77,88,78,70,52,31,11,9,416
20071704,103,106,110,72,60,31,9,18,509
20071705,39,59,56,57,29,20,2,6,268
20071706,50,65,79,90,46,29,5,11,375
20071707,182,138,149,129,81,47,15,23,764
20071708,70,59,65,62,44,29,3,6,338
20071709,120,133,172,90,53,34,13,3,618
20071710,109,119,102,78,47,29,8,8,500
20071711,47,37,38,36,15,15,0,2,190
20071801,25,50,89,113,57,31,18,12,395
20071802,8,22,35,23,14,9,4,9,124
20071803,51,65,52,55,28,24,7,6,288
20071804,46,55,53,45,32,16,2,5,254
20071805,43,58,63,51,46,16,9,6,292
20071806,85,90,100,97,55,33,7,18,485
20071807,26,50,49,49,44,34,11,23,286
20071808,30,42,43,38,25,33,13,22,246
20071809,83,67,76,66,48,17,13,7,377
20071810,42,73,91,100,55,31,11,11,414
20071811,80,88,71,75,40,25,8,16,403
20071901,34,69,66,51,29,21,1,3,274
20071902,101,91,105,93,66,32,5,14,507
20071903,34,59,84,89,50,26,10,11,363
20071904,71,86,95,103,42,33,12,13,455
20071905,58,76,67,79,51,30,18,13,392
20071906,25,58,82,95,65,53,28,34,440
20072001,76,122,73,77,22,7,2,1,380
20072002,32,65,27,42,18,6,1,1,192
20072003,49,83,46,56,15,5,1,4,259
20072004,46,51,31,33,18,4,5,2,190
20072005,61,63,64,54,21,9,1,5,278
20072006,47,84,62,57,21,7,3,2,283
20072007,57,63,64,55,27,8,3,2,279
20072008,108,116,108,57,31,15,3,3,441
20072009,52,86,60,55,28,12,5,4,302
20072010,70,78,83,59,47,18,6,7,368
20072011,69,96,82,58,29,18,5,6,363
20072012,50,57,34,45,17,15,3,2,223
20072013,105,175,125,105,38,21,1,5,575
20072101,125,135,73,69,13,8,0,1,424
20072102,135,153,86,67,20,4,1,0,466
20072103,144,143,79,49,13,4,1,0,433
20072104,67,91,40,34,5,2,1,0,240
20072105,49,79,50,54,11,5,1,1,250
20072106,148,131,82,44,15,2,0,1,423
20072107,75,114,61,37,15,1,0,0,303
20072108,42,69,27,27,4,4,0,2,175
20072109,89,115,47,37,15,2,2,0,307
20072110,109,110,82,50,17,6,1,1,376
20072111,107,101,61,42,18,9,1,0,339
20072112,72,77,68,62,22,9,0,3,313
20072201,108,100,44,32,12,1,0,0,297
20072202,80,128,77,54,19,4,3,0,365
20072203,111,104,69,46,22,9,0,0,361
20072204,103,112,76,66,18,1,0,2,378
20072205,99,98,85,78,21,4,1,0,386
20072206,94,118,79,51,11,9,1,2,365
20072207,51,65,55,39,8,2,1,0,221
20072208,64,76,45,36,10,4,0,0,235
20072209,40,79,43,39,17,4,2,0,224
20072210,58,65,51,59,20,11,1,3,268
20072211,50,104,61,49,17,4,1,0,286
20072212,78,80,59,29,9,1,0,0,256
20072213,60,95,61,50,19,3,1,0,289
20072301,57,101,61,52,23,7,1,1,303
20072302,118,122,74,58,13,2,1,0,388
20072303,104,95,60,45,11,2,1,0,318
20072304,87,79,52,41,10,3,0,0,272
20072305,63,94,71,45,13,3,0,1,290
20072306,64,91,55,40,14,7,4,1,276
20072307,78,102,60,46,20,6,0,1,313
20072308,78,105,68,45,17,6,3,0,322
20072309,69,97,58,37,19,8,1,0,289
20072401,89,97,70,64,15,7,1,2,345
20072402,59,85,70,66,25,7,5,1,318
20072403,59,90,81,92,38,11,4,9,384
20072404,89,105,78,62,26,13,4,2,379
20072405,84,89,75,54,30,9,0,3,344
20072406,68,106,78,76,25,14,2,2,371
20072407,59,65,68,63,20,7,2,5,289
20072408,78,84,79,60,26,4,0,0,331
20072409,64,100,84,54,21,15,2,1,341
20072410,48,94,76,63,24,12,2,4,323
20072411,82,109,75,58,29,13,2,3,371
20080101,54,60,61,69,39,32,8,8,331
20080102,105,115,115,84,47,26,11,14,517
20080103,27,64,80,79,43,32,13,13,351
20080104,59,82,81,92,69,54,17,28,482
20080105,46,76,85,86,68,49,18,21,449
20080106,67,146,117,134,64,46,28,25,627
20080107,107,99,84,68,42,26,16,18,460
20080108,74,85,78,61,36,22,9,9,374
20080109,124,175,186,152,83,62,11,17,810
20080110,68,96,93,87,36,26,14,20,440
20080111,23,23,37,53,27,5,8,6,182
20080112,160,212,242,172,106,81,10,36,1019
20080201,62,88,87,59,38,32,11,10,387
20080202,27,44,35,33,12,9,4,4,168
20080203,29,31,35,35,16,11,1,3,161
20080204,42,58,54,43,30,9,5,8,249
20080205,28,42,39,27,22,7,4,5,174
20080206,62,71,45,33,16,13,5,4,249
20080207,84,104,84,56,33,24,9,10,404
20080208,57,89,66,40,32,12,5,6,307
20080209,51,56,66,55,22,12,6,3,271
20080210,35,55,43,25,18,8,4,0,188
20080301,76,84,65,57,35,13,2,2,334
20080302,39,71,51,48,27,12,6,2,256
20080303,27,62,31,37,13,7,5,5,187
20080304,40,62,55,46,24,16,2,5,250
20080305,35,69,49,42,27,10,3,3,238
20080306,25,51,27,22,13,6,0,0,144
20080307,41,62,48,57,20,9,0,8,245
20080308,69,120,118,101,66,41,16,16,547
20080309,84,87,133,119,74,44,11,17,569
20080310,68,78,105,102,61,37,14,13,478
20080401,53,67,55,61,27,14,5,5,287
20080402,46,55,40,39,24,6,2,2,214
20080403,39,58,41,47,23,8,1,3,220
20080404,39,59,51,45,20,4,3,3,224
20080405,58,89,77,71,25,7,3,2,332
20080406,50,103,65,67,38,19,3,5,350
20080407,45,74,70,46,25,11,3,4,278
20080408,42,77,58,55,20,18,4,4,278
20080409,32,84,66,44,21,6,3,2,258
20080410,67,71,69,52,28,16,2,1,306
20080411,41,75,51,50,18,13,2,2,252
20080501,54,73,60,50,24,9,4,3,277
20080502,44,77,51,51,27,6,6,1,263
20080503,51,69,48,48,36,12,5,1,270
20080504,47,85,59,55,29,5,7,4,291
20080505,32,60,37,36,17,14,2,3,201
20080506,60,81,51,42,24,12,6,6,282
20080507,56,94,73,57,28,16,7,5,336
20080508,65,93,48,27,11,7,2,1,254
20080509,41,84,61,61,33,17,1,0,298
20080510,75,126,91,79,29,3,6,2,411
20080511,61,77,76,62,30,7,4,2,319
20080601,55,76,58,65,25,13,4,6,302
20080602,75,108,76,77,27,19,5,10,397
20080603,81,99,81,67,34,33,4,3,402
20080604,42,50,48,41,28,19,2,3,233
20080605,58,67,70,63,35,22,2,3,320
20080606,52,86,60,60,37,13,6,6,320
20080607,39,58,46,32,22,8,1,2,208
20080608,35,54,53,54,32,7,4,2,241
20080609,52,67,59,60,26,12,4,4,284
20080610,35,66,48,42,17,4,4,3,219
20080611,40,45,41,34,20,12,2,9,203
20080701,33,62,81,86,41,29,11,16,359
20080702,93,79,109,72,58,37,14,16,478
20080703,80,85,119,94,61,36,8,10,493
20080704,78,88,82,90,44,34,19,11,446
20080705,108,145,95,75,56,40,8,16,543
20080706,53,64,94,94,40,22,14,14,395
20080707,105,140,148,132,59,52,13,12,661
20080708,51,61,79,89,73,52,17,35,457
20080709,96,132,162,159,120,81,26,38,814
20080710,41,45,59,55,46,20,10,9,285
20080711,39,77,78,74,72,44,13,14,411
20080712,29,45,63,94,67,44,24,29,395
20080713,38,63,87,77,53,40,10,23,391
20080714,85,97,109,113,91,47,16,16,574
20080801,53,65,53,58,30,16,4,2,281
20080802,54,70,72,70,32,8,1,2,309
20080803,43,61,59,40,18,12,1,1,235
20080804,66,93,56,55,19,8,1,2,300
20080805,73,58,47,39,16,5,1,1,240
20080806,75,83,78,51,25,7,2,0,321
20080807,51,93,83,49,22,7,2,1,308
20080808,26,51,41,62,17,7,2,0,206
20080809,29,60,52,51,25,9,3,3,232
20080810,60,66,50,54,38,11,5,5,289
20080811,63,104,74,63,24,8,2,0,338
20080901,45,78,64,42,26,9,3,4,271
20080902,49,80,65,63,23,15,2,1,298
20080903,59,118,65,62,28,10,3,7,352
20080904,31,63,39,34,14,4,0,1,186
20080905,108,108,96,46,19,7,1,0,385
20080906,39,64,55,59,36,27,7,7,294
20080907,58,60,56,56,18,7,2,3,260
20080908,40,72,67,43,24,9,2,1,258
20080909,55,82,66,77,18,15,0,2,315
20081001,28,80,68,55,29,12,3,3,278
20081002,37,64,43,48,28,7,3,7,237
20081003,86,123,70,60,30,9,1,1,380
20081004,124,185,149,143,63,34,10,11,719
20081005,172,245,158,141,81,33,4,8,842
20081006,130,144,132,105,49,14,3,2,579
20081007,94,150,118,90,55,24,3,9,543
20081008,34,37,79,82,47,22,8,11,320
20081101,156,226,194,144,89,70,16,15,910
20081102,153,179,166,123,59,24,8,6,718
20081103,200,296,240,202,75,36,6,2,1057
20081104,98,190,137,128,46,32,8,4,643
20081105,104,106,105,65,36,21,7,5,449
20081201,55,88,61,57,23,13,2,7,306
20081202,71,97,76,69,31,7,3,2,356
20081203,56,95,62,67,24,16,7,4,331
20081204,53,70,62,61,22,15,10,9,302
20081205,75,87,66,66,28,11,5,3,341
20081206,47,60,51,60,20,7,0,4,249
20081207,51,72,61,58,15,14,3,4,278
20081301,11,3,2,3,0,0,0,1,20
20081302,20,31,22,23,13,8,0,1,118
20081303,44,83,52,66,41,21,1,3,311
20081304,51,76,75,67,34,21,5,4,333
20081305,49,88,68,59,25,17,6,3,315
20081306,38,60,57,32,13,17,3,1,221
20081307,54,68,53,38,27,7,5,1,253
20081308,69,66,46,65,30,11,4,6,297
20081401,54,77,97,77,63,52,17,27,464
20081402,38,61,74,83,67,22,19,18,382
20081403,49,86,108,99,80,45,23,28,518
20081404,171,150,151,133,86,57,18,27,793
20081405,82,97,56,83,36,20,5,6,385
20081406,40,70,48,57,15,11,6,3,250
20081407,53,72,56,58,28,17,8,5,297
20081408,43,65,55,53,22,13,5,3,259
20081409,70,78,69,63,27,22,3,4,336
20081410,57,65,68,62,37,16,5,3,313
20081501,159,165,179,161,93,60,17,18,852
20081502,83,115,122,136,97,47,29,26,655
20081503,65,128,148,131,101,58,17,19,667
20081504,25,30,42,43,44,27,10,10,231
20081505,98,140,181,173,112,90,36,47,877
20081506,27,38,60,38,24,25,10,11,233
20081507,35,45,53,54,31,28,5,8,259
20081508,44,52,69,84,50,30,15,14,358
20081509,82,127,95,79,64,52,9,11,519
20081510,65,94,77,78,36,18,9,12,389
20081601,51,56,60,43,39,30,13,7,299
20081602,27,39,43,31,20,15,3,5,183
20081603,25,53,63,60,31,31,8,18,289
20081604,51,53,44,35,33,25,14,11,266
20081605,41,89,53,42,30,20,8,11,294
20081606,46,80,48,34,30,18,5,6,267
20081607,27,49,61,55,37,28,9,10,276
20081608,33,47,44,54,32,21,2,3,236
20081609,47,62,58,51,29,22,7,4,280
20081610,44,49,61,54,41,26,2,2,279
20081701,48,69,52,38,15,0,1,0,223
20081702,44,67,49,37,12,6,1,5,221
20081703,123,111,62,23,5,3,0,0,327
20081704,64,84,58,57,16,11,0,0,290
20081705,42,50,38,29,10,3,0,1,173
20090101,43,73,40,37,8,3,1,1,206
20090102,53,52,43,25,10,0,0,1,184
20090103,92,72,43,31,17,3,3,0,261
20090104,63,75,43,58,14,10,3,3,269
20090105,91,84,64,31,14,6,2,2,294
20090106,88,79,44,41,20,12,5,2,291
20090107,68,74,55,33,15,9,2,1,257
20090108,92,79,41,39,17,9,1,0,278
20090109,112,130,52,40,9,1,0,0,344
20090201,94,124,69,42,16,1,3,0,349
20090202,71,93,63,50,23,1,0,0,301
20090203,85,111,63,42,23,4,0,2,330
20090204,124,128,84,52,17,6,3,0,414
20090205,81,140,90,82,30,4,0,1,428
20090206,50,70,53,56,17,6,2,1,255
20090207,51,110,60,53,20,5,1,0,300
20090208,41,72,57,50,21,3,1,0,245
20090209,105,101,80,51,17,3,1,0,358
20090210,84,88,62,51,17,2,1,0,305
20090211,85,93,69,69,17,4,3,1,341
20090212,40,66,47,49,13,5,3,0,223
20090301,79,83,56,24,11,7,0,3,263
20090302,69,64,63,36,16,2,3,2,255
20090303,58,77,55,31,9,8,1,0,239
20090304,57,70,50,39,20,5,0,1,242
20090305,122,79,37,21,7,3,1,1,271
20090306,70,99,70,35,16,6,1,1,298
20090307,72,108,58,46,21,9,2,0,316
20090308,56,66,76,59,13,4,3,2,279
20090309,63,69,60,33,18,8,3,3,257
20090310,44,77,75,55,26,6,0,0,283
20090311,50,89,63,61,23,4,1,3,294
20090312,38,72,42,37,17,6,0,1,213
20090313,47,93,78,47,26,21,1,0,313
20090401,88,111,73,60,19,8,2,0,361
20090402,66,87,70,62,31,5,0,4,325
20090403,80,94,76,58,26,6,1,1,342
20090404,64,86,70,72,28,7,1,1,329
20090405,71,105,78,55,32,7,3,4,355
20090406,62,76,59,39,11,4,0,0,251
20090407,64,92,55,41,12,6,1,0,271
20090408,50,74,75,51,15,4,0,1,270
20090409,47,71,67,45,20,5,1,0,256
20090410,59,94,57,54,20,5,1,0,290
20090411,69,107,70,63,12,13,6,1,341
20090501,54,91,69,61,27,2,4,2,310
20090502,81,94,76,47,21,3,0,0,322
20090503,70,90,44,39,13,5,0,0,261
20090504,59,95,60,56,23,3,2,5,303
20090505,96,110,72,70,26,6,4,0,384
20090506,75,92,60,56,18,12,0,2,315
20090507,75,106,63,43,20,5,0,2,314
20090508,59,76,56,65,24,9,3,0,292
20090509,102,99,60,41,23,2,3,0,330
20090510,65,95,75,63,13,6,2,0,319
20090511,57,95,63,67,19,12,3,1,317
20090601,91,136,75,59,30,12,3,2,408
20090602,39,67,72,48,17,13,1,2,259
20090603,105,124,68,41,26,6,2,1,373
20090604,75,99,90,42,23,9,1,2,341
20090605,75,143,88,68,22,14,1,1,412
20090606,58,74,53,44,19,5,5,1,259
20090607,77,122,81,60,25,3,2,4,374
20090608,62,75,50,65,18,8,2,1,281
20090609,102,121,79,54,13,2,1,1,373
20090610,86,100,74,58,16,5,3,3,345
20090611,74,94,59,49,20,9,0,4,309
20090612,52,78,60,51,34,10,0,1,286
20090701,38,107,41,54,11,11,4,3,269
20090702,44,99,67,65,15,7,2,1,300
20090703,52,72,41,35,16,0,3,1,220
20090704,40,75,54,51,20,1,1,0,242
20090705,48,83,48,50,18,9,1,0,257
20090706,52,99,62,71,17,4,1,2,308
20090707,44,85,49,40,10,2,0,2,232
20090708,65,84,46,52,17,6,3,2,275
20090709,75,92,47,66,26,5,2,0,313
20090710,44,86,40,51,19,3,1,1,245
20090711,59,78,61,49,19,8,2,2,278
20090712,55,85,59,65,32,17,1,1,315
20090713,74,105,71,50,14,9,0,1,324
20090714,77,92,58,39,21,7,2,1,297
20090801,62,81,64,61,14,3,1,1,287
20090802,81,78,68,49,14,3,0,1,294
20090803,48,94,64,53,22,9,1,2,293
20090804,80,81,65,42,10,8,0,0,286
20090805,65,100,65,59,29,10,0,1,329
20090806,81,93,64,66,28,18,2,1,353
20090807,65,74,62,63,29,16,9,12,330
20090808,55,91,74,50,37,15,6,7,335
20090809,50,67,41,49,20,13,4,6,250
20090810,80,88,56,61,23,11,4,3,326
20090811,69,88,64,65,21,13,1,2,323
20090812,60,101,68,56,24,12,8,2,331
20090813,44,39,51,39,16,8,3,7,207
20090901,65,78,48,53,22,11,3,2,282
20090902,70,72,51,40,24,5,5,1,268
20090903,93,135,69,60,27,8,0,4,396
20090904,37,54,52,38,15,8,4,3,211
20090905,57,69,61,47,19,6,1,1,261
20090906,50,89,64,59,31,7,4,0,304
20090907,71,129,65,55,24,8,5,2,359
20090908,33,71,35,36,19,7,4,0,205
20090909,40,68,46,54,28,13,3,4,256
20090910,41,86,68,55,16,12,6,1,285
20090911,59,83,54,46,20,9,4,0,275
20090912,41,60,46,43,24,8,2,3,227
20090913,29,54,53,47,16,6,1,3,209
20090914,47,71,72,75,30,9,3,3,310
20091001,70,75,65,56,19,6,2,5,298
20091002,71,94,75,58,20,14,1,3,336
20091003,61,83,59,63,37,17,3,5,328
20091004,51,85,47,37,12,2,1,2,237
20091005,86,103,68,59,16,5,2,3,342
20091006,69,69,46,51,29,13,4,1,282
20091007,62,69,48,45,12,9,3,1,249
20091008,53,98,70,60,22,13,5,1,322
20091009,36,52,40,26,7,5,3,1,170
20091010,78,100,54,48,18,5,0,1,304
20091011,62,86,54,28,12,3,0,0,245
20091012,72,71,42,22,12,3,2,0,224
20091101,102,118,100,64,29,11,4,2,430
20091102,80,82,65,68,26,20,6,8,355
20091103,52,91,58,51,25,8,2,5,292
20091104,86,110,64,69,24,10,6,1,370
20091105,59,99,94,94,28,16,3,4,397
20091106,83,71,62,63,29,11,6,2,327
20091107,77,117,73,65,28,16,4,5,385
20091108,65,88,67,52,25,9,4,1,311
20091109,61,92,51,63,25,11,2,9,314
20091110,56,87,55,51,36,11,5,5,306
20091111,60,100,64,64,27,11,1,2,329
20091112,71,105,100,73,35,20,7,3,414
20091201,55,79,79,69,33,16,3,4,338
20091202,47,51,35,27,24,4,2,1,191
20091203,55,65,61,57,27,11,3,4,283
20091204,60,92,69,39,22,9,3,2,296
20091205,69,74,58,51,26,9,1,2,290
20091206,60,98,56,69,33,12,6,4,338
20091207,57,61,51,48,18,11,1,3,250
20091208,41,98,70,64,32,11,3,1,320
20091209,41,87,65,56,28,12,2,1,292
20091210,67,69,71,67,38,30,1,0,343
20091211,82,70,68,48,29,10,0,3,310
20091212,42,53,50,42,24,13,4,4,232
20091301,44,92,69,61,26,18,1,4,315
20091302,94,116,66,84,23,16,1,4,404
20091303,81,103,83,66,41,19,4,5,402
20091304,36,56,46,61,27,16,4,4,250
20091305,55,65,65,48,38,20,7,5,303
20091306,41,68,69,68,26,20,3,5,300
20091307,66,85,59,68,42,27,5,6,358
20091401,68,116,77,83,27,11,5,1,388
20091402,42,87,77,62,26,7,3,3,307
20091403,52,70,50,50,21,16,2,2,263
20091404,39,52,55,42,27,22,4,8,249
20091405,34,72,88,95,72,47,24,25,457
20091406,72,94,135,142,92,70,26,28,659
20091407,51,50,80,56,40,40,10,24,351
20091408,56,48,89,91,58,37,22,25,426
20091409,34,48,48,46,31,34,5,6,252
20091410,65,73,106,103,68,44,12,18,489
20091501,58,64,35,30,20,5,3,2,217
20091502,61,73,49,55,29,15,3,5,290
20091503,55,78,57,54,28,11,3,4,290
20091504,44,65,58,50,31,15,3,6,272
20091505,65,77,59,72,27,14,0,5,319
20091506,50,79,80,72,29,21,2,3,336
20091507,65,80,79,73,27,15,3,6,348
20091508,58,74,47,59,26,14,2,3,283
20091509,83,70,53,43,27,9,6,2,293
20091510,44,55,58,41,14,9,4,4,229
20091511,63,69,70,61,28,14,3,3,311
20091601,51,92,61,49,33,20,1,2,309
20091602,77,83,66,47,24,11,3,3,314
20091603,61,64,37,34,20,7,5,0,228
20091604,54,64,54,36,25,10,1,3,247
20091605,46,74,60,53,31,13,3,3,283
20091606,53,88,69,62,31,16,6,1,326
20091607,64,97,72,56,25,13,6,3,336
20091608,48,79,69,60,27,9,4,5,301
20091609,59,99,64,59,34,18,1,6,340
20091610,74,71,50,57,25,13,2,5,297
20091611,50,54,49,47,34,9,3,1,247
20091612,47,69,52,48,22,10,6,5,259
20091613,83,78,60,40,18,10,4,3,296
20100101,59,78,57,38,6,11,1,0,250
20100102,89,116,70,48,20,10,0,0,353
20100103,73,98,66,76,20,4,2,2,341
20100104,57,92,66,45,20,10,3,1,294
20100105,46,77,70,48,11,5,0,1,258
20100106,61,103,68,53,16,8,0,0,309
20100107,46,74,55,46,26,9,0,2,258
20100108,70,107,65,70,30,10,1,0,353
20100201,67,121,76,60,23,4,2,0,353
20100202,81,74,51,39,10,2,0,0,257
20100203,46,65,57,47,20,6,2,2,245
20100204,54,79,82,47,27,10,1,3,303
20100205,49,94,61,62,22,6,2,1,297
20100206,68,117,80,89,28,7,4,0,393
20100207,59,101,70,67,30,8,4,1,340
20100208,58,91,81,54,24,7,1,0,316
20100301,41,71,47,38,16,7,2,0,222
20100302,52,85,56,59,25,8,3,2,290
20100303,64,89,54,51,23,10,1,1,293
20100304,51,59,42,44,17,4,0,1,218
20100305,46,92,57,52,25,8,1,2,283
20100306,69,85,61,43,12,7,0,1,278
20100307,73,104,75,63,17,6,3,1,342
20100308,68,106,68,67,22,8,5,0,344
20100401,61,113,88,75,22,8,1,2,370
20100402,74,113,98,81,29,7,0,0,402
20100403,62,74,66,53,30,13,2,0,300
20100404,56,76,67,54,26,6,1,2,288
20100405,56,77,68,62,15,5,2,1,286
20100406,38,80,42,52,16,6,1,0,235
20100407,65,94,74,49,13,5,0,1,301
20100408,52,84,53,49,17,7,1,1,264
20100409,81,91,55,53,19,5,0,1,305
20100501,41,68,62,44,15,8,2,3,243
20100502,77,100,52,37,17,7,1,1,292
20100503,84,107,74,56,19,10,3,2,355
20100504,61,103,64,65,16,9,3,2,323
20100505,63,81,69,50,23,12,1,0,299
20100506,89,106,65,51,18,8,1,1,339
20100507,59,102,54,58,19,10,3,1,306
20100508,69,116,78,54,34,4,0,2,357
20100509,60,86,57,34,18,5,2,1,263
20100510,63,93,55,55,17,11,1,1,296
20100511,45,73,59,40,21,4,3,3,248
20100512,36,90,64,38,23,8,4,2,265
20100513,44,84,69,61,24,5,1,0,288
20100514,54,77,55,60,16,5,2,0,269
20100601,40,67,53,44,18,3,4,2,231
20100602,49,75,53,43,16,6,4,1,247
20100603,82,113,85,59,31,13,3,2,388
20100604,71,98,58,53,27,6,4,2,319
20100605,99,108,61,60,17,4,3,1,353
20100606,48,95,67,49,25,10,2,2,298
20100607,42,94,71,46,21,5,3,2,284
20100608,76,112,79,46,19,5,0,2,339
20100609,77,103,83,60,18,11,3,2,357
20100610,109,106,97,77,20,11,2,0,422
20100611,50,74,72,57,19,7,1,0,280
20100612,55,88,54,46,16,5,0,2,266
20100613,87,131,80,61,26,8,1,1,395
20100701,95,112,74,58,26,13,2,1,381
20100702,92,127,87,65,24,8,1,3,407
20100703,121,143,83,71,47,6,0,0,471
20100704,139,131,75,56,20,9,1,3,434
20100705,117,122,65,36,16,8,1,1,366
20100706,68,123,57,60,23,10,1,0,342
20100707,70,148,131,112,39,9,2,4,515
20100708,91,120,79,59,24,11,0,0,384
20100709,62,97,70,73,22,14,1,0,339
20100710,85,112,93,66,26,13,4,3,402
20100801,84,129,83,74,22,10,4,0,406
20100802,87,131,84,73,29,19,2,3,428
20100803,86,94,64,52,21,1,0,1,319
20100804,82,101,70,73,30,10,0,1,367
20100805,52,106,49,60,19,11,4,1,302
20100806,42,81,58,71,24,9,3,2,290
20100807,105,121,80,77,24,16,2,0,425
20100808,83,129,95,65,23,8,2,3,408
20100809,78,78,52,36,17,3,0,0,264
20100901,96,83,62,66,13,8,0,1,329
20100902,65,90,71,59,22,8,3,3,321
20100903,60,97,57,53,26,8,0,2,303
20100904,74,103,59,49,12,10,3,0,310
20100905,45,86,72,55,26,12,1,5,302
20100906,65,86,78,68,29,15,2,0,343
20100907,59,89,61,70,21,7,2,3,312
20100908,49,79,43,58,22,4,2,2,259
20100909,54,75,49,42,19,9,1,1,250
20100910,52,81,54,57,20,12,1,2,279
20101001,60,83,64,53,14,5,1,1,281
20101002,73,85,83,65,30,10,3,1,350
20101003,40,82,90,63,27,10,3,3,318
20101004,46,93,65,54,23,1,1,1,284
20101005,55,95,62,70,15,12,3,1,313
20101006,49,87,71,73,28,3,3,0,314
20101007,67,102,55,53,17,9,3,2,308
20101008,40,83,53,44,19,11,1,3,254
20101009,86,89,77,55,28,7,4,4,350
20101010,50,76,64,44,17,8,1,2,262
20101011,82,83,52,57,18,6,2,4,304
20101012,88,106,70,45,25,5,3,4,346
20101101,68,90,66,46,26,7,4,2,309
20101102,102,145,84,65,18,14,5,0,433
20101103,107,102,80,39,12,12,1,1,354
20101104,104,115,76,58,27,10,2,2,394
20101105,55,64,74,56,27,15,4,6,301
20101106,46,48,39,21,18,8,0,3,183
20101107,71,119,78,63,22,16,4,4,377
20101108,102,119,52,42,14,12,0,3,344
20101109,94,105,69,72,28,6,5,2,381
20101110,91,92,65,38,5,4,1,0,296
20101111,60,75,54,43,14,4,1,0,251
20101201,69,97,77,68,23,8,3,2,347
20101202,101,135,63,48,17,6,0,0,370
20101203,95,83,68,33,19,4,3,4,309
20101204,75,77,39,31,9,10,1,1,243
20101205,36,51,38,29,19,8,2,6,189
20101206,46,58,46,42,11,5,3,3,214
20101207,58,65,48,38,15,6,4,4,238
20101208,80,112,60,37,13,7,2,0,311
20101209,92,105,45,41,15,9,1,0,308
20101210,57,85,51,36,14,3,0,0,246
20101301,46,58,45,39,18,14,3,3,226
20101302,46,86,53,43,19,8,0,0,255
20101303,55,74,52,54,13,8,3,2,261
20101304,68,77,54,33,10,5,0,1,248
20101305,80,105,55,49,17,9,0,0,315
20101306,51,88,64,44,21,6,2,2,278
20101307,63,69,56,38,20,6,0,2,254
20101308,59,85,69,53,16,5,1,2,290
20101309,67,88,60,47,15,4,0,0,281
20101310,68,66,39,43,11,2,1,0,230
20101311,98,101,44,37,4,2,1,0,287
20101312,76,101,49,31,9,0,1,0,267
20101401,58,109,83,57,16,9,1,1,334
20101402,59,91,54,60,33,11,5,2,315
20101403,92,97,57,43,21,8,2,2,322
20101404,50,99,56,59,17,13,0,2,296
20101405,45,89,54,46,21,5,1,1,262
20101406,33,66,47,36,15,4,1,3,205
20101407,53,82,64,56,22,11,1,2,291
20101408,76,78,51,34,10,2,1,1,253
20101409,81,101,70,45,29,9,1,1,337
20101410,92,108,69,46,18,7,0,1,341
20101411,54,85,58,48,14,7,1,0,267
20101501,83,82,38,40,13,4,1,2,263
20101502,78,112,57,70,20,6,3,1,347
20101503,44,59,41,34,13,8,1,2,202
20101504,45,80,48,55,11,7,0,1,247
20101505,69,89,62,53,15,7,1,2,298
20101506,76,75,41,31,18,4,3,0,248
20101507,67,73,45,29,7,2,1,1,225
20101508,77,106,87,56,26,13,4,6,375
20101509,111,129,94,74,39,8,2,2,459
20101601,76,90,47,38,14,4,1,0,270
20101602,90,131,80,70,22,11,3,1,408
20101603,62,93,59,34,22,7,2,3,282
20101604,80,111,76,51,20,3,3,0,344
20101605,95,115,80,67,22,8,0,2,389
20101606,62,111,84,63,18,13,2,3,356
20101607,61,92,61,52,16,6,1,0,289
20101608,69,98,52,52,29,8,2,2,312
20101609,77,88,71,62,26,5,2,7,338
20101701,94,89,65,45,19,1,0,0,313
20101702,122,130,57,39,17,4,1,2,372
20101703,78,119,78,48,26,8,1,2,360
20101704,61,103,82,97,28,7,0,0,378
20101705,78,89,81,69,31,12,3,4,367
20101706,76,67,73,48,24,15,2,3,308
20101707,60,68,54,58,24,16,5,4,289
20101708,42,78,50,45,21,9,1,0,246
20101709,59,72,40,44,14,7,1,2,239
20101710,58,81,48,55,14,10,1,2,269
20101801,70,87,49,45,19,5,2,3,280
20101802,65,68,62,35,22,12,3,3,270
20101803,112,105,59,37,15,7,1,1,337
20101804,101,98,84,64,24,17,4,4,396
20101805,92,102,39,25,11,4,3,1,277
20101806,113,79,41,29,13,4,1,0,280
20101807,136,121,54,39,11,2,0,2,365
20101808,30,56,44,37,11,6,0,0,184
20101809,111,152,92,72,22,7,1,1,458
20101810,54,51,34,22,14,13,2,1,191
20101811,45,62,46,38,22,7,4,0,224
20101812,69,80,65,46,23,13,1,0,297
20101901,99,78,55,24,7,2,0,0,265
20101902,126,138,68,61,27,12,1,3,436
20101903,74,93,85,52,31,15,1,4,355
20101904,99,112,74,38,12,4,1,0,340
20101905,117,102,57,47,15,5,3,2,348
20101906,120,88,55,52,19,5,3,5,347
20101907,103,95,67,40,18,4,1,0,328
20101908,74,57,34,33,12,5,0,0,215
20101909,80,75,51,43,14,12,0,1,276
20101910,129,115,74,53,15,11,1,2,400
20101911,83,106,56,61,27,10,1,0,344
20101912,109,126,72,78,31,8,2,3,429
20110101,68,95,66,70,11,9,3,2,324
20110102,65,109,68,57,22,18,0,0,339
20110103,56,73,48,39,20,8,1,2,247
20110104,76,86,61,67,18,3,2,3,316
20110105,53,65,40,41,14,6,2,0,221
20110106,42,79,70,57,21,7,1,1,278
20110107,63,80,43,40,20,6,0,0,252
20110108,101,88,56,31,13,3,1,2,295
20110109,76,83,72,50,15,8,0,0,304
20110110,97,107,66,47,14,8,1,0,340
20110111,115,154,76,45,10,2,0,0,402
20110112,69,96,40,40,11,9,1,0,266
20110201,47,78,68,56,25,9,1,2,286
20110202,75,105,80,68,23,9,1,0,361
20110203,74,91,56,39,23,2,0,1,286
20110204,48,80,50,32,10,2,1,0,223
20110205,74,108,101,73,23,6,2,2,389
20110206,67,97,84,86,20,4,0,0,358
20110207,65,100,60,58,21,7,1,0,312
20110208,49,85,78,55,19,12,4,0,302
20110209,38,82,56,39,12,6,3,2,238
20110210,64,96,74,68,36,7,2,1,348
20110211,79,104,70,52,16,5,2,0,328
20110301,56,89,45,53,14,7,0,0,264
20110302,60,94,63,53,12,8,1,1,292
20110303,49,83,45,37,18,4,4,0,240
20110304,41,67,45,34,13,6,4,0,210
20110305,70,74,43,27,17,2,0,0,233
20110306,67,86,58,47,23,3,3,0,287
20110307,49,85,58,65,20,6,0,0,283
20110308,81,96,56,43,14,6,2,1,299
20110309,72,102,62,43,15,3,1,0,298
20110310,79,114,60,41,16,7,0,0,317
20110311,60,80,61,29,13,9,2,0,254
20110312,61,82,64,45,26,3,1,0,282
20110401,43,81,66,51,39,3,0,1,284
20110402,64,95,56,57,15,9,1,0,297
20110403,49,69,38,37,23,3,0,2,221
20110404,49,105,57,52,28,4,1,0,296
20110405,75,111,50,41,25,4,1,1,308
20110406,48,78,52,44,14,3,1,1,241
20110407,73,82,55,40,17,7,3,2,279
20110408,65,104,52,42,16,0,2,1,282
20110409,67,100,56,52,23,7,4,0,309
20110410,81,88,50,45,9,7,0,1,281
20110411,64,85,66,54,35,4,1,4,313
20110412,83,109,79,62,17,2,0,0,352
20110413,84,105,72,49,13,4,0,0,327
20110501,39,65,61,49,25,2,0,1,242
20110502,64,96,63,57,27,6,2,1,316
20110503,86,102,49,64,35,11,5,1,353
20110504,66,87,42,39,10,7,0,1,252
20110505,76,103,86,58,14,2,0,0,339
20110506,63,94,64,69,20,7,1,1,319
20110507,52,98,51,54,16,6,3,0,280
20110508,56,87,66,71,18,6,1,2,307
20110509,61,82,57,64,14,9,4,1,292
20110510,79,127,65,39,17,7,0,0,334
20110601,93,117,63,39,4,1,0,0,317
20110602,68,107,71,68,26,9,1,1,351
20110603,102,109,67,51,14,4,0,0,347
20110604,76,91,73,54,27,8,1,3,333
20110605,86,105,56,38,9,5,1,4,304
20110606,62,90,59,60,19,13,2,1,306
20110607,49,81,81,63,22,9,2,1,308
20110608,55,99,63,46,14,6,0,1,284
20110609,58,91,65,46,25,8,4,5,302
20110610,41,77,63,57,20,9,3,1,271
20110611,66,96,64,51,23,9,4,1,314
20110701,27,41,47,29,19,6,0,2,171
20110702,68,95,72,59,30,4,0,0,328
20110703,84,73,53,51,25,9,2,0,297
20110704,56,89,85,63,21,6,3,2,325
20110705,89,110,60,60,23,4,1,2,349
20110706,52,96,61,56,19,5,1,1,291
20110707,41,83,55,60,25,6,1,2,273
20110708,48,78,45,47,24,6,0,1,249
20110709,65,84,59,54,26,6,0,2,296
20110710,54,77,73,63,16,7,0,2,292
20110711,74,108,68,56,14,2,1,0,323
20110712,59,99,51,65,20,7,2,3,306
20110801,86,100,79,54,22,5,1,0,347
20110802,78,95,73,57,29,6,0,0,338
20110803,54,69,37,38,9,2,1,0,210
20110804,122,104,64,29,8,2,0,0,329
20110805,63,87,57,45,10,2,0,1,265
20110806,93,102,86,62,28,7,1,0,379
20110807,49,114,72,74,22,11,0,3,345
20110808,83,85,78,68,34,5,2,0,355
20110809,116,124,67,40,13,3,1,1,365
20110901,56,101,66,57,24,8,3,0,315
20110902,82,76,75,58,13,7,0,1,312
20110903,75,114,92,67,26,4,1,0,379
20110904,49,90,51,50,13,2,0,0,255
20110905,85,91,69,52,11,0,0,0,308
20110906,79,86,29,40,8,2,3,1,248
20110907,95,102,57,44,12,2,0,0,312
20110908,81,108,76,50,11,4,1,0,331
20110909,87,85,44,17,9,3,0,1,246
20110910,164,107,45,23,12,1,0,0,352
20110911,74,96,49,27,8,3,1,0,258
20110912,100,104,51,19,17,6,0,0,297
20111001,108,100,51,36,19,1,0,0,315
20111002,101,132,76,53,16,3,2,1,384
20111003,96,114,60,32,12,1,0,2,317
20111004,74,126,81,56,19,6,1,1,364
20111005,113,131,65,48,22,7,0,0,386
20111006,157,161,82,40,12,5,1,0,458
20111007,99,142,83,51,15,7,3,1,401
20111008,111,97,52,37,12,8,0,1,318
20111009,87,111,58,45,15,3,0,0,319
20111010,70,96,53,33,17,10,1,1,281
20111101,61,82,62,52,21,12,1,2,293
20111102,55,85,65,69,24,7,2,2,309
20111103,64,82,59,77,27,12,1,3,325
20111104,19,30,21,18,9,3,0,2,102
20111105,54,105,74,61,28,9,4,0,335
20111106,96,120,87,60,21,10,1,1,396
20111107,50,82,70,72,23,6,1,1,305
20111108,68,91,64,62,16,9,1,4,315
20111109,52,82,61,48,28,16,3,6,296
20111201,65,67,46,39,9,7,0,0,233
20111202,58,77,50,33,15,3,0,0,236
20111203,82,106,74,63,21,13,0,1,360
20111204,84,89,53,34,8,3,1,0,272
20111205,38,92,51,42,20,2,0,0,245
20111206,62,103,62,60,28,3,0,2,320
20111207,63,86,45,43,15,6,0,1,259
20111208,60,69,64,47,22,6,3,1,272
20111209,67,74,44,35,13,5,2,0,240
20111210,86,79,50,28,12,4,2,0,261
20111301,124,132,51,30,6,3,0,0,346
20111302,139,145,52,32,10,7,2,0,387
20111303,109,102,53,44,9,4,0,0,321
20111304,120,106,61,47,8,2,0,1,345
20111305,119,142,65,45,19,2,1,0,393
20111306,94,140,78,44,13,3,1,0,373
20111307,69,82,72,55,17,3,1,0,299
20111308,68,89,59,46,10,8,1,0,281
20111309,84,105,78,68,24,10,2,0,371
20111310,60,69,57,40,20,2,1,1,250
20111311,81,110,71,55,14,2,0,3,336
20111401,83,112,69,60,28,9,2,1,364
20111402,93,95,71,49,19,4,0,1,332
20111403,77,105,74,70,26,6,5,2,365
20111404,68,91,59,41,14,4,2,0,279
20111405,52,99,63,69,30,13,1,1,328
20111406,99,136,75,63,27,5,1,3,409
20111407,191,234,145,90,25,7,4,0,696
20111501,70,101,70,60,30,11,5,2,349
20111502,56,94,80,60,22,8,1,3,324
20111503,79,105,69,74,27,8,3,3,368
20111504,69,105,74,75,28,4,1,0,356
20111505,94,102,55,62,13,3,0,0,329
20111506,43,97,77,68,21,7,0,0,313
20111507,78,101,43,37,17,5,0,0,281
20111508,110,132,68,48,12,1,1,0,372
20111509,92,114,61,46,16,7,1,0,337
20111510,54,113,74,53,22,13,1,1,331
20111511,125,139,77,57,23,11,2,0,434
20111601,54,112,63,48,29,8,2,3,319
20111602,95,120,65,50,19,7,2,1,359
20111603,57,90,57,49,11,2,1,0,267
20111604,59,73,58,40,14,5,1,2,252
20111605,65,88,52,56,19,5,2,1,288
20111606,87,113,68,46,17,4,0,0,335
20111607,96,124,61,43,20,5,0,1,350
20111608,88,135,73,63,22,10,1,1,393
20111609,68,82,41,43,17,3,1,1,256
20111610,42,73,51,43,17,7,1,2,236
20111701,51,85,63,63,16,9,2,1,290
20111702,49,85,60,57,24,9,2,0,286
20111703,77,103,66,55,28,6,1,0,336
20111704,56,101,68,58,21,13,3,4,324
20111705,56,82,64,60,26,7,2,0,297
20111706,83,111,86,82,32,13,1,0,408
20111707,58,116,68,54,23,6,2,4,331
20111708,78,97,74,44,13,10,1,5,322
20111801,54,77,60,50,26,12,0,0,279
20111802,72,92,63,52,15,7,1,1,303
20111803,66,82,65,59,22,7,6,3,310
20111804,101,119,76,50,10,12,2,0,370
20111805,81,104,60,50,10,9,2,2,318
20111806,124,142,133,84,28,8,0,2,521
20111807,86,82,70,57,20,7,1,1,324
20111808,81,109,74,47,22,10,0,3,346
20111809,61,101,65,48,19,5,2,3,304
20111901,53,67,46,39,11,4,0,1,221
20111902,76,104,74,41,15,11,0,1,322
20111903,60,101,54,42,17,4,0,1,279
20111904,71,97,88,51,23,6,1,2,339
20111905,70,90,76,47,15,7,0,1,306
20111906,68,118,63,61,17,10,0,4,341
20111907,64,91,60,61,26,11,2,4,319
20111908,74,72,65,50,26,12,0,2,301
20111909,106,101,62,55,16,5,0,3,348
20112001,109,92,70,54,21,4,2,4,356
20112002,74,105,53,47,27,4,3,4,317
20112003,75,99,81,78,40,10,3,3,389
20112004,59,84,64,59,18,11,5,3,303
20112005,75,105,74,44,13,9,6,2,328
20112006,67,74,59,36,19,9,2,1,267
20112007,54,69,43,31,20,4,6,5,232
20112008,49,56,36,28,12,9,1,0,191
20112009,41,52,45,79,35,7,1,0,260
20112010,75,84,62,38,23,4,2,4,292
20112011,45,87,45,46,19,7,2,1,252
20112101,109,81,59,46,15,6,5,2,323
20112102,55,74,55,55,22,6,2,2,271
20112103,127,145,61,64,16,9,1,0,423
20112104,90,103,68,36,17,2,1,1,318
20112105,125,114,77,49,21,2,1,2,391
20112106,102,120,79,49,24,5,4,2,385
20112107,63,75,65,43,15,8,0,1,270
20112108,59,77,42,42,21,10,3,2,256
20112109,62,62,44,38,9,0,2,1,218
20112110,56,90,60,46,21,14,2,3,292
20112111,104,117,63,60,17,7,5,1,374
20112201,86,114,61,61,17,2,1,3,345
20112202,104,86,66,59,23,14,5,1,358
20112203,79,104,69,66,23,16,1,2,360
20112204,70,71,58,46,15,3,1,1,265
20112205,69,90,63,50,23,10,2,3,310
20112206,107,123,84,60,28,5,0,2,409
20112207,102,110,61,47,19,4,1,1,345
20112208,53,89,50,45,19,7,2,4,269
20112209,57,80,51,36,28,13,2,2,269
20112210,77,104,56,37,22,11,0,0,307
20112211,51,72,53,44,18,8,0,2,248
20120101,25,60,35,46,15,5,3,2,191
20120102,19,72,37,42,17,8,1,0,196
20120103,23,48,45,50,16,1,1,3,187
20120104,75,83,49,58,31,10,6,1,313
20120105,54,66,32,37,18,6,2,2,217
20120106,67,79,64,50,17,6,2,1,286
20120107,53,101,80,68,42,9,4,3,360
20120108,37,50,43,31,13,6,2,0,182
20120109,79,100,75,65,22,10,2,3,356
20120110,110,114,55,46,25,8,2,1,361
20120111,71,115,77,70,27,12,0,2,374
20120201,96,115,72,53,21,9,2,3,371
20120202,99,100,59,38,12,7,0,1,316
20120203,132,137,73,38,11,3,0,0,394
20120204,80,109,82,72,24,9,1,2,379
20120205,85,127,95,80,10,2,2,0,401
20120206,57,110,76,60,28,9,3,1,344
20120207,73,93,68,53,19,12,0,1,319
20120208,59,110,70,61,34,6,2,3,345
20120301,28,45,15,13,1,2,0,0,104
20120302,45,80,49,47,17,8,2,1,249
20120303,52,65,55,55,30,9,2,2,270
20120304,44,72,59,59,27,2,2,3,268
20120305,54,99,48,57,20,8,4,2,292
20120306,46,73,73,91,78,40,20,30,451
20120307,79,112,94,53,29,10,1,0,378
20120308,46,79,53,38,25,6,3,3,253
20120309,45,59,51,46,11,5,2,4,223
20120310,62,87,55,64,21,7,5,4,305
20120311,70,84,63,43,23,4,1,2,290
20120401,61,68,66,50,24,5,1,2,277
20120402,69,76,57,50,21,8,5,1,287
20120403,99,145,70,64,28,9,1,2,418
20120404,57,87,61,52,24,8,4,2,295
20120405,71,74,58,26,15,3,1,1,249
20120406,66,98,71,37,17,6,2,0,297
20120407,169,178,85,51,10,6,0,0,499
20120408,58,90,61,54,14,8,2,2,289
20120409,62,56,45,34,15,10,2,0,224
20120410,60,75,45,40,16,5,2,0,243
20120501,31,61,51,41,23,1,2,2,212
20120502,105,78,41,34,13,11,1,0,283
20120503,135,179,103,90,26,6,3,1,543
20120504,93,79,50,33,16,4,0,2,277
20120505,146,113,47,32,8,1,1,0,348
20120506,120,91,48,26,11,5,0,0,301
20120507,107,103,52,48,11,4,1,1,327
20120508,117,145,91,47,15,5,1,0,421
20120509,82,95,62,55,11,6,0,0,311
20120510,81,89,47,47,15,3,2,0,284
20120511,97,107,66,37,18,3,4,0,332
20120601,94,97,62,43,13,7,1,3,320
20120602,97,111,73,42,22,3,4,1,353
20120603,49,89,50,47,15,3,4,0,257
20120604,81,101,63,57,35,10,1,1,349
20120605,88,125,79,61,26,5,2,1,387
20120606,94,121,62,66,27,8,2,0,380
20120607,136,88,41,48,12,5,1,1,332
20120608,67,98,53,43,23,4,0,0,288
20120609,95,87,64,34,13,6,2,1,302
20120610,80,109,63,41,17,5,1,0,316
20120701,69,100,66,54,22,6,1,0,318
20120702,71,83,62,64,24,5,1,0,310
20120703,67,114,64,54,19,5,1,1,325
20120704,86,108,65,68,21,9,1,1,359
20120705,76,87,48,56,16,4,1,2,290
20120706,78,113,69,54,21,11,0,1,347
20120707,72,84,54,56,22,12,0,1,301
20120708,119,98,67,55,21,3,1,1,365
20120709,201,181,86,67,15,5,0,2,557
20120710,164,137,89,57,19,7,2,1,476
20120801,129,172,93,96,34,15,6,3,548
20120802,53,83,64,50,16,5,1,1,273
20120803,69,105,60,61,18,10,2,0,325
20120804,48,60,61,60,23,8,2,0,262
20120805,186,96,33,20,9,0,0,0,344
20120806,97,125,56,53,17,4,0,0,352
20120807,115,116,61,49,15,6,0,2,364
20120808,141,127,71,64,11,1,0,0,415
20120809,99,138,68,67,19,2,3,0,396
20120810,75,101,62,39,11,0,2,0,290
20120811,63,91,55,38,12,2,0,1,262
20120901,59,95,76,77,15,6,3,0,331
20120902,90,143,82,67,23,11,3,1,420
20120903,88,109,92,68,19,7,2,0,385
20120904,81,125,74,67,32,12,0,1,392
20120905,69,109,91,58,19,9,2,1,358
20120906,91,117,77,64,21,6,1,0,377
20120907,54,93,58,61,31,6,3,1,307
20121001,75,107,80,67,29,6,0,2,366
20121002,108,127,67,58,23,5,0,2,390
20121003,72,89,60,48,10,6,1,1,287
20121004,50,69,71,54,18,7,0,1,270
20121005,91,78,54,53,16,5,1,0,298
20121006,107,98,76,45,18,5,0,4,353
20121007,73,94,56,52,14,4,2,0,295
20121008,135,144,110,62,18,7,1,0,477
20121009,75,104,55,50,21,7,2,4,318
20121010,86,86,52,39,24,7,4,1,299
20121011,90,113,64,45,17,9,4,3,345
20121101,104,98,62,49,12,3,0,0,328
20121102,77,96,41,25,17,9,2,0,267
20121103,90,77,46,24,13,3,1,0,254
20121104,95,95,68,56,17,9,3,0,343
20121105,81,71,51,52,23,10,9,10,307
20121106,67,102,65,49,22,12,2,0,319
20121107,115,95,47,50,13,8,0,2,330
20121108,77,113,55,68,18,11,2,0,344
20121109,125,112,77,40,16,3,0,0,373
20121110,46,79,56,63,21,9,3,6,283
20121111,61,82,52,48,19,13,3,0,278
20121201,88,94,43,33,12,1,1,0,272
20121202,172,163,84,65,14,3,0,0,501
20121203,142,178,91,75,15,5,2,1,509
20121204,92,103,71,63,19,5,2,1,356
20121205,83,112,68,44,15,5,1,0,328
20121206,90,95,39,27,7,1,1,0,260
20121207,124,135,69,39,14,4,1,0,386
20121208,63,71,63,46,16,7,1,0,267
20121301,145,132,61,47,15,6,1,0,407
20121302,127,130,74,34,20,3,0,1,389
20121303,223,289,114,63,25,6,0,1,721
20121304,167,193,88,55,16,5,1,1,526
20121305,160,160,84,55,14,2,0,0,475
20121306,109,152,64,48,18,4,0,0,395
20121307,108,77,34,23,6,0,1,0,249
20121401,114,127,74,46,11,1,0,0,373
20121402,132,121,68,62,14,3,0,0,400
20121403,59,117,65,49,15,2,1,0,308
20121404,149,135,61,50,9,2,1,0,407
20121405,108,152,86,60,14,1,0,0,421
20121406,69,118,66,52,11,2,0,0,318
20121407,122,140,72,69,16,8,5,0,432
20121408,165,176,73,43,9,3,0,0,469
20121409,73,115,66,54,13,3,0,0,324
20121410,133,153,67,67,13,6,2,0,441
20121501,122,107,74,52,20,3,0,0,378
20121502,162,156,58,35,10,1,0,0,422
20121503,118,147,90,42,17,5,0,1,420
20121504,127,149,71,52,15,4,0,0,418
20121505,124,130,64,54,16,3,1,1,393
20121506,84,121,75,44,13,5,1,0,343
20121507,92,159,59,57,13,3,0,0,383
20121508,82,123,72,52,26,8,0,1,364
20121509,135,137,83,50,18,3,0,0,426
20121510,44,99,58,62,24,8,1,1,297
20121511,38,79,54,61,28,9,2,1,272
20121512,64,73,61,54,26,5,1,0,284
20121513,48,96,56,46,14,2,0,0,262
20121601,78,109,81,83,31,9,2,2,395
20121602,113,108,72,44,12,10,1,3,363
20121603,82,121,74,57,18,5,2,0,359
20121604,160,189,103,53,13,2,1,0,521
20121605,198,239,94,63,19,2,2,1,618
20121606,226,218,107,66,23,6,0,1,647
20121607,113,117,57,34,9,5,3,0,338
20121608,207,198,56,51,9,6,1,0,528
20121609,110,119,66,49,12,6,0,0,362
20121610,115,140,42,28,2,2,0,1,330
20121611,97,107,58,56,10,5,1,0,334
20121612,101,109,57,30,12,6,0,1,316
20121613,52,70,38,26,12,2,1,1,202
20121614,70,58,25,18,4,0,0,0,175
20121701,70,92,83,66,27,12,4,1,355
20121702,80,128,65,59,34,9,4,1,380
20121703,78,91,58,67,25,11,1,2,333
20121704,68,95,66,54,15,7,1,0,306
20121705,86,166,95,63,19,6,1,1,437
20121706,116,130,85,54,21,4,3,1,414
20121707,83,115,79,56,29,7,2,2,373
20121708,181,181,106,63,20,4,1,1,557
20121801,42,69,60,36,19,4,0,1,231
20121802,57,97,64,62,30,9,3,1,323
20121803,66,85,82,51,28,5,0,1,318
20121804,57,101,75,52,16,4,3,0,308
20121805,60,81,66,57,27,9,1,0,301
20121806,62,80,69,59,34,5,1,2,312
20121807,74,98,71,67,18,7,0,1,336
20121808,58,102,72,62,22,11,0,1,328
20121809,64,81,48,69,23,3,1,1,290
20121810,70,78,60,52,17,3,2,2,284
20121811,42,75,54,36,21,8,2,0,238
20121812,116,132,82,64,25,14,1,2,436
20121813,68,112,64,43,15,3,1,0,306
20121901,89,116,54,54,25,11,2,1,352
20121902,58,63,47,33,16,4,2,2,225
20121903,62,78,59,59,18,6,1,0,283
20121904,66,97,87,73,29,9,2,4,367
20121905,88,119,90,70,27,9,2,1,406
20121906,57,94,77,82,33,8,4,1,356
20121907,67,97,69,60,31,20,1,1,346
20121908,82,90,76,63,27,9,2,2,351
20121909,89,100,60,51,12,4,0,0,316
20121910,67,102,70,77,32,9,1,2,360
20121911,62,101,90,67,35,15,1,1,372
20121912,90,101,64,47,26,4,1,0,333
20121913,82,90,53,41,12,6,1,1,286
20122001,68,93,66,65,17,5,2,1,317
20122002,174,194,99,60,21,9,1,1,559
20122003,111,133,75,65,19,3,4,1,411
20122004,75,131,83,72,26,1,2,1,391
20122005,99,118,72,59,23,7,3,1,382
20122006,111,124,76,66,20,9,0,1,407
20122007,85,96,79,63,18,4,1,0,346
20122008,105,93,79,54,24,6,2,2,365
20122101,148,161,76,61,18,2,0,1,467
20122102,141,178,93,49,11,3,1,0,476
20122103,92,111,64,62,22,7,2,0,360
20122104,117,136,77,66,19,6,0,0,421
20122105,55,97,62,51,22,7,2,1,297
20122106,69,91,75,69,18,2,1,1,326
20122107,56,99,81,70,27,4,3,0,340
20122108,79,114,60,42,16,7,0,1,319
20122109,37,112,51,55,22,6,3,0,286
20122110,60,84,46,47,17,3,1,0,258
20122201,65,82,69,46,26,5,0,1,294
20122202,77,116,68,73,20,7,1,0,362
20122203,71,80,69,54,20,3,2,0,299
20122204,41,86,64,74,26,6,0,2,299
20122205,81,124,97,90,32,10,1,0,435
20122206,120,137,90,64,30,4,1,2,448
20122207,127,144,100,48,28,10,2,0,459
20122208,70,114,80,71,23,6,0,1,365
20122209,92,124,72,46,22,5,1,3,365
20122210,78,120,76,69,22,3,2,0,370
20122211,79,124,87,52,20,6,1,2,371
20130101,79,102,55,35,19,6,0,0,296
20130102,114,111,58,42,16,2,0,0,343
20130103,69,93,46,37,11,1,0,1,258
20130104,137,133,52,32,6,4,2,1,367
20130105,176,138,62,35,5,4,0,1,421
20130106,123,123,73,48,12,7,0,0,386
20130107,38,55,40,28,17,5,2,0,185
20130108,79,76,54,19,10,2,1,0,241
20130109,86,61,43,19,5,3,0,0,217
20130110,90,123,55,29,11,5,1,0,314
20130111,100,104,55,26,8,6,1,0,300
20130112,88,78,43,24,10,1,2,0,246
20130113,51,93,47,36,11,4,3,0,245
20130114,136,82,32,27,3,2,1,0,283
20130201,238,177,76,36,13,4,1,0,545
20130202,91,135,64,51,7,9,2,0,359
20130203,78,96,39,31,11,3,1,0,259
20130204,50,68,48,42,22,5,4,0,239
20130205,100,105,60,48,9,5,2,1,330
20130206,192,158,58,45,15,2,0,0,470
20130207,98,99,54,38,10,0,1,0,300
20130208,75,81,40,40,14,2,1,0,253
20130209,91,128,61,78,28,8,2,0,396
20130210,128,166,87,62,18,6,1,0,468
20130211,119,87,47,24,13,3,0,0,293
20130301,125,129,63,40,19,1,0,0,377
20130302,97,92,38,28,13,1,1,0,270
20130303,125,111,57,40,17,3,0,0,353
20130304,116,147,79,51,28,9,2,1,433
20130305,75,102,49,65,16,3,2,0,312
20130306,77,86,57,32,15,2,1,1,271
20130307,100,87,50,34,12,6,1,0,290
20130308,88,96,54,23,11,6,0,0,278
20130309,92,96,54,68,32,12,0,0,354
20130310,173,124,68,70,11,2,0,0,448
20130401,118,93,40,25,9,5,0,1,291
20130402,133,102,51,45,10,6,3,0,350
20130403,122,86,45,37,11,1,1,1,304
20130404,134,148,58,63,23,4,0,0,430
20130405,137,129,45,35,14,3,0,0,363
20130406,134,134,74,40,14,3,1,0,400
20130407,100,100,49,36,8,3,0,0,296
20130408,87,73,45,46,12,2,0,0,265
20130409,125,114,61,32,6,2,0,1,341
20130410,116,74,34,9,3,0,1,0,237
20130411,127,112,68,49,11,3,0,0,370
20130412,197,196,116,75,22,5,0,2,613
20130413,119,127,43,37,9,2,0,0,337
20130414,114,104,54,44,8,3,0,0,327
20130501,120,120,51,38,12,2,1,0,344
20130502,125,132,75,48,14,6,3,0,403
20130503,188,176,81,63,19,1,1,1,530
20130504,165,180,74,43,12,2,0,2,478
20130505,99,106,78,48,20,5,3,0,359
20130506,151,141,80,51,8,6,0,0,437
20130507,100,93,73,37,20,4,0,0,327
20130508,156,136,60,53,9,3,0,0,417
20130601,74,82,73,43,7,4,0,0,283
20130602,108,136,79,75,22,4,0,1,425
20130603,98,118,63,54,23,9,2,1,368
20130604,144,150,64,44,11,5,1,0,419
20130605,168,163,71,31,18,3,0,0,454
20130606,136,125,58,33,12,2,2,0,368
20130607,139,142,62,54,21,5,1,1,425
20130608,93,123,59,45,16,3,0,0,339
20130701,54,79,65,48,18,7,0,0,271
20130702,59,74,39,33,7,8,0,1,221
20130703,151,167,72,48,15,2,2,0,457
20130704,114,123,58,32,12,4,1,0,344
20130705,157,167,80,49,18,4,1,0,476
20130706,128,135,59,47,9,0,3,0,381
20130707,101,109,74,48,13,0,1,0,346
20130708,94,85,59,56,13,2,0,0,309
20130709,138,119,64,33,13,5,0,1,373
20130801,124,106,45,31,4,3,1,0,314
20130802,110,102,36,18,5,1,2,1,275
20130803,129,138,74,51,17,1,1,0,411
20130804,131,121,69,43,18,5,1,0,388
20130805,178,154,65,44,8,2,0,1,452
20130806,95,94,52,41,11,0,1,1,295
20130807,132,104,65,49,10,2,1,1,364
20130808,128,164,79,44,20,4,0,0,439
20130809,118,104,49,45,6,3,1,0,326
20130810,97,93,53,37,12,0,0,0,292
20130901,95,82,46,47,14,3,0,0,287
20130902,99,92,50,47,12,3,0,0,303
20130903,84,101,36,19,6,1,0,0,247
20130904,133,87,41,20,10,2,0,0,293
20130905,141,169,103,50,16,7,0,2,488
20130906,122,101,45,40,6,6,0,0,320
20130907,100,103,48,28,11,5,0,1,296
20130908,99,128,54,49,10,3,1,0,344
20130909,111,117,57,50,18,9,0,1,363
20130910,81,87,30,24,11,4,1,1,239
20131001,189,124,59,34,6,3,0,0,415
20131002,140,135,75,39,7,7,1,0,404
20131003,142,128,84,54,17,1,1,0,427
20131004,142,123,82,55,14,1,0,0,417
20131005,90,79,29,37,17,0,0,0,252
20131006,114,135,69,47,18,4,1,0,388
20131007,123,115,43,24,13,3,0,0,321
20131008,179,146,60,29,16,2,0,0,432
20131009,120,101,48,46,9,1,0,0,325
20131010,161,147,57,38,14,5,1,1,424
20131011,149,88,33,30,12,2,0,0,314
20131101,32,52,29,36,13,9,0,1,172
20131102,33,79,48,55,18,4,2,2,241
20131103,38,67,45,34,9,8,6,0,207
20131104,63,77,43,28,12,5,0,1,229
20131105,46,74,43,38,14,4,2,1,222
20131106,98,122,88,57,22,13,6,2,408
20131107,68,92,57,42,17,6,2,0,284
20131201,88,71,58,28,22,6,2,2,277
20131202,61,93,64,69,22,7,3,1,320
20131203,53,86,36,36,14,10,0,2,237
20131204,123,86,54,57,21,7,4,0,352
20131205,37,49,43,51,24,11,3,0,218
20131206,72,75,40,40,11,2,0,0,240
20131207,100,114,60,40,15,9,2,1,341
20131208,105,80,47,35,8,6,1,0,282
20131209,103,129,76,45,24,6,0,1,384
20131210,77,90,40,30,10,2,0,0,249
20131301,75,116,78,62,36,7,2,0,376
20131302,63,54,22,9,4,2,0,1,155
20131303,100,110,57,39,8,6,2,0,322
20131304,138,134,64,46,12,0,0,0,394
20131305,155,153,61,29,11,2,0,0,411
20131306,54,50,12,15,0,0,0,1,132
20131307,121,102,41,30,6,4,1,0,305
20131308,54,84,47,38,22,4,0,0,249
20131309,61,95,49,43,28,8,2,1,287
20131310,85,132,53,46,28,13,0,1,358
20131311,38,61,46,48,20,1,1,0,215
20131312,60,121,63,44,25,10,4,0,327
20131313,196,174,93,70,22,1,0,0,556
20131314,164,95,51,26,8,3,1,0,348
20131401,106,117,56,44,16,2,0,0,341
20131402,48,59,25,20,5,3,2,0,162
20131403,180,119,40,22,3,2,1,0,367
20131404,76,101,43,35,29,7,0,0,291
20131405,75,64,47,28,10,3,1,0,228
20131406,107,126,65,38,13,6,3,1,359
20131407,55,50,23,28,7,1,1,0,165
20131408,76,86,43,32,10,7,0,0,254
20131409,71,97,31,25,8,6,0,0,238
20131410,76,105,48,50,17,2,0,0,298
20131411,60,84,45,55,25,12,1,2,284
20131501,123,119,61,39,4,3,1,0,350
20131502,151,117,52,31,8,1,0,0,360
20131503,124,124,51,34,13,3,0,0,349
20131504,84,59,26,19,10,1,0,0,199
20131505,157,134,46,37,11,6,0,0,391
20131506,83,93,51,38,11,5,0,0,281
20131507,147,125,54,46,6,5,0,0,383
20131508,163,125,52,17,14,1,0,0,372
20131509,154,139,71,41,8,3,0,0,416
20131510,152,107,31,32,9,0,0,0,331
20131511,151,126,48,36,5,2,1,0,369
20131512,142,98,46,32,10,0,0,0,328
20131601,146,130,64,42,7,2,1,0,392
20131602,164,154,73,29,9,1,0,0,430
20131603,101,84,39,20,5,3,0,0,252
20131604,151,142,48,19,7,1,0,0,368
20131605,115,64,37,21,7,5,1,2,252
20131606,55,63,38,20,6,0,1,0,183
20131607,130,132,66,35,5,0,0,1,369
20131608,181,78,52,32,4,5,0,0,352
20131609,135,124,64,38,17,0,1,1,380
20131610,141,129,69,35,11,4,2,0,391
20131611,166,126,59,24,4,1,1,0,381
20131612,125,128,45,36,10,2,0,1,347
20131613,60,69,40,39,12,3,0,0,223
20131701,146,168,86,61,11,3,0,1,476
20131702,147,162,83,57,19,4,0,0,472
20131703,143,129,69,33,13,2,0,0,389
20131704,80,87,46,19,11,1,1,2,247
20131705,140,115,47,28,11,1,1,2,345
20131706,128,131,48,37,11,4,1,0,360
20131707,140,119,61,53,11,2,0,0,386
20131708,91,115,47,48,7,6,2,0,316
20131709,120,152,50,61,15,5,0,0,403
20131710,106,134,83,57,15,3,0,0,398
20131711,77,72,55,33,8,2,0,0,247
20131801,83,123,58,44,16,7,2,1,334
20131802,145,149,55,43,10,2,2,1,407
20131803,108,137,80,47,22,1,2,0,397
20131804,86,89,55,42,15,5,0,2,294
20131805,75,89,46,58,6,7,1,0,282
20131806,72,119,47,39,20,3,2,0,302
20131807,99,122,63,64,29,4,2,0,383
20131808,66,90,45,44,23,10,1,1,280
20131809,33,55,32,24,16,9,1,0,170
20131810,52,89,44,47,26,12,1,3,274
20131901,100,123,53,46,14,3,1,0,340
20131902,124,124,62,63,21,3,0,0,397
20131903,87,100,42,46,18,2,0,0,295
20131904,73,80,37,29,8,0,0,0,227
20131905,102,140,62,50,10,2,0,0,366
20131906,69,60,46,30,10,0,0,0,215
20131907,64,69,43,50,17,7,5,2,257
20131908,116,112,40,40,17,4,0,0,329
20131909,148,110,37,25,10,2,0,0,332
20131910,102,110,45,41,12,2,0,0,312
20131911,82,57,16,30,7,1,0,0,193
20131912,61,89,51,42,17,7,1,0,268
20132001,95,120,47,28,9,1,1,0,301
20132002,114,126,80,46,18,8,1,1,394
20132003,43,69,33,22,6,1,0,1,175
20132004,106,121,41,32,11,4,1,0,316
20132005,135,111,32,26,5,1,2,0,312
20132006,183,159,46,29,6,5,0,0,428
20132007,144,101,53,51,14,7,2,0,372
20132008,148,135,58,34,11,0,0,0,386
20132009,93,90,37,28,6,3,1,0,258
20132010,100,97,41,25,8,0,1,0,272
20132011,80,94,40,32,11,3,0,1,261
20132012,112,86,46,24,8,1,0,0,277
20132101,71,75,49,27,13,9,0,0,244
20132102,54,56,21,12,4,2,0,0,149
20132103,88,66,25,33,17,3,1,0,233
20132104,65,105,56,56,28,9,0,0,319
20132105,61,76,47,53,43,8,3,0,291
20132106,95,98,52,35,21,10,1,0,312
20132107,113,148,91,62,23,11,2,0,450
20132108,141,101,41,45,13,4,0,0,345
20132109,118,110,64,43,17,7,0,1,360
20132110,67,122,51,68,26,7,0,1,342
20132201,79,76,51,28,14,1,2,0,251
20132202,70,67,38,32,11,2,1,0,221
20132203,85,73,31,22,8,2,1,0,222
20132204,71,92,67,60,29,6,0,2,327
20132205,69,126,61,73,42,17,5,1,394
20132206,59,125,84,72,36,13,1,1,391
20132207,132,151,69,65,28,10,0,0,455
20132208,159,98,62,41,13,4,0,0,377
20132209,52,78,40,31,15,4,0,0,220
20132301,190,183,82,67,18,4,1,0,545
20132302,114,97,33,23,2,1,0,0,270
20132303,213,176,81,51,15,2,0,0,538
20132304,111,105,41,26,10,1,0,0,294
20132305,79,97,34,18,4,1,3,0,236
20132306,132,126,72,30,7,0,1,0,368
20132307,108,82,36,27,2,2,0,0,257
20132308,207,157,76,40,16,8,1,0,505
20132309,129,146,75,50,23,5,0,1,429
20132310,73,85,38,32,13,2,0,0,243
20132311,184,148,46,32,11,3,0,0,424
20132401,47,76,39,27,7,2,0,0,198
20132402,92,73,42,28,12,4,1,0,252
20132403,75,100,55,41,9,2,1,0,283
20132404,133,115,55,42,15,4,0,0,364
20132405,78,80,54,53,15,4,1,1,286
20132406,103,113,51,29,15,7,0,0,318
20132407,77,119,89,56,19,7,0,0,367
20132408,87,109,64,54,20,3,1,1,339
20132409,104,114,63,63,29,7,0,1,381
20132410,75,78,50,54,18,5,1,2,283
20132501,92,82,35,40,10,2,0,1,262
20132502,73,88,60,35,12,9,1,1,279
20132503,134,124,74,38,15,5,2,0,392
20132504,81,76,46,46,12,6,0,2,269
20132505,54,54,52,38,18,3,1,1,221
20132506,68,79,54,51,17,4,1,0,274
20132507,146,173,96,72,16,1,0,0,504
20132508,135,119,49,47,9,5,0,0,364
20132601,92,90,56,45,19,9,2,3,316
20132602,109,87,55,49,17,7,0,1,325
20132603,102,84,36,43,18,4,0,1,288
20132604,163,143,61,30,17,2,2,1,419
20132605,99,107,56,33,17,3,2,0,317
20132606,82,90,47,32,10,4,0,0,265
20132607,43,70,41,21,10,2,1,1,189
20132608,83,65,29,25,7,3,2,0,214
20132609,61,65,34,28,10,3,1,0,202
20132610,166,130,78,38,19,4,1,0,436
20132611,87,93,55,27,17,0,2,0,281
20132701,37,71,35,23,8,1,0,0,175
20132702,138,135,73,38,13,2,0,0,399
20132703,169,143,69,46,10,2,0,1,440
20132704,138,122,66,43,15,2,1,0,387
20132705,127,107,46,20,9,2,0,0,311
20132706,210,177,69,53,16,2,2,0,529
20132707,201,160,73,45,16,1,1,0,497
20132708,129,124,51,43,18,1,1,1,368
20132709,138,146,70,37,16,0,0,0,407
20132801,111,92,34,25,6,0,0,0,268
20132802,92,67,34,19,1,0,0,0,213
20132803,118,105,53,33,7,1,1,0,318
20132804,87,63,33,13,5,0,0,0,201
20132805,59,76,43,23,8,7,1,0,217
20132806,109,122,59,42,19,5,0,0,356
20132807,105,135,47,36,4,1,1,0,329
20132808,170,156,63,47,14,0,1,0,451
20132809,155,145,55,31,6,1,0,0,393
20132810,86,91,52,27,11,5,1,0,273
20132901,68,94,57,36,13,5,0,1,274
20132902,90,102,43,26,13,7,0,0,281
20132903,90,77,39,28,9,4,0,0,247
20132904,124,131,72,41,8,6,0,0,382
20132905,119,95,35,25,5,1,0,0,280
20132906,103,107,60,43,13,1,1,2,330
20132907,94,111,71,48,24,4,2,1,355
20132908,114,107,92,64,31,6,3,3,420
20132909,40,68,43,35,14,5,2,1,208
20132910,41,62,66,51,22,8,5,3,258
20132911,113,84,66,35,22,4,1,2,327
20140101,80,79,22,22,5,2,0,0,210
20140102,81,96,40,24,11,3,0,0,255
20140103,163,114,57,40,19,4,3,0,400
20140104,100,98,65,62,24,8,4,1,362
20140105,191,186,95,73,28,10,1,1,585
20140106,155,141,71,49,26,4,0,0,446
20140107,106,140,55,40,18,8,0,0,367
20140108,46,102,46,54,35,12,4,0,299
20140109,99,128,80,52,27,10,2,0,398
20140110,103,149,92,75,30,8,5,0,462
20140201,170,150,81,73,23,5,2,1,505
20140202,111,92,36,24,7,1,0,0,271
20140203,98,110,61,48,24,5,1,2,349
20140204,131,93,57,28,8,3,0,0,320
20140205,130,116,44,29,16,5,0,0,340
20140206,78,77,40,51,18,2,1,1,268
20140207,100,107,65,33,9,3,0,0,317
20140208,116,147,67,47,19,5,0,1,402
20140209,113,122,63,56,19,6,0,1,380
20140210,157,136,70,69,33,8,1,0,474
20140301,277,262,98,89,25,6,1,0,758
20140302,76,76,36,30,6,2,0,0,226
20140303,108,72,20,18,6,2,0,0,226
20140304,82,89,38,44,34,9,1,0,297
20140305,149,136,71,35,12,2,0,2,407
20140306,39,56,31,26,10,2,0,0,164
20140307,113,96,37,38,10,2,0,1,297
20140308,176,161,45,38,6,4,0,0,430
20140309,207,134,64,36,11,1,3,0,456
20140310,132,84,51,31,6,4,0,0,308
20140311,140,114,48,33,9,2,1,0,347
20140312,115,87,47,37,15,4,0,0,305
20140401,158,132,55,49,17,2,0,0,413
20140402,48,69,40,30,21,8,3,1,220
20140403,66,49,39,46,15,2,0,1,218
20140404,86,113,50,33,9,2,0,0,293
20140405,129,133,61,46,12,3,0,0,384
20140406,181,157,63,42,9,1,1,0,454
20140407,160,141,71,47,7,4,2,0,432
20140408,166,157,66,54,26,9,2,2,482
20140409,197,152,52,20,12,0,0,0,433
20140410,264,236,97,72,19,8,1,0,697
20140501,111,132,64,36,11,1,0,2,357
20140502,71,124,90,65,15,4,1,0,370
20140503,147,135,64,46,17,3,0,0,412
20140504,129,99,23,19,11,2,0,1,284
20140505,230,148,69,44,13,2,0,1,507
20140506,88,94,44,38,9,2,2,0,277
20140507,70,94,36,24,9,2,1,0,236
20140508,56,65,35,20,7,6,0,1,190
20140509,129,169,102,77,19,5,1,0,502
20140510,164,194,85,67,23,13,0,0,546
20140601,219,186,66,27,9,3,1,1,512
20140602,161,140,53,33,6,5,1,2,401
20140603,118,115,61,52,25,8,1,0,380
20140604,156,111,57,24,9,3,1,0,361
20140605,153,130,53,40,8,1,1,1,387
20140606,189,155,79,64,13,8,2,1,511
20140607,131,106,70,36,10,2,3,1,359
20140608,87,91,47,23,2,3,0,0,253
20140609,185,119,57,21,17,2,0,1,402
20140610,107,58,28,14,4,2,0,0,213
20140701,128,106,66,45,20,9,1,0,375
20140702,157,124,61,35,20,9,4,1,411
20140703,66,82,63,44,18,16,0,0,289
20140704,116,108,74,68,23,11,2,0,402
20140705,57,80,53,37,19,10,3,1,260
20140706,87,103,54,35,14,5,2,1,301
20140707,57,78,48,31,11,9,1,5,240
20140708,82,80,33,29,11,1,3,0,239
20140709,114,79,40,28,8,3,2,1,275
20140801,119,115,63,48,15,6,0,0,366
20140802,126,87,40,25,6,2,2,2,290
20140803,76,53,20,11,5,3,1,0,169
20140804,124,69,29,13,7,2,1,0,245
20140805,199,163,64,43,9,4,0,0,482
20140806,188,165,71,32,10,3,0,0,469
20140807,124,82,51,33,7,4,0,0,301
20140808,102,107,45,31,15,2,1,3,306
20140809,179,175,65,43,8,5,1,0,476
20140901,154,137,93,70,27,5,2,3,491
20140902,67,79,47,61,35,10,3,1,303
20140903,214,159,72,53,22,3,2,0,525
20140904,211,145,77,55,31,16,2,0,537
20140905,80,66,28,19,4,1,0,0,198
20140906,88,93,56,48,8,1,2,0,296
20140907,77,87,35,41,16,7,0,1,264
20140908,177,105,57,39,8,5,0,0,391
20140909,121,136,44,47,13,1,0,1,363
20140910,194,161,47,47,11,2,0,0,462
20140911,179,120,51,32,11,2,0,0,395
20140912,158,133,60,54,10,3,0,0,418
20140913,157,123,37,23,8,0,0,1,349
20141001,0,4,2,0,0,0,0,0,6
20141101,98,94,42,32,12,4,1,1,284
20141102,204,132,64,49,15,4,0,0,468
20141103,93,71,36,26,6,5,0,0,237
20141104,74,92,47,36,16,12,1,1,279
20141105,147,110,64,50,8,0,0,0,379
20141106,93,102,63,61,23,11,0,0,353
20141107,126,85,33,9,11,3,0,0,267
20141108,213,189,75,37,15,0,0,0,529
20141109,218,132,42,17,2,0,1,0,412
20141110,107,61,20,13,5,1,0,1,208
20141111,176,97,27,10,3,2,0,1,316
20141112,166,119,37,29,7,4,0,0,362
20141113,177,132,45,32,8,3,2,0,399
20141114,80,74,38,22,11,4,2,0,231
20141201,111,67,26,20,5,1,0,0,230
20141202,154,111,53,45,12,2,3,2,382
20141203,154,96,45,23,6,5,0,0,329
20141204,155,106,52,25,4,2,0,0,344
20141205,144,120,62,32,16,3,2,1,380
20141206,110,81,36,23,10,3,1,0,264
20141207,44,56,24,19,2,0,0,0,145
20141208,100,48,26,12,2,0,0,0,188
20141209,147,122,29,19,9,1,0,0,327
20141210,126,128,47,41,6,3,0,1,352
20141211,114,84,43,24,7,2,0,0,274
20141301,74,89,38,34,16,6,5,5,267
20141302,128,101,37,22,17,6,1,1,313
20141303,204,111,53,28,8,2,0,0,406
20141304,80,70,37,32,11,10,1,1,242
20141305,101,88,51,40,16,2,1,2,301
20141306,120,83,40,20,9,3,2,1,278
20141307,52,47,25,12,8,2,1,0,147
20141308,103,85,31,33,15,4,0,4,275
20141309,128,97,48,38,16,7,2,1,337
20141310,92,96,51,41,9,2,2,1,294
20141311,110,79,42,16,7,5,1,0,260
20141312,89,75,37,32,7,5,1,1,247
20141401,224,145,56,26,8,1,0,0,460
20141402,111,104,38,25,10,1,1,0,290
20141403,143,115,56,35,9,0,0,0,358
20141404,85,54,26,21,5,2,0,1,194
20141405,81,61,25,18,7,4,1,0,197
20141406,76,59,37,20,6,4,0,0,202
20141407,69,48,55,18,8,10,0,2,210
20141408,187,141,80,39,13,2,0,0,462
20141409,187,168,76,34,14,3,1,0,483
20141410,149,127,43,20,10,0,0,0,349
20141411,171,126,66,32,12,4,0,0,411
20141501,127,95,62,24,5,4,1,1,319
20141502,140,109,51,27,19,3,0,2,351
20141503,157,109,53,24,2,4,1,0,350
20141504,147,129,63,28,8,3,0,1,379
20141505,185,140,75,35,8,0,0,0,443
20141506,176,147,60,40,13,3,0,1,440
20141507,156,129,40,16,3,4,0,0,348
20141508,310,325,123,92,24,11,1,0,886
20141601,195,212,89,67,19,7,1,1,591
20141602,121,87,48,43,18,10,3,1,331
20141603,187,205,55,52,19,6,0,0,524
20141604,130,124,55,52,27,7,0,2,397
20141605,110,116,65,42,25,14,1,1,374
20141606,25,53,22,11,11,0,0,0,122
20141607,106,113,56,33,9,5,2,0,324
20141701,98,137,58,37,17,5,0,0,352
20141702,154,107,60,38,17,10,2,2,390
20141703,108,99,57,42,21,10,1,0,338
20141704,88,75,19,12,9,3,2,0,208
20141705,123,100,45,36,18,5,1,0,328
20141706,90,71,49,34,21,8,1,0,274
20141707,105,96,47,37,12,17,2,0,316
20141708,231,213,81,66,24,7,0,1,623
20141801,134,126,50,30,10,3,2,0,355
20141802,100,98,44,49,21,2,0,0,314
20141803,150,172,68,55,23,8,0,0,476
20141804,114,145,60,50,17,4,1,0,391
20141805,180,147,57,68,9,4,0,1,466
20141806,120,97,68,37,30,2,0,0,354
20141807,90,108,47,29,7,0,0,1,282
20141808,211,183,60,24,7,4,0,0,489
20141901,125,85,38,17,6,3,0,2,276
20141902,264,147,71,38,8,1,0,0,529
20141903,241,166,87,38,10,4,0,0,546
20141904,274,207,76,59,7,4,0,1,628
20141905,224,232,93,71,24,5,1,2,652
20142001,235,194,91,64,13,5,0,2,604
20142002,282,217,88,52,15,6,1,0,661
20142003,183,159,73,41,11,3,0,0,470
20142004,131,133,52,45,11,2,0,0,374
20142005,161,113,50,36,10,3,0,2,375
20142006,141,78,24,23,8,1,0,0,275
20142007,80,55,14,12,5,0,1,1,168
20142101,159,117,65,40,16,1,1,0,399
20142102,113,90,45,37,11,7,0,0,303
20142103,44,62,14,14,8,1,2,0,145
20142104,100,89,34,16,12,2,0,1,254
20142105,48,50,29,20,7,2,2,0,158
20142106,88,80,33,31,4,4,5,1,246
20142107,102,106,50,30,15,5,1,0,309
20142108,112,124,43,30,9,5,0,0,323
20142109,113,78,28,33,9,1,1,3,266
20142110,107,77,43,15,2,6,0,2,252
20142111,80,91,47,40,22,2,0,2,284
20142201,124,115,63,46,16,4,0,0,368
20142202,174,113,52,41,21,5,1,0,407
20142203,101,62,39,24,3,2,1,1,233
20142204,75,78,43,34,6,2,2,0,240
20142205,177,121,57,38,16,10,1,3,423
20142206,110,123,88,55,28,6,2,3,415
20142207,108,98,51,40,19,3,2,1,322
20142208,113,119,49,36,16,5,2,0,340
20142209,238,185,43,29,4,1,0,0,500
20142210,131,119,58,19,4,3,1,1,336
20142301,100,91,53,30,4,3,0,0,281
20142302,81,73,30,24,6,3,1,0,218
20142303,84,79,38,24,15,2,0,1,243
20142304,155,127,40,36,7,3,0,0,368
20142305,223,161,70,47,11,3,1,0,516
20142306,74,83,26,21,7,1,0,0,212
20142307,150,105,36,33,13,3,0,1,341
20142308,176,149,82,54,15,5,0,1,482
20142309,233,142,55,44,12,6,0,0,492
20142310,147,144,51,25,5,5,1,0,378
20142311,218,146,55,34,8,1,0,0,462
20142401,138,80,29,43,10,1,0,0,301
20142402,96,79,29,20,7,1,0,0,232
20142403,112,103,27,21,6,0,0,0,269
20142404,106,56,28,13,3,3,1,0,210
20142405,204,145,48,29,7,3,0,0,436
20142406,145,97,50,37,9,3,2,0,343
20142407,130,107,42,44,5,2,1,0,331
20142408,113,82,45,21,5,1,0,0,267
20142409,147,109,39,32,17,3,1,0,348
20142501,153,126,54,36,8,4,2,0,383
20142502,85,73,34,19,4,0,1,0,216
20142503,167,117,40,20,9,0,0,0,353
20142504,133,96,35,18,3,0,0,0,285
20142505,100,80,36,17,6,0,0,0,239
20142506,160,78,18,15,6,0,0,0,277
20142507,172,112,47,31,8,2,0,1,373
20142508,144,125,41,33,9,0,3,0,355
20142509,223,122,38,17,4,1,0,0,405
20142601,227,175,56,48,14,4,1,1,526
20142602,144,123,44,30,12,3,0,1,357
20142603,63,63,24,22,11,0,1,0,184
20142604,329,292,125,81,19,3,1,0,850
20142605,175,159,69,35,17,2,1,0,458
20142606,108,126,72,52,19,10,0,0,387
20142607,183,181,80,60,23,5,0,0,532
20142701,255,202,88,52,16,3,0,0,616
20142702,247,190,66,42,19,5,1,0,570
20142703,112,97,37,24,10,4,0,0,284
20142704,169,134,54,31,7,1,0,0,396
20142705,216,164,67,30,6,3,0,1,487
20142706,83,78,30,15,6,0,0,0,212
20142707,90,74,25,22,5,0,1,0,217
20142801,114,96,50,23,14,2,0,0,299
20142802,80,92,40,41,10,2,1,0,266
20142803,105,83,32,41,18,8,1,0,288
20142804,99,124,40,34,13,3,1,0,314
20142805,69,73,35,29,15,6,0,1,228
20142806,127,145,71,47,20,3,0,0,413
20142807,150,123,70,22,8,1,0,0,374
20142808,163,89,29,14,4,1,1,1,302
20142809,93,84,43,31,8,3,1,0,263
20142810,144,111,60,42,16,7,1,0,381
20142811,98,134,69,60,26,3,0,2,392
20142812,95,103,34,22,11,4,1,0,270
20142901,122,89,32,26,3,5,0,0,277
20142902,143,78,31,24,2,2,0,0,280
20142903,126,84,30,18,11,1,0,0,270
20142904,138,125,45,34,9,5,1,1,358
20142905,155,80,26,15,3,1,0,0,280
20142906,227,135,44,27,14,1,0,0,448
20142907,146,109,52,48,20,2,2,0,379
20142908,91,87,40,32,14,3,0,0,267
20142909,122,115,49,33,13,4,0,0,336
20142910,144,122,38,38,13,9,2,0,366
20142911,100,87,41,29,18,5,1,0,281
20143001,92,108,52,41,24,8,1,1,327
20143002,150,131,74,37,32,2,2,1,429
20143003,170,125,54,38,14,6,0,0,407
20143004,149,89,35,21,8,3,0,0,305
20143005,93,131,66,50,30,7,1,0,378
20143006,86,89,34,14,6,4,0,0,233
20143007,99,61,22,16,4,2,0,0,204
20143008,189,242,109,72,39,20,3,1,675
20143009,204,184,102,58,19,10,1,1,579
20143101,49,61,31,33,29,11,2,1,217
20143102,91,99,52,52,18,11,4,0,327
20143103,103,83,45,33,11,3,1,0,279
20143104,58,88,42,34,20,6,2,0,250
20143105,82,73,41,28,18,9,0,0,251
20143106,108,115,71,67,35,5,3,2,406
20143107,53,117,55,50,26,11,3,0,315
20143108,71,80,45,33,20,9,5,6,269
20143109,42,71,45,32,16,13,4,2,225
20143110,43,54,46,25,13,11,0,3,195
20143111,104,70,23,11,3,2,1,0,214
20143112,99,80,31,33,12,4,1,0,260
20150101,102,148,82,53,27,3,2,0,417
20150102,72,105,69,66,24,5,1,2,344
20150103,62,94,44,47,15,5,0,1,268
20150104,51,77,49,40,13,4,2,1,237
20150105,55,73,52,53,21,10,3,1,268
20150106,41,74,53,60,24,4,0,1,257
20150107,79,90,62,43,14,2,0,0,290
20150108,69,88,50,39,23,5,1,1,276
20150109,62,107,71,61,30,5,5,1,342
20150110,67,101,70,68,22,8,3,1,340
20150111,45,65,50,40,18,2,0,0,220
20150112,57,105,54,45,9,10,1,2,283
20150201,56,84,68,47,15,8,1,1,280
20150202,64,91,54,62,18,9,1,1,300
20150203,49,81,77,59,17,7,0,2,292
20150204,40,66,45,39,17,1,0,0,208
20150205,50,71,42,33,9,2,0,1,208
20150206,60,79,59,48,12,8,2,0,268
20150207,87,88,44,37,16,6,1,0,279
20150208,40,73,44,51,23,4,1,0,236
20150209,36,70,50,38,9,7,0,2,212
20150210,54,63,67,32,14,1,1,1,233
20150301,82,85,54,46,12,6,4,0,289
20150302,114,140,75,42,19,4,5,0,399
20150303,110,123,72,49,20,7,0,1,382
20150304,57,76,47,57,18,11,1,2,269
20150305,34,68,49,47,22,12,1,9,242
20150306,56,90,55,43,16,7,5,0,272
20150307,27,80,57,49,28,6,2,2,251
20150308,60,101,67,62,31,7,0,1,329
20150309,104,104,59,45,23,8,3,3,349
20150310,89,107,66,54,18,5,1,0,340
20150311,121,106,57,37,13,4,2,0,340
20150312,74,120,79,83,26,20,5,4,411
20150313,75,97,54,39,15,7,2,2,291
20150401,96,96,69,36,29,10,0,1,337
20150402,64,72,51,34,24,5,4,2,256
20150403,134,116,72,42,22,13,0,2,401
20150404,52,51,39,40,17,5,0,2,206
20150405,57,60,48,36,17,5,4,3,230
20150406,72,72,49,50,13,8,3,3,270
20150407,78,85,65,47,16,12,2,3,308
20150408,83,83,65,42,11,9,1,3,297
20150409,82,76,52,29,17,6,1,1,264
20150410,63,91,47,34,14,5,3,0,257
20150411,81,90,49,38,23,11,2,2,296
20150412,113,116,62,38,18,4,1,1,353
20150413,93,117,67,29,15,2,3,2,328
20150414,62,83,75,58,28,12,0,0,318
20150501,78,90,70,42,17,6,0,0,303
20150502,72,104,76,73,25,7,0,1,358
20150503,53,84,60,51,25,4,0,1,278
20150504,64,82,38,28,16,5,0,2,235
20150505,68,96,65,49,14,9,0,0,301
20150506,63,74,69,50,20,5,1,0,282
20150507,63,103,53,49,5,4,3,1,281
20150508,75,98,74,49,19,13,3,3,334
20150509,57,67,55,39,26,6,3,5,258
20150510,48,58,50,38,17,8,1,4,224
20150511,58,88,52,47,16,10,0,3,274
20150512,65,82,60,38,17,7,0,3,272
20150513,72,90,57,43,20,6,0,1,289
20150514,59,70,45,59,19,7,1,1,261
20150601,85,100,54,33,17,1,0,1,291
20150602,84,100,47,38,13,0,2,1,285
20150603,103,86,44,35,14,4,0,0,286
20150604,46,93,49,45,12,3,2,0,250
20150605,36,62,44,28,12,9,0,1,192
20150606,28,55,42,43,11,3,1,0,183
20150607,62,75,59,37,15,6,1,0,255
20150701,51,89,58,50,34,14,1,3,300
20150702,59,53,56,39,23,7,3,4,244
20150703,40,71,53,42,15,6,0,3,230
20150704,54,55,44,31,24,7,0,1,216
20150705,61,64,68,56,21,12,4,7,293
20150706,70,65,59,58,30,24,6,9,321
20150707,91,76,71,70,23,13,3,4,351
20150708,59,88,75,59,29,11,6,1,328
20150709,57,89,55,46,16,13,2,5,283
20150710,95,109,86,55,20,7,6,1,379
20150711,64,104,75,55,20,5,5,1,329
20150712,71,92,83,68,21,6,3,4,348
20150801,75,91,63,53,29,12,7,6,336
20150802,35,69,53,41,21,12,3,3,237
20150803,94,107,65,64,24,10,5,4,373
20150804,64,101,57,60,29,15,2,2,330
20150805,72,86,56,38,22,8,1,2,285
20150806,54,70,67,38,19,10,1,1,260
20150807,93,110,69,50,22,10,2,1,357
20150808,70,85,63,55,30,16,1,3,323
20150809,136,137,84,48,17,7,2,2,433
20150810,110,125,84,44,14,5,0,0,382
20150901,80,77,36,22,10,3,0,0,228
20150902,66,65,40,22,12,4,0,0,209
20150903,78,67,47,29,8,0,0,1,230
20150904,61,58,52,35,33,10,2,2,253
20150905,50,66,40,47,22,17,2,5,249
20150906,48,52,42,38,20,11,1,1,213
20150907,74,76,45,42,17,11,3,2,270
20150908,147,149,154,128,62,59,12,16,727
20151001,144,104,50,36,11,3,0,0,348
20151002,94,106,67,54,14,2,2,2,341
20151003,97,128,76,60,33,8,6,1,409
20151004,116,88,67,41,15,7,1,2,337
20151005,79,86,54,29,13,7,3,6,277
20151006,78,70,35,19,8,2,0,4,216
20151007,157,125,63,42,10,4,0,1,402
20151008,112,116,44,30,15,4,1,2,324
20151009,85,86,61,36,19,0,4,6,297
20151010,102,67,45,26,8,5,1,3,257
20151011,73,80,50,38,5,5,2,0,253
20151012,101,130,47,38,13,5,1,3,338
20151013,144,130,56,20,8,3,1,2,364
20151101,102,81,48,52,16,4,0,5,308
20151102,147,107,45,38,12,8,0,1,358
20151103,95,96,55,41,13,3,1,1,305
20151104,77,87,65,46,19,9,1,4,308
20151105,55,70,51,36,15,11,2,5,245
20151106,58,79,41,33,34,9,4,8,266
20151107,72,74,50,29,19,9,3,2,258
20151108,82,80,60,34,12,5,1,2,276
20151109,101,117,83,56,20,4,1,0,382
20151110,83,74,51,27,22,10,0,1,268
20151111,209,164,67,55,28,5,2,1,531
20151112,125,115,71,43,13,6,2,1,376
20151113,104,103,71,51,22,10,2,1,364
20151201,79,54,58,45,20,10,9,2,277
20151202,72,84,58,34,21,8,3,3,283
20151203,106,89,56,32,15,9,0,2,309
20151204,128,106,36,36,11,5,1,1,324
20151205,102,89,63,42,26,6,4,1,333
20151206,107,90,49,36,15,9,0,2,308
20151207,90,77,33,26,6,3,0,0,235
20151208,163,122,47,24,9,6,1,1,373
20151209,90,84,39,21,7,3,0,1,245
20151301,81,72,66,43,23,11,3,5,304
20151302,67,73,38,40,20,14,2,3,257
20151303,114,107,30,28,12,6,0,1,298
20151304,69,76,53,42,17,3,2,0,262
20151305,88,70,28,17,8,1,0,0,212
20151306,114,66,27,21,9,0,1,0,238
20151307,96,83,52,45,11,3,1,1,292
20151308,75,49,32,23,12,3,0,0,194
20151309,139,165,78,57,17,6,0,0,462
20151310,102,110,34,37,9,3,1,1,297
20151401,112,119,68,38,20,7,0,0,364
20151402,105,140,75,45,17,4,0,0,386
20151403,98,95,48,40,17,3,1,0,302
20151404,104,88,59,37,15,1,4,0,308
20151405,159,119,64,53,17,5,2,2,421
20151406,146,84,23,27,5,1,0,0,286
20151407,130,120,71,55,16,0,0,0,392
20151408,99,98,46,47,15,12,2,7,326
20151409,92,102,79,54,10,8,1,1,347
20151410,69,91,52,38,13,7,1,1,272
20151411,81,106,87,65,23,9,2,3,376
20151501,90,84,55,49,13,2,0,0,293
20151502,31,54,46,54,37,12,0,1,235
20151503,78,145,78,68,24,7,0,1,401
20151504,76,95,87,54,17,13,4,6,352
20151505,62,79,65,46,29,11,3,2,297
20151506,69,80,72,48,27,9,4,2,311
20151507,116,109,64,43,18,8,3,0,361
20151508,73,73,46,42,15,11,0,0,260
20151509,127,131,90,52,17,10,2,1,430
20151510,132,137,84,33,21,5,0,1,413
20151601,109,99,71,49,18,7,1,1,355
20151602,80,105,60,50,20,9,1,2,327
20151603,77,114,82,76,30,7,0,2,388
20151604,64,103,60,45,13,6,2,0,293
20151605,76,104,46,37,8,3,2,0,276
20151606,84,85,71,41,22,4,1,0,308
20151607,70,102,53,58,21,9,0,3,316
20151608,114,102,70,45,14,8,0,1,354
20151609,90,106,50,45,10,3,2,0,306
20151610,98,100,76,43,15,3,2,0,337
20151611,70,109,65,47,11,4,0,1,307
20151701,114,88,60,49,6,6,0,0,323
20151702,103,88,34,30,14,1,1,0,271
20151703,101,139,70,41,9,4,1,3,368
20151704,112,128,74,71,17,5,1,1,409
20151705,103,91,66,58,24,6,1,0,349
20151706,94,98,63,39,10,3,0,1,308
20151707,113,114,53,39,7,3,3,1,333
20151708,84,101,44,32,6,3,0,0,270
20151709,64,81,51,56,10,3,1,0,266
20151710,113,105,65,46,13,0,0,0,342
20151711,118,106,59,54,15,4,0,0,356
20151712,75,115,56,33,15,6,2,0,302
20151801,84,83,53,26,9,2,0,0,257
20151802,43,98,37,25,10,0,0,0,213
20151803,108,97,48,39,14,3,0,1,310
20151804,70,63,41,29,4,2,0,0,209
20151805,61,88,28,27,6,4,1,0,215
20151806,61,62,39,31,12,4,1,0,210
20151807,70,124,57,47,15,2,1,0,316
20151808,58,71,35,42,8,1,1,2,218
20151809,67,73,49,33,0,0,0,0,222
20151810,68,72,55,32,9,2,1,1,240
20151811,101,97,47,33,14,2,0,0,294
20151812,74,83,44,32,9,1,0,1,244
20151813,85,90,43,29,6,1,0,0,254
20151901,95,73,35,19,5,3,0,0,230
20151902,109,105,49,44,23,2,1,2,335
20151903,98,110,58,31,11,1,0,1,310
20151904,125,109,51,37,14,6,1,0,343
20151905,133,119,75,37,17,2,0,0,383
20151906,108,109,65,39,14,3,0,0,338
20151907,163,116,47,43,4,1,0,0,374
20151908,110,106,46,24,5,3,0,0,294
20151909,83,104,43,41,13,2,0,0,286
20151910,124,143,69,58,12,3,3,0,412
20151911,131,138,71,30,12,1,0,0,383
20152001,100,98,62,63,21,2,1,0,347
20152002,122,122,65,44,10,3,0,0,366
20152003,103,126,56,41,18,1,0,1,346
20152004,91,91,37,45,13,1,0,0,278
20152005,92,104,39,29,6,2,0,2,274
20152006,114,105,48,33,15,5,0,1,321
20152007,87,88,55,38,12,6,2,1,289
20152008,88,75,45,45,11,3,1,0,268
20152009,89,75,28,19,5,2,5,2,225
20152010,93,92,62,44,13,11,2,2,319
20152011,147,108,40,30,10,7,1,1,344
20152012,125,119,42,43,7,5,0,1,342
20152101,107,97,62,41,9,3,0,1,320
20152102,137,115,58,48,10,4,2,0,374
20152103,119,87,40,28,10,7,2,0,293
20152104,142,93,55,41,5,5,2,0,343
20152105,76,54,30,27,9,3,0,2,201
20152106,113,136,69,72,24,1,1,2,418
20152107,56,54,26,27,11,1,0,0,175
20152108,91,83,45,31,8,3,0,0,261
20152109,150,110,72,36,18,4,0,2,392
20152110,104,88,45,26,9,2,3,1,278
20152111,124,118,56,27,3,5,1,1,335
20152112,61,81,32,30,8,4,1,0,217
20152113,138,122,64,45,12,7,1,0,389
60280101,44,50,84,82,57,23,7,13,360
60280102,21,36,65,55,44,42,8,19,290
60280103,39,50,68,76,42,30,7,14,326
60280104,40,59,63,65,41,20,5,2,295
60280105,34,51,47,35,18,11,2,3,201
60280106,40,62,52,47,34,23,3,5,266
60280107,16,51,50,103,64,19,14,9,326
60280108,33,67,99,97,60,40,13,19,428
60280109,70,93,115,108,45,34,11,9,485
60280110,35,65,41,50,18,9,8,3,229
60280111,56,101,81,83,49,14,5,6,395
60280112,50,55,59,71,36,23,2,5,301
60280113,31,77,55,48,26,23,8,9,277
60280114,31,48,66,68,33,24,14,10,294
60280115,63,97,104,84,37,22,10,9,426
60280201,51,77,97,107,53,45,10,16,456
60280202,35,51,93,80,46,30,17,17,369
60280203,49,70,104,80,64,44,11,15,437
60280204,33,69,75,95,66,43,20,28,429
60280205,33,44,58,66,40,23,10,18,292
60280206,25,43,82,72,50,36,14,15,337
60280207,31,51,65,69,50,25,5,14,310
60280208,22,52,86,67,39,36,9,13,324
60280301,56,95,113,103,47,33,13,13,473
60280302,37,70,105,93,66,27,16,16,430
60280303,41,64,90,118,78,45,19,41,496
60280304,25,31,36,44,29,28,8,15,216
60280305,26,40,85,83,68,44,24,36,406
60280306,13,24,31,38,30,30,12,16,194
60280307,20,31,79,70,60,49,15,22,346
60280308,58,107,93,116,60,49,16,26,525
60280309,23,50,48,65,48,25,3,15,277
60280310,47,71,67,74,31,18,5,5,318
60280311,30,46,54,53,34,25,2,7,251
60280312,28,42,59,46,42,21,13,15,266
60280401,45,46,94,92,83,60,20,19,459
60280402,60,46,70,70,49,33,11,28,367
60280403,35,57,77,71,53,52,22,23,390
60280404,37,36,66,69,48,42,18,15,331
60280405,25,49,59,59,51,42,21,33,339
60280406,35,41,70,71,45,65,15,37,379
60280407,39,63,93,83,59,47,17,21,422
60280408,32,53,80,95,59,49,13,20,401
60280409,46,60,81,96,50,45,30,37,445
60280410,30,58,67,93,51,35,8,19,361
60280411,39,61,87,72,55,32,16,18,380
60280412,57,87,102,98,56,43,10,21,474
60280501,4,4,3,4,4,1,0,1,21
60280502,3,2,8,4,3,2,2,1,25
60280503,1,2,1,4,2,0,0,1,11
60280504,42,60,60,56,36,26,12,14,306
60280505,1,4,7,3,5,3,0,1,24
60280506,29,36,39,39,18,19,13,5,198
60280507,8,11,23,20,15,7,7,10,101
60280508,9,9,17,16,13,8,1,2,75
60280509,4,15,10,15,6,7,2,3,62
60280510,7,14,13,13,5,9,2,3,66
60280511,24,58,71,65,53,30,6,17,324
60280512,1,7,11,7,7,2,0,1,36
60280513,33,52,98,71,45,36,9,15,359
60280601,66,78,78,81,57,24,5,0,389
60280602,85,138,169,115,69,56,13,22,667
60280603,62,89,79,96,68,33,8,8,443
60280604,118,221,243,246,160,100,36,41,1165
60280605,67,90,100,123,65,41,22,28,536
60280606,62,111,103,114,69,37,18,17,531
60280607,50,75,86,70,59,33,8,19,400
60280608,27,37,53,45,28,18,8,10,226
60280609,32,80,82,65,41,23,3,8,334
60280610,144,149,188,189,148,97,37,49,1001
60280611,22,31,37,56,35,39,20,14,254
60280612,32,30,46,61,37,27,11,12,256
60280613,41,54,52,51,24,12,6,4,244
60280614,80,133,170,154,101,66,24,34,762
60280615,92,160,215,233,140,104,39,49,1032
60280701,61,85,116,131,98,59,20,38,608
60280702,76,96,96,100,89,49,20,20,546
60280703,82,89,114,106,79,53,18,32,573
60280704,46,90,80,94,51,36,9,11,417
60280705,40,76,96,71,59,37,20,12,411
60280706,57,109,99,100,47,25,6,6,449
60280707,60,131,148,141,95,54,14,23,666
60280708,37,68,47,63,43,31,6,12,307
60280709,42,63,75,69,50,36,12,14,361
60280710,60,74,69,61,40,24,8,6,342
60280711,47,81,86,87,68,38,10,16,433
60280801,5,9,20,13,12,13,0,10,82
60280802,8,11,14,12,12,11,3,2,73
60280803,3,3,4,3,1,1,2,3,20
60280804,9,7,15,9,7,5,3,5,60
60280805,18,51,79,62,58,31,14,11,324
60280806,43,42,54,60,34,18,8,8,267
60280807,17,59,51,60,45,21,3,4,260
60280808,55,70,71,70,30,33,5,3,337
60280809,0,10,8,7,3,2,1,1,32
60280810,70,112,104,92,54,34,18,6,490
60280811,79,114,110,84,46,20,8,3,464
60280812,61,101,82,63,30,18,4,0,359
60280813,88,104,71,84,19,6,5,0,377
60280901,55,100,91,99,52,36,14,16,463
60280902,34,75,68,72,50,23,10,17,349
60280903,29,36,64,64,42,28,14,4,281
60280904,61,97,123,105,63,46,17,21,533
60280905,56,76,68,50,23,18,2,7,300
60280906,66,95,88,81,36,15,6,8,395
60280907,32,54,53,65,52,32,14,14,316
60280908,42,61,89,67,50,32,8,15,364
60280909,68,113,96,101,54,29,15,14,490
60281001,42,50,64,48,16,17,7,4,248
60281002,34,52,52,49,23,17,0,2,229
60281003,61,83,95,69,36,15,7,3,369
60281004,42,47,58,56,27,12,4,3,249
60281005,49,69,64,40,32,19,4,6,283
60281006,34,45,62,61,32,33,7,7,281
60281007,38,58,82,67,46,39,8,16,354
60281008,62,97,89,97,45,29,13,10,442
60281009,37,53,49,62,26,30,11,12,280
60281010,41,54,66,63,38,26,12,11,311
60281011,29,49,68,74,32,26,13,11,302
60281012,44,49,74,76,38,26,11,2,320
60281013,64,77,107,125,69,42,18,26,528
60281014,36,72,68,72,43,31,8,17,347
60281015,33,57,73,51,35,23,5,9,286
60281016,37,73,69,69,35,16,6,4,309
60281017,30,53,59,55,24,16,4,4,245
60281101,42,63,65,47,40,20,9,12,298
60281102,41,61,67,41,31,23,12,8,284
60281103,50,69,54,61,22,9,5,6,276
60281104,26,63,58,41,17,12,5,3,225
60281105,41,64,55,43,21,8,2,4,238
60281106,30,68,50,37,23,6,1,0,215
60281107,30,61,47,45,20,2,3,0,208
60281108,19,29,37,21,19,3,1,2,131
60281109,63,116,111,108,55,10,7,2,472
60281110,85,111,106,97,47,22,3,4,475
60281111,93,117,113,101,62,24,6,10,526
60281112,33,49,56,63,37,9,1,6,254
60281113,37,51,53,47,18,15,3,3,227
60281201,73,102,101,89,37,12,2,0,416
60281202,62,89,94,58,24,6,2,0,335
60281203,75,117,77,70,43,21,1,4,408
60281204,64,104,66,60,17,7,2,1,321
60281205,58,106,62,51,26,9,2,0,314
60281206,61,70,29,19,7,3,1,0,190
60281207,74,70,61,39,20,4,3,2,273
60281208,68,93,67,57,24,6,2,1,318
60281209,54,82,73,84,28,10,1,2,334
60281210,55,102,85,102,51,25,6,3,429
60281211,50,95,80,83,45,14,1,4,372
60281301,69,110,91,99,32,24,6,3,434
60281302,37,53,51,60,22,7,3,2,235
60281303,17,34,41,59,39,25,12,9,236
60281304,55,93,93,97,63,38,16,10,465
60281305,52,95,69,58,26,20,10,9,339
60281306,38,70,67,62,31,31,7,6,312
60281307,17,41,59,53,39,30,6,10,255
60281308,32,62,67,73,43,29,13,13,332
60281309,30,58,81,82,44,32,6,7,340
60281310,75,100,75,77,36,18,9,2,392
60281311,46,68,100,87,34,19,5,8,367
60281312,47,64,59,67,35,13,3,2,290
60281313,27,36,49,52,28,19,6,1,218
60281401,52,73,78,85,45,40,15,22,410
60281402,43,48,54,69,45,30,7,11,307
60281403,54,103,96,83,64,41,18,13,472
60281404,44,85,82,98,48,37,12,28,434
60281405,27,69,76,77,60,30,16,17,372
60281406,60,79,102,92,63,32,15,22,465
60281407,49,97,82,97,47,40,19,23,454
60281408,48,59,58,59,44,24,2,12,306
60281409,43,54,59,44,31,22,4,14,271
60281410,30,43,59,58,48,32,19,15,304
60281501,37,30,51,49,37,23,9,14,250
60281502,40,51,50,51,32,15,8,9,256
60281503,30,62,58,56,44,20,4,5,279
60281504,28,44,43,52,40,34,15,13,269
60281505,37,64,50,64,32,28,8,17,300
60281506,40,47,53,55,37,14,5,8,259
60281507,69,102,95,102,46,22,5,4,445
60281508,20,48,64,58,28,9,3,2,232
60281509,67,117,130,117,64,35,9,7,546
60281510,48,65,65,67,42,36,8,22,353
60281511,51,31,40,36,33,16,7,6,220
60281512,28,61,68,67,38,18,4,8,292
60281601,38,58,66,59,23,26,1,3,274
60281602,64,93,77,61,38,29,0,0,362
60281603,72,90,118,117,78,49,10,25,559
60281604,31,56,71,70,39,25,8,9,309
60281605,32,64,67,73,42,27,10,8,323
60281606,63,76,84,97,64,34,11,12,441
60281607,22,54,47,49,24,28,4,6,234
60281608,46,66,59,46,25,17,8,10,277
60281701,43,54,50,57,21,14,6,2,247
60281702,48,60,79,72,45,25,6,6,341
60281703,24,42,43,33,25,11,6,2,186
60281704,24,48,52,64,33,16,5,4,246
60281705,33,45,58,50,35,21,8,7,257
60281706,61,89,108,84,53,34,13,14,456
60281707,52,77,74,62,39,14,4,10,332
60281708,47,87,86,84,34,33,8,18,397
60281709,45,75,65,50,27,16,7,3,288
60281801,55,83,88,82,61,28,15,12,424
60281802,46,71,71,67,24,12,6,4,301
60281803,40,79,94,83,58,45,21,20,440
60281804,24,35,38,62,33,21,6,12,231
60281805,36,38,54,41,35,19,7,10,240
60281806,38,93,80,89,84,48,15,19,466
60281807,20,34,56,64,50,44,14,20,302
60281808,31,58,99,96,75,42,21,16,438
60281809,16,35,54,77,59,31,12,11,295
60281810,30,53,75,64,37,27,10,19,315
60281811,14,34,59,68,37,18,2,5,237
60281901,37,68,99,77,43,20,12,8,364
60281902,46,70,90,66,36,15,7,4,334
60281903,37,53,85,76,40,43,15,28,377
60281904,39,71,72,81,39,38,13,25,378
60281905,19,23,34,46,17,18,9,4,170
60281906,9,21,18,20,18,2,2,2,92
60281907,44,63,69,48,29,18,6,5,282
60281908,62,74,62,64,47,28,10,14,361
60281909,40,80,86,90,61,22,18,10,407
60281910,50,89,49,45,14,3,3,2,255
60281911,29,59,62,79,56,38,18,21,362
60281912,26,52,46,69,46,36,8,15,298
60281913,20,27,33,36,34,21,11,10,192
60282001,51,94,89,83,42,18,10,10,397
60282002,21,55,69,74,53,29,12,17,330
60282003,27,35,37,36,26,17,9,7,194
60282004,45,73,92,81,79,62,22,36,490
60282005,31,82,86,99,49,41,12,18,418
60282006,42,50,75,104,51,36,13,11,382
60282007,25,32,53,62,62,43,6,10,293
60282008,22,60,49,62,62,33,10,14,312
60282009,28,35,46,64,46,33,11,20,283
60282010,33,35,48,65,50,45,15,28,319
60282011,26,29,49,49,48,23,12,26,262
60282012,31,34,35,29,23,25,9,9,195
60282013,63,56,62,73,66,38,24,24,406
60282014,39,48,86,62,50,41,9,17,352
60282015,33,64,68,82,60,35,20,15,377
60282101,31,61,37,43,18,17,3,3,213
60282102,36,64,55,46,22,18,4,4,249
60282103,68,102,83,66,45,21,13,10,408
60282104,39,69,47,47,24,10,3,5,244
60282105,37,68,62,48,38,23,5,8,289
60282106,48,61,34,46,14,7,1,1,212
60282107,42,54,64,78,47,16,2,4,307
60282108,31,51,52,86,47,24,6,9,306
60282109,30,42,75,63,51,28,14,24,327
60282110,20,35,49,58,45,24,7,9,247
60282111,43,58,75,65,45,31,8,5,330
60282112,36,54,54,61,44,21,7,15,292
60282113,43,51,47,58,33,14,2,6,254
60282201,21,46,24,39,7,6,1,3,147
60282202,45,59,66,70,33,17,1,1,292
60282203,39,60,86,81,38,22,11,8,345
60282204,35,43,55,67,29,20,7,7,263
60282205,34,63,97,100,76,31,17,20,438
60282206,36,75,82,93,63,32,11,14,406
60282207,14,31,32,47,39,14,3,5,185
60282208,41,66,56,45,21,18,4,11,262
60282209,50,67,85,90,54,15,11,13,385
60282210,56,100,99,115,59,30,13,23,495
60282211,49,74,61,52,30,7,9,4,286
60282212,37,64,58,49,18,7,6,7,246
60282213,43,53,60,53,27,18,6,7,267
60282214,26,48,66,48,30,12,5,11,246
60282215,21,48,53,36,31,16,3,9,217
60282216,73,118,112,97,69,49,5,21,544
60282217,25,42,38,49,31,14,5,4,208
60282218,32,60,45,51,25,22,1,1,237
60282301,71,126,94,86,52,13,4,7,453
60282302,63,106,111,97,46,25,3,2,453
60282303,38,72,74,40,23,13,4,1,265
60282304,73,103,73,76,38,12,2,2,379
60282305,55,52,52,46,23,7,3,3,241
60282306,55,92,75,57,29,9,1,0,318
60282307,63,101,82,53,23,7,2,2,333
60282308,37,52,44,52,14,9,5,0,213
60282309,39,68,73,60,27,10,1,6,284
60282310,43,65,58,58,27,13,2,2,268
60282311,53,71,53,60,19,4,2,0,262
60282312,30,60,53,36,18,9,3,4,213
60282313,39,44,45,42,22,6,4,1,203
60282401,69,96,78,86,34,20,4,3,390
60282402,56,78,97,96,43,30,7,11,418
60282403,43,80,55,63,32,12,2,4,291
60282404,128,134,68,47,14,5,0,1,397
60282405,71,97,105,94,44,22,12,8,453
60282406,66,89,77,61,23,8,7,4,335
60282407,72,86,80,83,37,13,5,5,381
60282408,63,91,69,67,20,9,3,2,324
60282409,75,109,68,50,25,10,3,1,341
60282501,45,79,47,62,20,9,0,0,262
60282502,77,94,67,52,25,12,2,0,329
60282503,99,60,17,6,4,2,1,0,189
60282504,90,62,17,12,0,1,1,0,183
60282505,85,118,63,48,28,12,2,0,356
60282506,68,101,81,80,30,12,0,3,375
60282507,65,62,39,30,16,3,1,2,218
60282508,64,61,30,28,9,4,1,2,199
60282509,39,52,42,30,24,8,2,0,197
60282510,70,96,81,75,33,15,5,1,376
60282511,71,108,94,80,36,6,3,1,399
60282512,61,65,53,64,26,11,4,2,286
60282513,62,91,62,54,30,5,2,1,307
60282601,22,54,30,35,10,5,1,0,157
60282602,14,36,30,28,12,5,1,0,126
60282603,36,73,62,54,30,22,3,4,284
60282604,38,106,43,38,13,3,0,0,241
60282605,30,71,47,47,23,6,0,0,224
60282606,31,48,45,58,20,19,3,3,227
60282607,16,38,32,30,24,12,6,6,164
60282608,26,57,35,39,8,5,1,0,171
60282609,33,67,74,68,27,9,2,0,280
60282610,22,29,28,39,19,21,8,5,171
60282611,19,35,33,30,17,8,2,5,149
60282612,8,19,36,29,13,11,3,4,123
60282701,21,62,48,46,21,6,4,2,210
60282702,43,56,63,70,39,10,3,5,289
60282703,33,44,79,76,56,39,17,29,373
60282704,56,82,58,71,30,12,6,1,316
60282705,27,53,56,63,27,10,8,4,248
60282706,26,35,74,71,53,44,15,29,347
60282707,15,22,31,33,28,11,8,4,152
60282708,53,104,92,89,49,34,8,14,443
60282709,24,29,33,38,10,4,1,2,141
60282710,23,37,45,35,9,7,0,2,158
60282711,46,58,46,50,26,10,2,0,238
60282712,61,77,62,67,21,8,5,5,306
60282713,58,103,75,63,29,13,3,0,344
60282801,57,83,85,65,28,29,5,2,354
60282802,41,64,60,57,19,23,0,2,266
60282803,34,85,83,90,39,29,4,16,380
60282804,28,33,61,62,49,42,10,22,307
60282805,45,73,105,101,59,29,13,16,441
60282806,46,102,117,94,78,48,22,16,523
60282807,54,76,85,76,44,22,12,5,374
60282808,37,43,54,61,30,12,12,4,253
60282809,37,59,76,68,40,35,5,19,339
60282810,27,48,53,77,41,39,14,17,316
60282811,31,40,39,39,13,11,3,7,183
60282901,41,45,70,71,45,33,9,18,332
60282902,31,64,51,47,20,10,2,4,229
60282903,51,63,66,50,38,21,7,6,302
60282904,44,50,62,54,35,23,15,7,290
60282905,40,37,59,47,28,18,13,14,256
60282906,13,28,44,47,34,28,9,19,222
60282907,28,40,65,72,37,35,8,18,303
60282908,32,51,62,50,42,28,8,10,283
60282909,41,48,57,66,36,29,13,11,301
60282910,25,41,45,76,27,15,5,12,246
60282911,31,70,55,52,49,38,4,9,308
60282912,31,64,56,62,45,21,9,13,301
60282913,37,55,55,60,36,19,5,7,274
60283001,40,53,47,57,34,23,5,4,263
60283002,26,40,49,57,26,20,7,7,232
60283003,31,51,51,47,27,12,5,12,236
60283004,40,78,76,55,35,28,11,11,334
60283005,38,53,62,71,30,20,3,7,284
60283006,47,65,55,49,40,19,6,7,288
60283007,41,55,58,84,57,32,10,23,360
60283008,35,67,98,102,87,60,11,30,490
60283009,29,50,53,76,49,38,12,18,325
60283010,43,56,70,84,58,44,16,14,385
60283011,32,52,66,54,34,38,4,10,290
60283012,26,38,51,47,41,22,6,13,244
60283013,21,44,55,49,38,26,0,4,237
60283014,33,49,59,70,46,24,10,13,304
60283015,32,60,58,56,42,26,10,11,295
60283016,29,49,59,55,48,26,6,12,284
60283017,3,2,2,1,2,0,0,1,11
60283101,47,77,69,50,34,6,1,4,288
60283102,57,76,58,30,21,8,3,1,254
60283103,58,74,63,50,25,13,3,2,288
60283104,35,59,32,40,18,6,1,2,193
60283105,51,61,57,60,20,8,0,1,258
60283106,67,102,100,78,31,19,6,4,407
60283107,54,74,73,86,54,23,9,14,387
60283108,21,32,39,59,25,18,6,15,215
60283109,30,59,50,55,41,20,13,11,279
60283110,68,86,77,88,44,24,13,20,420
60283111,52,82,78,78,41,20,5,3,359
60283112,51,69,69,57,33,12,3,6,300
60283201,31,45,52,52,39,19,5,4,247
60283202,49,72,54,45,22,9,6,2,259
60283203,44,79,71,59,47,16,4,2,322
60283204,58,89,65,56,22,3,2,1,296
60283205,41,47,60,43,20,13,1,0,225
60283206,30,53,54,56,27,12,2,4,238
60283207,43,76,80,57,30,16,4,3,309
60283208,59,86,68,79,46,30,8,10,386
60283209,72,99,91,106,49,26,2,8,453
60283301,95,117,152,118,67,48,15,15,627
60283302,55,111,86,89,49,21,7,10,428
60283303,35,46,56,62,33,12,1,5,250
60283304,51,56,60,53,25,17,5,3,270
60283305,56,99,70,46,12,3,2,0,288
60283306,0,1,0,0,0,0,0,0,1
60283307,44,74,83,80,56,35,16,15,403
60283308,50,80,85,100,43,28,7,12,405
60283309,63,100,77,82,33,15,1,2,373
60283310,68,74,62,58,23,4,7,1,297
60283311,50,89,82,81,28,18,2,4,354
60283312,53,66,79,79,43,24,10,7,361
60283313,43,74,77,85,51,30,17,19,396
60283314,42,69,92,116,74,45,22,22,482
60283401,32,53,70,49,32,26,5,8,275
60283402,50,83,70,90,50,29,6,11,389
60283403,61,96,92,90,46,22,7,2,416
60283404,48,69,72,73,56,28,14,7,367
60283405,25,54,55,66,36,23,3,13,275
60283406,66,93,85,67,33,20,8,3,375
60283407,31,62,42,45,26,8,6,3,223
60283408,62,130,47,49,33,7,0,7,335
60283409,65,85,81,97,41,18,2,3,392
60283410,57,95,74,77,36,10,4,2,355
60283411,36,66,57,72,33,15,7,7,293
60283412,63,87,76,68,43,20,6,5,368
60283501,48,60,93,72,51,31,20,11,386
60283502,33,42,64,62,47,40,30,33,351
60283503,25,62,72,86,49,31,15,8,348
60283504,38,66,69,67,43,23,6,3,315
60283505,24,58,101,91,73,57,23,22,449
60283506,39,49,80,71,68,38,11,17,373
60283507,38,87,97,79,63,41,16,17,438
60283508,32,70,67,78,36,15,5,6,309
60283509,40,56,75,92,53,50,27,22,415
60283601,27,34,42,43,23,18,8,4,199
60283602,45,53,39,33,9,5,2,0,186
60283603,59,65,78,55,18,3,0,2,280
60283604,72,101,104,85,46,21,5,7,441
60283605,47,66,85,90,65,36,16,15,420
60283606,47,65,83,80,59,41,11,18,404
60283607,66,92,104,86,54,23,10,3,438
60283608,58,78,62,53,19,5,3,6,284
60283609,35,51,52,59,33,24,9,5,268
60283610,33,62,56,69,44,33,8,11,316
60283611,32,38,58,63,49,31,17,16,304
60283612,45,65,84,68,49,36,10,24,381
60283613,73,70,94,59,35,23,7,3,364
60283614,30,72,84,91,70,40,14,21,422
60283615,34,65,88,113,58,45,15,30,448
60283701,61,97,80,49,37,15,7,6,352
60283702,38,58,67,49,34,19,7,4,276
60283703,36,54,56,68,33,23,8,8,286
60283704,36,51,71,67,44,28,9,11,317
60283705,41,85,78,61,55,26,11,14,371
60283706,35,53,74,74,53,38,16,25,368
60283707,32,48,41,47,37,23,8,9,245
60283708,49,44,59,60,24,12,5,6,259
60283709,43,61,60,64,28,11,5,7,279
60283710,38,76,63,68,55,37,11,8,356
60283711,46,74,81,78,52,33,8,8,380
60283712,32,59,85,82,67,40,12,17,394
60283713,27,34,50,59,42,31,10,22,275
60283714,39,45,50,64,36,38,7,10,289
60283801,57,61,112,89,81,59,24,31,514
60283802,37,53,74,89,40,27,11,16,347
60283803,45,53,68,61,48,28,16,28,347
60283804,63,79,88,107,52,30,8,9,436
60283805,66,127,80,67,30,16,4,2,392
60283806,35,56,58,60,36,18,4,5,272
60283807,36,45,44,56,22,19,3,4,229
60283808,62,94,83,73,40,20,6,8,386
60283809,37,49,65,54,44,22,10,6,287
60283810,26,67,56,68,34,18,2,10,281
60283811,35,64,60,58,24,16,8,4,269
60283812,42,58,67,69,36,19,3,10,304
60283901,28,45,54,56,70,34,14,16,317
60283902,39,67,73,81,49,26,20,25,380
60283903,22,45,61,54,52,36,12,17,299
60283904,41,53,81,85,38,39,12,11,360
60283905,38,38,51,72,58,28,12,20,317
60283906,31,43,51,46,29,30,8,13,251
60283907,23,33,51,68,48,25,8,17,273
60283908,23,44,56,55,43,28,12,8,269
60283909,62,64,63,106,73,45,14,27,454
60283910,53,93,87,97,62,33,12,15,452
60283911,44,68,94,75,50,34,19,24,408
60283912,56,61,88,87,64,30,20,16,422
60283913,43,84,110,99,82,42,15,20,495
60283914,31,37,44,44,38,16,11,6,227
60283915,29,41,76,55,37,19,9,3,269
60350101,123,112,151,150,86,69,14,26,731
60350102,47,85,72,66,51,50,22,25,418
60350103,40,61,48,44,27,9,5,5,239
60350104,38,42,51,38,21,16,2,9,217
60350105,26,29,35,31,14,5,5,4,149
60350106,41,49,46,41,25,12,9,2,225
60350107,45,51,56,44,25,17,3,4,245
60350108,38,49,33,27,16,9,1,2,175
60350109,26,27,32,25,12,10,5,5,142
60350110,32,54,68,54,37,30,5,6,286
60350111,31,45,54,49,37,23,9,8,256
60350201,67,54,58,64,40,21,6,11,321
60350202,26,36,53,62,44,27,13,17,278
60350203,39,33,50,75,55,22,11,14,299
60350301,54,74,55,52,43,16,6,8,308
60350302,30,68,74,63,50,32,11,13,341
60350303,51,53,68,56,34,14,6,5,287
60350304,78,83,90,70,22,7,4,3,357
60350305,43,59,68,58,16,7,0,1,252
60350306,53,107,87,85,21,8,1,1,363
60350307,55,88,76,69,17,10,0,2,317
60350308,53,75,80,52,19,10,2,0,291
60350309,20,55,45,37,17,2,2,2,180
60350310,30,60,60,40,19,13,1,0,223
60350311,67,72,76,75,30,7,5,2,334
60350312,46,59,53,55,20,8,2,5,248
60350313,60,89,62,57,36,11,13,6,334
60350314,48,75,67,45,29,9,1,3,277
60350315,63,94,60,72,26,10,3,2,330
60350401,54,83,85,88,45,26,8,17,406
60350402,39,57,71,59,27,11,4,5,273
60350403,62,53,70,67,38,19,8,8,325
60350404,42,66,67,84,43,37,9,17,365
60350405,55,85,83,59,39,20,6,9,356
60350406,57,88,82,61,29,15,7,3,342
60350407,65,84,74,65,32,18,4,6,348
60350408,35,59,53,45,22,18,8,10,250
60350409,55,109,95,89,50,24,6,7,435
60350410,53,59,44,51,26,12,2,1,248
60350411,73,101,92,87,40,20,7,10,430
60350412,39,71,71,52,26,11,2,1,273
60350413,54,104,60,61,31,13,1,3,327
60350414,39,78,67,52,12,8,1,1,258
60350415,34,85,61,62,9,2,0,0,253
60350501,31,53,48,23,18,16,1,3,193
60350502,111,127,104,75,29,15,3,1,465
60350503,66,90,71,50,13,1,0,0,291
60350504,61,103,83,64,36,19,3,6,375
60350505,93,130,151,165,128,104,22,37,830
60350506,43,72,97,97,63,48,9,16,445
60350507,61,89,104,73,46,55,4,6,438
60350508,64,90,80,69,22,14,1,3,343
60350509,63,96,73,54,19,9,4,1,319
60350510,51,76,75,55,27,9,1,1,295
60350511,54,81,58,49,14,5,3,5,269
60350512,41,74,67,63,20,6,0,0,271
60350601,53,77,69,66,42,17,5,7,336
60350602,70,118,82,72,24,14,2,3,385
60350603,69,98,80,55,26,8,0,1,337
60350604,50,65,60,60,20,9,2,3,269
60350605,70,91,70,47,24,10,1,3,316
60350606,57,87,67,63,23,14,6,4,321
60350607,35,57,52,38,20,4,0,1,207
60350608,48,73,77,74,27,4,0,0,303
60350609,48,51,66,54,38,46,5,7,315
60350610,36,61,52,47,31,25,6,8,266
60350611,24,36,41,52,39,15,7,4,218
60350612,60,78,60,56,19,17,4,5,299
60350701,37,57,47,37,28,13,0,6,225
60350702,64,72,61,66,42,24,10,8,347
60350703,30,68,49,52,30,20,7,8,264
60350704,42,70,59,43,30,13,4,6,267
60350705,64,67,60,54,22,10,5,4,286
60350706,58,98,87,70,25,11,7,7,363
60350707,40,44,41,43,19,6,4,2,199
60350708,27,31,28,14,13,4,0,0,117
60350709,22,44,25,21,7,4,0,1,124
60350710,34,30,30,21,8,11,3,1,138
60350711,38,53,46,26,16,9,3,0,191
60350712,17,29,19,20,8,3,1,1,98
60350801,35,64,39,59,40,21,6,10,274
60350802,10,33,35,34,34,17,6,5,174
60350803,57,66,77,69,37,28,5,5,344
60350804,56,80,62,60,29,23,4,7,321
60350805,11,27,20,20,14,11,4,5,112
60350806,52,45,45,45,19,15,6,6,233
60350807,48,49,48,38,17,15,9,3,227
60350808,43,54,42,31,19,20,4,2,215
60350809,46,63,59,52,22,17,3,5,267
60350810,36,36,32,37,16,12,4,7,180
60350811,44,50,45,45,28,11,9,6,238
60350812,220,308,238,193,96,41,9,11,1116
60350813,54,66,55,55,44,48,6,16,344
60350814,41,49,51,38,21,15,6,1,222
60350815,62,94,139,85,44,38,14,25,501
60350901,45,39,48,37,26,20,5,9,229
60350902,25,29,29,39,28,15,5,9,179
60350903,23,29,36,23,19,13,6,10,159
60350904,97,125,139,118,111,85,11,25,711
60350905,43,34,40,31,29,27,13,14,231
60350906,23,31,32,33,30,19,9,13,190
60350907,52,51,59,48,36,23,7,9,285
60350908,48,56,70,61,51,27,13,16,342
60350909,45,33,37,27,25,18,4,4,193
60350910,70,59,74,79,56,28,17,19,402
60350911,67,57,61,51,32,26,17,25,336
60350912,31,37,43,33,26,13,6,2,191
60350913,64,75,65,44,21,13,5,7,294
60350914,57,44,62,42,29,14,4,2,254
60351001,75,54,43,41,19,12,7,5,256
60351002,251,297,207,117,24,7,1,1,905
60351003,71,76,60,38,24,16,6,6,297
60351004,63,69,68,51,30,14,8,7,310
60351005,57,51,30,33,11,9,3,1,195
60351006,91,86,75,35,17,5,1,0,310
60351007,97,128,59,38,16,6,0,1,345
60351008,93,78,37,16,4,2,0,0,230
60351009,45,53,21,12,6,1,2,0,140
60351010,80,89,58,56,12,3,0,1,299
60351011,71,62,53,35,18,6,2,2,249
60351012,78,109,49,33,12,2,0,0,283
60351101,53,53,44,22,17,4,2,8,203
60351102,47,64,56,40,24,19,2,7,259
60351103,28,37,30,28,18,11,0,5,157
60351104,98,97,50,45,21,5,2,2,320
60351105,155,165,91,86,34,11,4,1,547
60351106,86,111,77,56,13,5,2,0,350
60351107,30,17,17,17,15,5,2,4,107
60351108,132,94,64,45,16,10,2,2,365
60351109,107,88,49,27,3,1,0,0,275
60351110,92,119,77,42,13,7,0,0,350
60351201,48,87,57,39,13,5,0,1,250
60351202,75,102,71,57,21,3,1,0,330
60351203,46,49,36,24,7,4,0,0,166
60351204,33,53,27,25,5,2,1,0,146
60351205,54,57,51,50,22,20,4,3,261
60351206,70,78,38,31,9,1,0,0,227
60351207,50,56,23,24,7,0,0,0,160
60351208,92,130,55,50,14,1,0,0,342
60351209,33,31,21,14,4,2,1,0,106
60351210,162,127,69,29,10,0,0,0,397
60351211,90,97,58,59,19,6,0,0,329
60351212,54,66,47,32,13,5,0,1,218
60351301,64,75,63,48,29,15,7,5,306
60351302,83,100,82,45,12,11,3,2,338
60351303,81,98,51,40,15,3,2,1,291
60351304,89,94,52,45,12,6,1,3,302
60351305,53,62,48,45,24,5,2,6,245
60351306,48,68,63,27,23,5,1,0,235
60351307,38,57,56,41,15,6,5,1,219
60351308,54,58,53,55,18,5,2,0,245
60351309,54,57,40,27,8,3,3,0,192
60351310,65,68,56,35,16,1,2,0,243
60351401,66,77,58,36,12,11,1,1,262
60351402,57,79,38,37,10,2,1,1,225
60351403,67,89,76,68,24,7,2,2,335
60351404,56,97,61,51,19,9,7,2,302
60351405,49,87,54,39,13,3,0,1,246
60351406,52,83,44,38,6,0,2,0,225
60351407,28,40,43,37,17,8,0,1,174
60351408,49,71,60,71,27,13,1,2,294
60351409,79,102,54,35,12,1,2,0,285
60351410,94,95,64,52,22,6,0,0,333
60351411,25,36,27,36,15,4,2,5,150
60351412,39,49,53,48,16,8,1,2,216
60351413,43,54,40,40,21,8,3,1,210
60351501,23,35,41,47,24,19,11,7,207
60351502,59,113,65,51,18,4,2,0,312
60351503,79,103,85,48,22,2,1,0,340
60351504,61,68,74,41,19,11,1,2,277
60351505,20,34,58,52,38,36,10,8,256
60351506,91,106,119,83,50,14,10,7,480
60351507,54,87,67,49,22,7,2,3,291
60351508,71,91,73,59,21,7,1,1,324
60351509,58,62,52,50,30,3,4,2,261
60351510,46,76,48,53,9,4,3,1,240
60351511,62,79,44,42,26,7,2,2,264
60351512,59,73,41,35,23,5,1,2,239
60351601,42,69,38,20,10,6,2,0,187
60351602,69,80,82,72,20,7,1,2,333
60351603,40,80,68,53,31,12,4,0,288
60351604,32,37,21,23,13,6,3,1,136
60351605,54,73,52,44,26,8,5,2,264
60351606,40,69,62,51,23,18,3,1,267
60351607,50,60,33,28,23,6,2,4,206
60351608,70,101,75,65,26,11,5,4,357
60351609,65,92,68,67,21,7,2,3,325
60351610,69,77,84,61,27,9,3,4,334
60351611,43,67,53,48,18,12,1,3,245
60351701,70,74,63,56,22,8,1,2,296
60351702,48,63,71,46,20,9,3,2,262
60351703,51,84,67,60,21,13,2,1,299
60351704,77,80,79,60,20,3,2,2,323
60351705,46,110,78,71,30,8,7,2,352
60351706,62,63,66,41,22,5,3,4,266
60351707,66,67,59,64,34,8,2,2,302
60351708,68,77,61,56,16,4,3,3,288
60351709,65,75,51,57,13,7,3,2,273
60351710,62,97,68,68,24,20,5,7,351
60351711,41,73,48,35,20,13,1,1,232
60351801,54,86,59,58,19,8,1,1,286
60351802,48,89,65,63,32,9,1,2,309
60351803,46,83,54,46,21,9,4,1,264
60351804,48,85,59,44,20,8,2,2,268
60351805,66,65,57,62,20,5,0,2,277
60351806,69,96,64,46,29,14,2,1,321
60351807,60,71,49,39,18,9,0,2,248
60351808,42,59,60,37,22,8,0,1,229
60351809,78,83,53,49,24,16,2,1,306
60351810,53,81,52,40,17,8,1,2,254
60351811,76,73,66,58,31,14,1,1,320
60351901,55,79,60,55,30,10,3,0,292
60351902,67,89,57,70,35,9,2,4,333
60351903,79,99,74,45,13,10,2,3,325
60351904,61,82,52,47,20,7,1,2,272
60351905,72,90,67,62,20,8,4,1,324
60351906,65,80,70,56,33,11,1,3,319
60351907,56,83,68,51,14,13,1,3,289
60351908,51,66,59,49,31,10,2,5,273
60351909,47,87,61,60,22,16,3,0,296
60351910,69,108,73,67,47,18,3,4,389
60351911,63,70,86,65,26,19,10,4,343
60352001,85,89,85,68,30,6,1,1,365
60352002,79,135,91,61,25,0,0,0,391
60352003,106,157,79,58,29,8,1,0,438
60352004,47,59,51,54,20,7,2,2,242
60352005,59,86,68,54,19,9,6,3,304
60352006,57,67,52,55,27,18,6,5,287
60352007,84,95,76,54,31,12,3,3,358
60352008,62,95,87,58,24,9,5,3,343
60352009,63,92,63,57,20,13,3,1,312
60352010,47,77,89,57,26,11,6,1,314
60352011,57,60,60,60,28,13,1,2,281
60352101,81,109,100,67,24,19,2,2,404
60352102,83,121,82,68,28,6,1,2,391
60352103,43,46,46,47,15,7,1,0,205
60352104,53,53,50,37,5,5,0,1,204
60352105,74,56,31,14,8,1,0,0,184
60352106,48,48,35,32,13,3,0,1,180
60352107,39,51,43,55,16,6,1,1,212
60352108,121,88,34,28,7,2,0,0,280
60352109,38,86,49,57,12,5,1,1,249
60352110,70,91,58,55,17,6,2,0,299
60352201,73,89,75,73,49,36,11,15,421
60352202,68,78,58,41,14,3,0,0,262
60352203,77,55,22,32,10,1,0,3,200
60352204,65,54,34,26,10,2,0,1,192
60352205,52,58,42,34,11,3,1,0,201
60352206,68,82,54,47,17,5,2,0,275
60352207,85,85,47,42,11,2,1,1,274
60352208,77,62,42,24,7,3,0,0,215
60352209,51,76,46,34,10,8,1,1,227
60352210,40,82,56,52,21,7,1,1,260
60352211,46,54,36,38,10,1,1,0,186
60352212,10,18,11,4,4,2,0,0,49
60352301,32,46,35,29,14,6,2,1,165
60352302,37,49,39,32,10,5,0,1,173
60352303,57,91,54,46,6,1,0,0,255
60352304,29,34,26,29,9,4,0,0,131
60352305,91,114,66,66,30,10,4,0,381
60352306,66,96,90,59,32,16,4,0,363
60352307,43,58,67,75,39,29,6,9,326
60352308,23,34,41,47,26,16,12,13,212
60352309,56,75,55,58,23,11,0,2,280
60352310,54,104,61,69,27,8,2,0,325
60352311,45,87,78,62,28,14,5,4,323
60352312,32,72,68,89,55,23,9,15,363
60352401,74,77,68,60,40,9,1,2,331
60352402,52,95,59,60,32,8,2,7,315
60352403,68,105,77,82,37,24,5,8,406
60352404,66,89,80,64,30,11,4,3,347
60352405,43,58,58,49,30,7,2,1,248
60352406,47,88,66,66,27,7,3,3,307
60352407,55,85,70,69,27,8,0,3,317
60352408,53,85,77,67,32,26,6,4,350
60352409,64,76,65,76,32,22,7,10,352
60352410,65,86,68,60,40,19,4,5,347
60352411,35,60,69,90,39,46,8,16,363
60352501,21,46,43,43,20,13,2,6,194
60352502,32,74,54,42,35,15,11,3,266
60352503,66,107,108,79,46,25,9,7,447
60352504,53,84,56,40,21,12,4,7,277
60352505,61,85,73,62,31,17,4,7,340
60352506,60,77,67,74,32,12,5,3,330
60352507,71,86,42,51,29,18,2,2,301
60352508,58,67,61,62,37,13,4,5,307
60352509,48,83,74,60,39,7,4,1,316
60352510,74,121,131,104,66,38,13,8,555
60352511,50,97,89,82,44,18,4,1,385
60352601,59,95,71,79,62,25,10,9,410
60352602,60,63,84,84,52,41,10,20,414
60352603,23,38,44,40,33,16,4,10,208
60352604,15,18,19,21,8,5,3,1,90
60352605,79,136,141,110,53,41,13,20,593
60352606,23,40,55,39,34,19,4,9,223
60352607,34,46,68,48,46,13,11,11,277
60352608,33,33,52,53,28,20,10,6,235
60352609,35,64,53,44,39,36,12,20,303
60352610,59,75,93,99,50,58,17,33,484
60352611,61,66,85,96,58,49,8,13,436
60352612,32,52,44,45,21,20,6,8,228
60352613,26,36,41,35,30,21,8,10,207
60352614,39,50,54,50,32,28,5,9,267
60352615,68,79,72,50,31,22,6,4,332
60352701,11,9,7,12,11,7,7,5,69
60352702,44,52,72,51,22,8,6,6,261
60352703,60,60,61,45,33,14,7,5,285
60352704,85,92,119,109,91,59,16,40,611
60352705,34,60,57,48,28,16,1,2,246
60352706,74,88,93,88,63,48,10,18,482
60352707,35,45,73,77,64,32,23,25,374
60352708,21,28,26,29,17,2,4,1,128
60352709,46,74,67,55,38,9,5,9,303
60352710,34,63,57,61,36,12,6,13,282
60352711,61,83,78,89,69,54,10,25,469
60352712,60,91,83,72,49,29,9,19,412
60352713,47,52,46,34,29,14,4,4,230
60352714,25,36,64,59,41,37,16,19,297
60352801,64,95,68,68,31,17,6,5,354
60352802,53,83,73,63,38,18,7,5,340
60352803,58,65,67,56,25,18,6,3,298
60352804,56,71,55,61,22,5,1,1,272
60352805,51,72,68,64,30,9,4,1,299
60352806,60,75,75,71,27,9,1,3,321
60352807,48,67,44,67,22,7,5,1,261
60352808,71,81,75,70,25,11,6,1,340
60352901,43,60,44,42,20,13,1,0,223
60352902,60,66,63,67,28,13,6,1,304
60352903,66,94,73,62,31,7,9,3,345
60352904,30,70,66,63,27,8,2,1,267
60352905,50,60,70,40,24,6,2,2,254
60352906,64,88,57,43,30,12,0,2,296
60352907,50,76,60,37,22,12,6,0,263
60352908,32,70,48,51,23,15,1,2,242
60352909,42,60,58,35,16,7,0,1,219
60353001,63,91,70,63,36,18,3,3,347
60353002,45,59,69,53,41,27,8,9,311
60353003,58,80,52,56,33,16,3,3,301
60353004,64,79,77,70,30,18,7,14,359
60353005,50,65,50,54,23,13,2,5,262
60353006,68,104,63,53,29,11,1,4,333
60353007,65,83,80,57,33,18,1,4,341
60353008,62,99,81,64,30,16,3,1,356
60353009,50,72,65,54,23,10,3,7,284
60353010,62,77,81,51,19,6,1,3,300
60353101,29,50,37,22,13,5,0,0,156
60353102,30,50,32,28,12,7,1,1,161
60353103,60,74,59,50,20,6,2,0,271
60353104,115,125,89,47,19,3,2,1,401
60353105,72,94,80,58,32,26,5,6,373
60353106,44,51,56,43,11,1,1,0,207
60353107,27,50,23,33,8,3,6,2,152
60353108,47,66,63,46,17,5,3,4,251
60353109,49,65,49,34,14,6,1,1,219
60353201,79,91,81,60,21,15,5,1,353
60353202,45,69,65,47,19,6,3,4,258
60353203,64,86,83,48,26,11,4,3,325
60353204,56,96,56,57,23,10,3,0,301
60353205,58,73,49,38,15,6,3,2,244
60353206,61,79,63,59,30,13,2,3,310
60353207,61,94,75,69,24,14,4,2,343
60353208,56,87,62,54,18,7,1,1,286
60353301,59,98,60,56,24,15,2,6,320
60353302,77,82,56,64,20,9,0,3,311
60353303,80,114,96,67,26,16,2,4,405
60353304,59,75,66,56,19,11,3,0,289
60353305,35,65,43,20,11,4,2,3,183
60353306,63,79,66,49,22,7,3,2,291
60353307,63,105,41,44,25,7,5,5,295
60353308,54,54,54,56,24,8,3,1,254
60353401,67,71,45,40,25,7,5,4,264
60353402,53,60,45,45,17,13,2,5,240
60353403,48,65,52,36,12,8,1,1,223
60353404,81,52,60,38,18,5,5,0,259
60353405,49,59,49,55,18,5,1,8,244
60353406,61,95,74,62,26,12,5,6,341
60353407,66,71,56,37,4,5,2,1,242
60353408,44,60,59,37,31,10,8,2,251
60353409,53,73,53,42,23,5,3,0,252
60353501,46,83,71,74,35,12,7,4,332
60353502,56,68,61,49,38,11,1,4,288
60353503,60,61,64,48,21,14,3,2,273
60353504,34,59,46,56,31,14,3,3,246
60353505,88,88,107,72,44,35,9,20,463
60353506,49,58,54,42,25,15,6,4,253
60353507,39,70,56,45,17,8,6,1,242
60353508,45,71,43,48,27,7,1,5,247
60910101,51,74,85,85,48,38,9,30,420
60910102,50,59,86,76,66,51,19,26,433
60910103,40,78,47,33,19,5,3,1,226
60910104,56,74,66,42,11,4,2,0,255
60910105,37,49,54,53,27,11,1,1,233
60910106,26,59,41,65,25,6,1,1,224
60910107,49,97,99,85,36,17,3,5,391
60910108,56,94,91,57,19,6,1,6,330
60910109,90,105,94,85,50,18,4,3,449
60910110,34,47,58,53,43,24,6,6,271
60910201,60,92,75,70,38,20,11,9,375
60910202,42,63,66,68,36,16,4,2,297
60910203,44,55,49,47,13,4,0,0,212
60910204,98,101,51,48,19,8,2,0,327
60910205,68,77,62,49,9,4,0,0,269
60910206,42,59,43,35,17,4,1,1,202
60910207,47,67,49,35,17,9,0,0,224
60910208,67,120,78,63,28,9,4,3,372
60910209,55,110,106,68,37,25,13,10,424
60910301,93,134,81,61,21,7,2,1,400
60910302,48,91,94,74,55,28,10,14,414
60910303,51,63,37,34,19,10,2,5,221
60910304,38,60,57,66,39,20,9,11,300
60910305,29,56,56,55,23,14,2,1,236
60910306,54,101,96,86,49,24,3,9,422
60910307,59,85,88,92,36,32,4,7,403
60910308,33,49,71,44,24,11,4,5,241
60910309,61,114,95,80,30,14,2,0,396
60910310,84,143,80,47,32,10,5,1,402
60910311,84,98,51,39,25,8,1,1,307
60910312,28,51,35,24,11,5,1,1,156
60910313,80,74,28,26,8,3,1,0,220
60910401,34,51,84,70,55,53,23,26,396
60910402,28,48,76,85,58,26,14,18,353
60910403,46,67,104,116,54,34,10,16,447
60910404,54,76,80,75,55,70,23,26,459
60910405,66,113,89,102,52,29,9,5,465
60910406,48,48,79,76,45,53,21,32,402
60910407,32,70,75,78,57,45,14,20,391
60910408,42,44,47,44,27,12,5,2,223
60910409,66,72,100,101,69,48,31,31,518
60910410,56,85,104,93,76,54,20,32,520
60910411,73,65,82,80,52,50,14,15,431
60910412,54,88,67,88,55,26,10,10,398
60910501,35,59,102,102,68,45,29,39,479
60910502,54,80,88,83,43,22,7,1,378
60910503,48,80,78,97,58,59,15,14,449
60910504,17,51,64,70,35,5,1,2,245
60910505,82,107,89,76,29,16,4,4,407
60910506,37,52,64,47,32,17,2,1,252
60910507,37,53,74,65,37,15,13,5,299
60910508,29,41,46,40,32,21,4,10,223
60910509,23,21,39,31,23,11,5,7,160
60910510,5,3,8,4,5,2,0,0,27
60910601,29,68,76,95,31,25,7,12,343
60910602,55,91,66,51,37,8,6,4,318
60910603,37,65,66,47,20,13,7,3,258
60910604,43,79,51,45,27,16,2,4,267
60910605,37,59,46,46,26,12,3,3,232
60910606,31,60,63,45,51,27,16,14,307
60910607,52,69,83,100,45,40,9,11,409
60910608,41,73,105,97,64,48,18,27,473
60910609,47,70,66,79,62,38,20,23,405
60910610,33,45,77,81,56,40,19,19,370
60910611,34,51,70,57,52,35,12,11,322
60910701,49,79,85,78,43,31,4,5,374
60910702,46,78,78,58,37,14,8,9,328
60910703,43,58,45,51,29,11,4,4,245
60910704,34,74,73,50,34,23,8,9,305
60910705,31,52,60,54,45,16,8,2,268
60910706,42,72,51,50,36,24,9,10,294
60910707,54,89,86,93,54,24,11,13,424
60910708,26,55,84,60,62,46,12,17,362
60910709,40,44,50,66,47,38,16,16,317
60910710,51,76,87,68,54,28,15,11,390
60910801,34,88,49,64,23,6,1,1,266
60910802,41,57,51,37,16,10,1,0,213
60910803,28,56,46,62,26,10,10,10,248
60910804,40,51,66,74,28,22,15,12,308
60910805,30,48,63,51,32,11,5,4,244
60910806,44,50,71,68,40,16,3,7,299
60910807,62,91,105,81,44,31,12,13,439
60910808,55,93,99,85,64,37,15,10,458
60910809,56,82,84,84,58,24,9,8,405
60910810,68,98,81,61,31,22,5,10,376
60910901,42,67,55,46,10,4,2,1,227
60910902,54,113,91,82,35,19,6,2,402
60910903,67,88,98,88,46,20,6,5,418
60910904,58,96,113,87,35,19,7,7,422
60910905,33,71,52,28,16,8,0,2,210
60910906,67,91,88,63,26,17,3,5,360
60910907,66,121,105,93,37,19,1,3,445
60910908,43,53,55,41,21,7,2,2,224
60911001,62,108,87,54,29,9,4,1,354
60911002,37,58,42,43,20,6,0,3,209
60911003,61,99,113,92,45,24,6,8,448
60911004,33,67,61,52,21,4,3,1,242
60911005,78,124,105,81,34,24,2,5,453
60911006,67,99,97,105,48,27,8,11,462
60911007,41,52,91,60,34,25,4,8,315
60911008,37,64,49,60,40,17,5,6,278
60911009,36,80,68,63,30,9,2,2,290
60911010,82,133,120,114,56,39,5,6,555
60911011,40,78,95,104,46,38,10,8,419
60911101,93,111,102,84,34,22,6,2,454
60911102,84,114,92,87,51,20,1,4,453
60911103,36,51,48,46,17,7,1,0,206
60911104,55,62,47,41,14,2,2,1,224
60911105,54,92,81,58,23,12,4,2,326
60911106,66,94,72,63,28,12,2,2,339
60911107,85,105,83,69,34,21,7,2,406
60911108,67,83,108,90,37,28,9,4,426
60911109,73,99,87,89,40,25,6,9,428
60911201,42,74,85,78,48,25,8,10,370
60911202,62,83,103,105,57,26,6,11,453
60911203,54,69,73,73,43,27,10,9,358
60911204,62,78,85,84,41,18,8,5,381
60911205,37,76,82,65,40,21,4,10,335
60911206,47,77,84,87,65,48,13,22,443
60911207,35,61,48,62,36,20,7,9,278
60911208,55,98,91,95,55,49,7,25,475
60911301,39,66,73,66,53,37,12,17,363
60911302,28,65,68,75,41,27,11,12,327
60911303,22,45,71,73,46,22,8,16,303
60911304,36,50,65,84,60,30,16,20,361
60911305,33,70,92,89,60,39,15,20,418
60911306,45,59,80,83,57,15,14,9,362
60911307,40,60,61,57,41,16,12,11,298
60911308,24,48,66,66,43,25,21,15,308
60911309,50,111,118,89,62,22,7,10,469
60911310,67,74,76,95,39,39,11,12,413
60911311,38,49,54,54,39,23,7,6,270
60911312,39,57,53,57,37,22,8,4,277
60911401,54,66,72,100,66,57,28,37,480
60911402,56,61,76,81,52,37,17,20,400
60911403,31,59,54,43,35,31,7,17,277
60911404,30,74,84,55,38,31,12,10,334
60911405,32,32,79,78,66,34,18,25,364
60911406,27,41,71,74,50,37,16,22,338
60911407,44,76,82,93,51,31,13,13,403
60911408,39,100,76,80,42,33,5,10,385
60911409,31,52,68,37,40,9,14,10,261
60911410,57,104,118,113,59,38,12,21,522
60911411,54,87,95,109,48,27,15,13,448
60911412,46,72,53,72,22,19,8,13,305
60911413,39,43,57,57,42,30,12,10,290
60911501,26,53,52,55,35,10,8,8,247
60911502,22,44,59,52,37,20,10,5,249
60911503,38,65,73,67,37,13,4,2,299
60911504,75,114,103,79,51,17,3,4,446
60911505,36,68,68,75,24,14,7,7,299
60911506,42,55,66,72,38,17,8,9,307
60911507,35,67,42,41,30,13,5,12,245
60911508,25,54,67,58,35,23,14,21,297
60911509,48,58,45,44,28,11,3,1,238
60911510,36,51,69,57,33,21,7,11,285
60911511,54,69,74,89,61,39,10,14,410
60911512,54,66,59,52,28,16,6,5,286
60911513,37,45,55,59,28,14,5,3,246
60911601,52,75,91,69,50,31,8,6,382
60911602,60,93,91,82,64,26,11,9,436
60911603,30,41,54,50,38,21,12,13,259
60911604,50,82,98,86,42,33,14,11,416
60911605,54,91,102,74,59,25,11,21,437
60911606,22,51,48,59,40,26,7,8,261
60911607,23,41,44,33,20,9,2,2,174
60911608,33,59,66,62,33,11,4,2,270
60911609,31,47,60,73,25,10,5,7,258
60911610,29,53,57,71,42,22,5,6,285
60911611,60,98,101,102,79,51,11,12,514
60911612,19,43,52,67,35,10,2,6,234
60911613,43,86,95,90,67,31,11,9,432
60911614,49,78,78,74,51,26,8,9,373
60911701,31,50,70,60,38,21,6,6,282
60911702,51,100,93,88,46,29,9,18,434
60911703,59,84,112,98,59,30,12,16,470
60911704,27,45,69,57,29,15,12,6,260
60911705,37,51,74,67,52,33,15,28,357
60911706,50,59,75,84,51,18,12,14,363
60911707,33,53,79,74,53,40,27,20,379
60911708,17,39,45,51,40,33,16,9,250
60911709,40,76,87,67,52,29,11,17,379
60911710,38,77,76,82,43,36,9,8,369
60911711,42,60,78,77,52,34,9,9,361
60911712,43,77,76,86,44,20,9,8,363
60911713,29,33,58,57,41,21,7,10,256
60911714,51,59,72,96,77,42,23,32,452
60911801,26,41,46,44,42,25,6,6,236
60911802,34,46,55,56,30,14,5,4,244
60911803,65,104,119,114,79,38,21,11,551
60911804,54,86,97,85,45,34,7,6,414
60911805,52,72,89,68,53,26,13,12,385
60911806,29,64,80,84,56,42,19,17,391
60911807,50,81,83,96,57,27,9,14,417
60911808,49,66,89,72,38,18,5,6,343
60911809,39,70,57,57,21,10,2,2,258
60911810,36,48,43,41,25,18,3,11,225
60911811,61,82,126,102,64,29,10,11,485
60911812,51,105,82,82,50,26,6,13,415
60911901,28,49,48,68,19,6,3,2,223
60911902,33,79,105,120,61,34,6,2,440
60911903,34,53,96,83,40,31,5,7,349
60911904,43,60,83,89,47,41,12,7,382
60911905,22,54,44,52,24,5,2,5,208
60911906,17,56,46,53,19,1,4,0,196
60911907,36,62,51,59,18,9,1,0,236
60911908,47,78,80,91,43,24,8,2,373
60911909,31,56,59,51,24,2,2,1,226
60911910,33,61,72,67,42,17,4,6,302
60911911,31,58,62,57,41,21,4,6,280
60911912,50,90,114,85,51,20,4,4,418
60912001,28,58,94,88,34,25,5,8,340
60912002,39,51,83,106,49,22,10,10,370
60912003,13,26,31,47,19,8,7,2,153
60912004,27,50,44,39,25,21,7,3,216
60912005,43,55,92,79,57,60,15,17,418
60912006,37,49,52,37,26,14,6,5,226
60912007,66,70,62,103,38,13,2,2,356
60912008,36,54,49,45,21,8,1,1,215
60912009,15,36,58,70,34,8,5,2,228
60912010,30,52,69,73,45,26,15,7,317
60912011,37,96,87,89,46,10,3,5,373
60912012,19,39,48,63,28,14,5,11,227
60912013,27,39,40,47,37,18,11,10,229
60912101,24,39,54,57,39,25,10,18,266
60912102,61,89,62,58,27,9,2,4,312
60912103,40,50,56,55,30,19,11,14,275
60912104,42,90,49,51,20,6,3,1,262
60912105,46,75,49,41,29,4,1,3,248
60912106,26,43,43,57,35,25,13,12,254
60912107,40,52,86,67,47,39,12,17,360
60912108,32,36,59,64,28,15,2,7,243
60912109,58,90,78,32,20,11,1,1,291
60912110,59,93,69,52,24,14,3,2,316
60912111,46,47,66,74,57,35,11,20,356
60912112,39,87,77,76,74,38,13,20,424
60912113,21,48,58,76,38,37,11,14,303
60912114,48,74,81,71,39,19,8,10,350
60912115,31,58,60,64,35,20,5,8,281
60912116,28,40,67,65,49,18,15,32,314
60912117,49,71,102,88,62,49,14,11,446
60912201,45,69,80,90,41,21,10,11,367
60912202,38,60,78,90,31,15,4,1,317
60912203,47,85,62,91,46,29,3,7,370
60912204,24,75,63,88,60,23,4,3,340
60912205,7,35,52,89,61,17,1,3,265
60912206,33,71,90,93,52,35,13,27,414
60912207,37,58,76,63,25,20,13,17,309
60912208,36,53,53,62,32,19,4,6,265
60912209,33,43,48,43,29,14,6,8,224
60912210,66,82,107,98,55,42,18,25,493
60912211,18,27,33,45,14,6,1,0,144
60912212,8,33,34,32,16,1,0,0,124
60912213,8,44,46,83,49,18,4,2,254
60912214,9,41,38,55,26,3,2,1,175
60912215,48,74,78,96,56,33,13,12,410
60912216,39,76,84,103,57,31,12,13,415
60912217,6,33,35,107,24,5,0,1,211
60912301,24,49,66,53,31,23,13,7,266
60912302,37,50,64,64,37,31,6,12,301
60912303,39,53,49,51,34,15,2,5,248
60912304,54,85,94,76,44,27,11,9,400
60912305,37,50,57,52,19,11,1,1,228
60912306,53,81,70,95,44,25,11,9,388
60912307,30,58,53,41,30,8,2,1,223
60912308,28,44,60,56,21,9,6,7,231
60912309,25,38,42,33,18,9,9,5,179
60912310,50,90,118,79,59,34,12,13,455
60912311,33,43,63,84,48,32,8,11,322
60912312,24,34,43,43,22,15,4,8,193
60912313,12,27,41,49,28,10,1,3,171
60912314,8,13,21,11,11,5,2,1,72
60912315,29,43,43,41,35,21,11,9,232
60912316,23,24,22,30,9,6,1,0,115
60912317,15,31,31,37,22,8,2,1,147
60912318,6,16,7,17,5,4,0,3,58
60912319,18,16,20,16,9,3,2,1,85
60912401,31,32,45,52,23,11,3,7,204
60912402,26,47,43,52,34,15,1,5,223
60912403,23,40,63,65,33,22,10,17,273
60912404,43,58,81,89,55,48,14,15,403
60912405,32,44,56,50,34,23,15,27,281
60912406,49,60,71,48,33,19,2,3,285
60912407,25,41,43,25,10,5,1,3,153
60912408,27,27,35,19,15,9,2,2,136
60912409,15,33,22,16,10,5,2,1,104
60912410,22,48,61,53,29,15,8,5,241
60912411,16,45,52,69,32,23,9,4,250
60912412,33,24,40,29,29,14,3,7,179
60912413,31,39,36,35,22,14,9,4,190
62600101,61,53,108,90,57,41,12,24,446
62600102,52,62,73,72,49,24,14,13,359
62600103,24,43,46,62,44,33,4,15,271
62600104,39,35,51,48,33,20,3,6,235
62600105,51,65,81,54,27,19,5,4,306
62600106,49,90,108,111,70,55,15,22,520
62600107,50,72,74,76,45,27,11,13,368
62600108,65,74,106,88,58,40,7,8,446
62600109,49,65,80,83,45,22,10,26,380
62600110,48,90,106,114,47,42,11,11,469
62600111,46,46,72,60,29,25,7,10,295
62600112,36,82,77,76,73,43,16,15,418
62600113,34,50,50,62,38,23,10,11,278
62600114,35,58,75,69,48,39,17,11,352
62600115,40,64,59,53,47,26,14,9,312
62600116,31,66,69,68,40,31,7,12,324
62600117,56,93,90,104,57,32,16,16,464
62600118,20,32,44,35,20,13,5,7,176
62600119,51,69,79,85,54,31,17,20,406
62600201,54,115,129,111,78,53,20,27,587
62600202,52,83,105,129,57,43,20,12,501
62600203,59,61,102,95,70,46,27,21,481
62600204,29,53,81,77,64,43,16,25,388
62600205,40,55,77,89,78,65,22,42,468
62600206,23,46,60,77,56,33,12,21,328
62600207,41,65,87,96,57,50,11,17,424
62600208,14,24,19,14,5,4,1,1,82
62600209,48,56,109,89,57,41,27,16,443
62600210,49,61,83,91,51,25,18,12,390
62600211,41,55,74,91,56,40,12,16,385
62600212,22,40,80,73,63,36,19,15,348
62600213,30,63,58,76,47,42,7,11,334
62600214,36,67,77,93,37,27,8,14,359
62600215,33,65,83,111,51,44,11,13,411
62600216,27,54,90,88,56,24,11,14,364
62600301,109,144,156,151,74,46,11,12,703
62600302,17,30,44,65,37,25,12,17,247
62600303,36,37,69,62,54,43,13,24,338
62600304,53,63,93,127,87,62,17,32,534
62600305,29,64,87,87,45,41,19,21,393
62600306,39,46,50,54,50,29,8,17,293
62600307,33,65,77,93,63,32,5,7,375
62600308,35,44,60,78,52,32,10,9,320
62600309,13,38,53,56,30,19,5,8,222
62600310,24,82,106,121,78,34,14,12,471
62600311,15,50,88,95,74,57,25,28,432
62600312,15,60,162,139,86,34,15,8,519
62600313,22,64,100,126,73,46,20,12,463
62600314,24,37,55,60,39,27,3,14,259
62600315,29,45,59,83,41,19,5,5,286
62600316,38,56,95,97,56,45,9,13,409
62600317,36,62,83,93,51,34,11,7,377
62600318,39,61,83,68,45,13,24,12,345
62600319,36,68,75,59,54,22,3,8,325
62600401,34,52,68,56,34,26,3,4,277
62600402,45,60,74,82,43,29,13,18,364
62600403,31,75,68,75,41,30,10,9,339
62600404,39,74,87,54,40,16,13,13,336
62600405,39,65,80,67,31,18,4,9,313
62600406,27,64,79,75,46,24,9,7,331
62600407,35,56,69,54,38,20,8,9,289
62600408,43,89,86,76,32,30,4,4,364
62600409,38,59,72,68,39,23,6,6,311
62600410,36,71,42,43,20,15,6,2,235
62600411,47,52,53,46,26,18,1,4,247
62600412,52,71,63,69,37,21,10,8,331
62600501,49,60,66,78,49,23,11,15,351
62600502,33,61,61,79,44,24,9,14,325
62600503,41,36,63,37,26,20,5,12,240
62600504,54,65,74,84,46,28,7,13,371
62600505,39,50,72,94,55,35,16,11,372
62600506,42,63,83,91,58,53,12,22,424
62600507,32,46,78,63,51,22,16,13,321
62600508,34,49,35,23,23,13,5,5,187
62600509,48,67,78,81,53,24,16,11,378
62600510,41,55,66,62,38,17,11,7,297
62600511,29,61,94,84,53,44,13,27,405
62600512,33,57,52,81,43,25,9,13,313
62600513,38,69,94,91,47,42,7,11,399
62600514,36,61,88,78,55,42,13,13,386
62600515,51,60,67,71,56,29,11,12,357
62600516,21,60,57,50,30,13,4,11,246
62600517,34,70,67,65,24,8,8,7,283
62600601,54,66,102,80,55,26,6,9,398
62600602,40,71,73,64,23,17,2,5,295
62600603,48,76,81,66,41,9,3,2,326
62600604,75,104,107,75,46,18,4,3,432
62600605,73,95,86,67,44,20,9,6,400
62600606,33,54,46,53,19,11,2,3,221
62600607,30,40,62,53,34,15,5,8,247
62600608,33,60,59,54,28,9,1,2,246
62600609,30,61,68,59,16,11,2,0,247
62600610,24,52,42,41,19,9,3,3,193
62600611,44,46,56,56,29,8,0,0,239
62600612,54,101,86,62,34,6,1,2,346
62600613,56,86,77,72,28,14,3,5,341
62600614,61,112,77,62,27,8,4,2,353
62600615,58,82,72,50,20,15,4,2,303
62600616,65,102,86,80,40,12,3,2,390
62600701,91,123,102,105,41,15,4,7,488
62600702,53,117,87,67,34,10,1,0,369
62600703,62,127,90,84,37,13,3,1,417
62600704,56,74,74,70,34,7,2,2,319
62600705,36,46,51,77,23,16,3,2,254
62600706,56,63,77,69,33,24,6,9,337
62600707,40,77,82,81,45,17,2,7,351
62600708,37,60,55,48,34,13,3,5,255
62600709,53,69,60,62,34,12,5,2,297
62600710,54,127,107,87,41,11,4,3,434
62600711,59,85,65,62,33,11,6,2,323
62600712,67,91,52,63,24,6,2,0,305
62600713,87,105,67,48,16,7,2,0,332
62600801,30,37,73,69,53,46,11,13,332
62600802,56,64,99,95,56,41,16,13,440
62600803,30,48,54,70,39,47,14,15,317
62600804,35,62,91,85,66,49,13,32,433
62600805,23,38,67,58,38,34,13,19,290
62600806,22,53,53,71,56,50,6,9,320
62600807,18,50,39,57,45,32,14,11,266
62600808,45,75,70,89,48,26,6,10,369
62600809,50,83,82,57,33,30,7,10,352
62600810,29,47,54,58,28,21,8,9,254
62600811,43,68,73,70,59,46,13,18,390
62600812,39,60,87,88,60,33,19,16,402
62600813,51,89,83,107,59,35,9,13,446
62600814,34,59,65,61,42,17,8,9,295
62600901,51,60,74,60,50,24,14,11,344
62600902,34,49,83,64,49,30,8,8,325
62600903,58,82,114,104,71,35,18,20,502
62600904,52,86,74,87,69,54,11,22,455
62600905,19,45,65,73,44,25,14,19,304
62600906,15,22,21,19,10,6,2,5,100
62600907,51,74,91,100,61,24,10,9,420
62600908,38,78,100,96,68,37,11,10,438
62600909,34,55,48,53,17,29,8,5,249
62600910,45,65,66,90,50,29,13,14,372
62600911,58,79,73,97,71,25,12,20,435
62600912,23,46,78,65,46,27,9,15,309
62600913,38,63,85,92,82,33,19,13,425
62600914,37,64,66,70,45,19,9,4,314
62601001,45,63,73,59,39,24,13,21,337
62601002,33,40,63,66,31,31,5,6,275
62601003,57,87,74,79,41,18,6,5,367
62601004,52,63,52,75,33,23,2,3,303
62601005,34,31,37,30,10,3,1,0,146
62601006,231,320,341,217,114,30,4,13,1270
62601007,43,83,74,77,42,34,7,16,376
62601008,42,74,61,75,45,25,4,12,338
62601009,27,49,43,48,35,20,11,5,238
62601010,35,52,66,48,25,17,8,9,260
62601011,44,67,69,65,33,35,16,8,337
62601012,38,45,67,60,28,29,10,14,291
62601013,41,52,79,106,50,39,21,24,412
62601014,25,28,59,49,32,37,12,16,258
62601015,16,26,34,23,18,10,4,6,137
62601101,51,45,17,11,3,2,0,1,130
62601102,72,55,37,18,7,2,3,1,195
62601103,83,123,73,49,23,13,1,1,366
62601104,60,92,82,68,26,8,0,0,336
62601105,49,73,69,60,28,11,2,0,292
62601106,27,68,41,34,11,5,2,1,189
62601107,77,132,81,79,30,15,4,1,419
62601108,62,91,90,76,30,13,3,0,365
62601109,44,63,91,94,38,14,5,4,353
62601110,55,75,82,92,52,20,8,5,389
62601201,77,89,64,55,19,4,0,0,308
62601202,27,52,47,38,13,6,3,1,187
62601203,48,51,30,25,11,4,1,0,170
62601204,57,89,62,57,28,7,3,0,303
62601205,72,92,95,86,42,13,4,3,407
62601206,43,99,90,77,28,10,4,2,353
62601207,30,57,61,38,16,8,0,3,213
62601208,57,78,75,65,25,10,3,1,314
62601209,41,63,59,67,23,15,4,2,274
62601210,25,47,49,48,20,7,2,6,204
62601211,34,56,68,71,31,14,3,6,283
62601212,35,59,75,71,45,33,13,10,341
62601301,37,54,74,61,18,4,3,2,253
62601302,88,138,103,93,36,12,7,0,477
62601303,62,106,85,62,31,13,0,1,360
62601304,63,108,68,69,28,7,4,2,349
62601305,53,109,106,100,36,18,6,1,429
62601306,57,106,58,80,23,13,4,3,344
62601307,54,98,102,68,28,11,6,4,371
62601308,64,84,78,72,38,15,1,4,356
62601309,47,85,62,62,37,21,7,8,329
62601310,43,57,44,40,17,6,2,0,209
62601311,87,94,46,25,13,1,1,2,269
62601312,57,52,35,20,4,3,0,0,171
62601313,56,68,46,39,13,5,1,0,228
62601314,95,74,27,13,8,0,1,0,218
62601401,51,112,78,87,38,17,3,5,391
62601402,45,74,60,69,29,18,1,1,297
62601403,42,75,61,66,32,8,2,1,287
62601404,26,49,54,46,29,8,1,1,214
62601405,50,95,77,84,38,18,5,3,370
62601406,90,126,102,87,33,10,1,4,453
62601407,45,67,57,57,30,16,4,5,281
62601408,41,70,92,85,53,31,6,4,382
62601409,48,63,98,90,52,19,6,4,380
62601410,63,86,86,77,51,22,7,9,401
62601411,47,63,84,79,38,17,7,10,345
62601412,40,69,62,45,17,16,0,0,249
62601413,48,52,61,57,42,19,5,7,291
62601501,49,54,98,93,67,48,17,17,443
62601502,34,70,87,69,40,19,7,12,338
62601503,17,43,44,36,36,12,5,7,200
62601504,29,55,56,52,31,11,11,10,255
62601505,42,49,77,77,60,23,9,11,348
62601506,32,54,81,52,38,36,12,12,317
62601507,32,49,56,63,36,29,11,16,292
62601508,17,39,40,70,32,33,14,19,264
62601509,23,41,69,75,62,50,26,22,368
62601510,45,63,81,109,75,58,16,22,469
62601511,43,63,87,110,64,36,16,29,448
62601512,50,53,51,64,36,22,10,8,294
62601513,36,55,71,79,53,31,10,7,342
62601514,25,46,40,48,33,28,6,18,244
62601515,21,35,47,72,37,53,5,15,285
62601516,20,59,45,68,54,29,13,19,307
62601517,46,71,100,107,75,53,10,21,483
62601518,40,73,101,106,60,43,19,12,454
62601519,40,58,73,69,54,26,5,4,329
62601601,41,84,93,97,51,24,7,15,412
62601602,45,54,66,61,51,22,7,11,317
62601603,29,57,89,87,62,42,10,18,394
62601604,31,61,61,66,45,23,11,8,306
62601605,42,59,90,89,41,30,8,11,370
62601606,51,64,81,98,42,27,10,13,386
62601607,29,49,72,79,51,46,27,24,377
62601608,11,18,27,21,25,11,6,6,125
62601609,37,61,63,58,44,38,13,22,336
62601610,26,45,57,60,46,24,15,13,286
62601611,17,39,63,58,46,37,22,21,303
62601612,24,63,60,79,54,36,13,16,345
62601613,38,53,58,74,44,26,11,14,318
62601614,50,89,85,117,49,46,13,23,472
62601615,48,70,114,97,58,42,10,16,455
62601616,43,68,80,90,34,29,8,9,361
62601617,43,85,79,97,65,24,10,13,416
62601701,77,116,122,96,64,28,10,2,515
62601702,6,3,4,5,1,0,0,2,21
62601703,405,240,198,180,107,50,23,20,1223
62601704,26,41,56,51,40,26,7,15,262
62601705,11,10,13,12,10,2,1,3,62
62601706,35,65,76,155,73,32,8,13,457
62601707,9,12,6,15,7,7,0,2,58
62601708,10,27,49,71,37,11,0,1,206
62601709,5,16,9,22,17,5,2,1,77
62601710,14,37,21,17,14,4,0,0,107
62601711,8,13,21,20,14,9,0,0,85
62601712,4,28,15,35,18,5,1,2,108
62601713,32,104,129,234,116,19,9,0,643
62601714,8,10,6,18,9,1,0,0,52
62700101,13,29,36,63,32,6,1,1,181
62700102,31,58,36,35,14,4,4,3,185
62700103,21,49,24,37,12,1,0,0,144
62700104,24,42,74,73,47,36,16,26,338
62700105,34,54,32,30,13,5,1,0,169
62700106,22,31,45,43,21,6,1,0,169
62700201,49,84,93,98,66,60,32,19,501
62700202,26,42,45,46,44,23,12,13,251
62700203,37,57,61,56,30,24,7,9,281
62700204,37,45,68,60,37,25,7,9,288
62700205,54,80,71,53,35,10,5,1,309
62700206,82,116,103,96,34,26,6,9,472
62700207,51,71,91,93,48,24,12,12,402
62700208,40,64,104,98,72,46,26,28,478
62700209,38,74,88,112,62,50,18,22,464
62700210,30,65,88,97,56,34,18,17,405
62700211,45,55,108,91,65,45,14,16,439
62700212,47,69,79,99,59,32,28,16,429
62700213,22,24,46,57,41,35,13,18,256
62700214,26,28,59,61,46,20,12,11,263
62700215,25,35,62,70,45,25,8,7,277
62700216,31,56,59,81,48,32,15,16,338
62700217,49,58,84,89,52,32,9,15,388
62700301,25,35,58,57,28,16,7,6,232
62700302,28,48,59,54,36,30,4,7,266
62700303,43,66,82,89,73,44,15,23,435
62700304,53,74,97,120,77,56,13,16,506
62700305,61,82,90,89,68,36,7,22,455
62700306,36,75,89,69,54,28,15,9,375
62700307,36,64,74,58,30,16,7,2,287
62700308,60,90,85,69,51,29,6,6,396
62700309,54,70,85,77,60,42,9,15,412
62700310,55,66,70,82,45,35,15,15,383
62700311,57,83,81,63,38,25,5,4,356
62700312,67,121,118,86,40,15,2,7,456
62700313,24,65,60,62,24,15,4,4,258
62700314,58,95,51,56,31,10,3,1,305
62700315,63,49,70,39,28,4,0,3,256
62700316,43,66,61,45,25,17,2,3,262
62700401,26,33,41,30,23,11,4,4,172
62700402,40,58,67,53,29,18,6,3,274
62700403,66,105,108,62,22,6,2,1,372
62700404,63,88,79,95,43,13,13,7,401
62700405,56,75,81,81,45,42,10,13,403
62700406,59,80,107,107,69,39,7,12,480
62700407,55,77,81,72,31,17,3,3,339
62700408,44,43,40,26,15,8,4,0,180
62700409,90,112,107,70,38,15,1,0,433
62700410,47,72,89,73,43,26,4,10,364
62700411,53,83,86,115,76,26,20,19,478
62700412,44,86,83,75,53,18,6,5,370
62700413,49,64,82,94,38,16,15,8,366
62700414,37,46,79,62,49,31,17,14,335
62700501,46,63,69,56,38,14,4,4,294
62700502,35,57,60,53,27,11,3,2,248
62700503,35,45,47,58,42,34,4,15,280
62700504,39,56,90,105,64,86,12,13,465
62700505,26,58,79,91,56,36,15,19,380
62700506,21,46,65,90,80,39,12,8,361
62700507,53,80,76,90,42,31,5,7,384
62700508,47,84,80,88,61,48,10,16,434
62700509,1,3,3,1,1,0,1,1,11
62700510,49,62,90,96,60,25,18,18,418
62700511,33,43,50,48,23,14,5,6,222
62700512,37,46,59,47,27,9,9,1,235
62700601,37,55,70,55,35,24,6,9,291
62700602,25,58,44,35,15,7,1,1,186
62700603,21,36,25,14,11,3,1,0,111
62700604,16,33,37,36,11,9,1,2,145
62700605,49,76,70,78,51,22,9,6,361
62700606,69,84,94,73,55,33,20,14,442
62700607,57,69,97,81,58,26,13,19,420
62700608,64,68,90,78,61,41,10,12,424
62700609,38,81,80,76,43,26,9,10,363
62700610,70,84,107,102,67,70,20,39,559
62700611,46,69,98,93,49,32,18,15,420
62700612,7,35,28,23,13,6,1,4,117
62700613,14,25,24,25,12,7,0,1,108
62700614,28,38,59,44,34,19,3,10,235
62700615,19,34,48,45,25,19,8,3,201
62700616,36,57,65,65,42,45,18,18,346
62700617,63,81,101,114,59,25,21,31,495
62700701,27,37,64,59,38,21,8,12,266
62700702,16,45,44,45,28,24,8,8,218
62700703,39,49,63,66,52,23,15,13,320
62700704,34,39,33,42,24,14,2,3,191
62700705,41,50,76,78,32,26,17,17,337
62700706,20,25,45,47,40,29,12,19,237
62700707,55,86,100,89,57,25,13,6,431
62700708,45,60,62,55,13,9,1,1,246
62700709,34,60,44,46,21,11,1,3,220
62700710,25,39,55,36,27,12,8,5,207
62700711,31,67,60,75,67,39,11,17,367
62700712,42,69,95,90,87,40,25,28,476
62700713,23,39,63,54,35,32,9,18,273
62700714,48,60,63,65,45,34,7,9,331
62700715,32,41,76,55,40,20,5,9,278
62700716,58,51,69,68,55,46,11,9,367
62700717,46,65,70,75,58,41,12,22,389
62700718,64,106,95,102,69,50,18,18,522
62700719,57,85,89,80,56,46,12,20,445
62700801,9,18,26,10,4,3,4,1,75
62700802,7,17,7,4,5,2,1,0,43
62700803,12,17,15,18,8,4,0,1,75
62700804,4,4,3,5,2,0,1,0,19
62700805,5,15,8,9,2,4,1,2,46
62700806,3,13,6,5,2,2,1,0,32
62700807,11,18,18,17,4,2,1,1,72
62700808,51,64,78,85,55,27,9,11,380
62700809,21,39,53,59,46,20,13,12,263
62700810,28,26,36,56,35,25,11,21,238
62700811,44,67,80,72,43,15,6,7,334
62700812,3,10,10,3,2,0,0,0,28
62700813,11,14,17,16,4,0,1,0,63
62700814,22,22,17,27,17,6,1,4,116
62700815,27,33,41,32,14,17,1,5,170
62700816,29,23,40,34,28,19,5,10,188
62700817,6,8,6,6,4,5,0,2,37
62700901,78,97,142,135,101,68,22,31,674
62700902,40,60,81,73,56,37,15,23,385
62700903,21,41,60,79,40,39,5,10,295
62700904,60,61,58,63,31,17,6,0,296
62700905,31,54,63,63,49,26,2,14,302
62700906,43,59,67,90,49,29,12,20,369
62700907,44,74,43,33,29,12,7,4,246
62700908,27,34,41,47,33,16,4,6,208
62700909,36,43,73,89,52,43,23,33,392
62700910,44,55,69,86,53,32,17,11,367
62700911,32,61,60,49,28,8,7,6,251
62700912,38,47,67,59,36,19,5,9,280
62700913,36,50,65,65,36,25,12,8,297
62701001,57,81,83,70,40,23,7,9,370
62701002,70,91,132,120,86,53,20,37,609
62701003,79,95,128,131,104,53,29,25,644
62701004,50,81,95,103,70,40,17,14,470
62701005,40,62,73,84,56,27,10,16,368
62701006,35,79,80,69,63,35,12,12,385
62701007,43,64,52,80,56,53,10,19,377
62701008,30,43,67,84,51,36,19,15,345
62701009,28,69,73,94,39,40,14,14,371
62701010,30,55,60,66,59,50,6,12,338
62701101,26,63,103,102,70,35,2,1,402
62701102,1,2,3,4,0,0,1,0,11
62701103,5,4,2,3,5,2,0,0,21
62701104,13,28,24,22,17,5,1,1,111
62701105,0,7,3,3,0,0,0,0,13
62740101,57,78,86,69,42,23,10,9,374
62740102,98,115,84,56,32,9,3,2,399
62740103,39,56,52,45,24,8,2,1,227
62740104,31,55,53,46,19,9,2,0,215
62740105,70,103,112,118,51,22,6,11,493
62740106,42,57,62,57,31,21,4,8,282
62740107,35,49,58,65,27,13,5,1,253
62740108,32,55,35,36,7,6,4,2,177
62740109,29,51,55,63,34,22,2,5,261
62740110,32,63,64,51,33,14,4,3,264
62740111,54,65,58,51,33,25,5,3,294
62740112,20,60,62,48,26,24,5,8,253
62740113,53,86,101,95,63,41,12,12,463
62740114,22,44,61,52,29,23,7,5,243
62740115,66,107,113,113,69,37,15,10,530
62740201,60,111,103,61,46,21,7,4,413
62740202,42,78,65,103,49,23,10,6,376
62740203,51,66,104,96,57,20,10,10,414
62740204,37,70,81,65,23,8,4,0,288
62740205,34,74,84,81,28,19,7,4,331
62740206,63,125,114,87,59,26,11,11,496
62740207,33,72,79,71,38,18,6,4,321
62740208,40,56,66,60,33,27,11,8,301
62740209,35,53,61,58,32,15,10,9,273
62740210,24,36,58,69,49,36,13,13,298
62740211,49,82,92,83,59,44,18,15,442
62740212,35,70,73,69,42,17,11,11,328
62740213,42,55,78,67,37,22,11,11,323
62740214,57,102,103,84,29,14,11,5,405
62740215,55,113,101,65,43,16,6,9,408
62740301,47,67,93,78,59,25,9,5,383
62740302,47,56,63,57,30,22,10,6,291
62740303,24,40,43,53,35,24,7,2,228
62740304,37,71,101,94,77,31,15,26,452
62740305,36,70,86,84,58,34,21,10,399
62740306,22,43,43,42,32,17,7,5,211
62740307,43,99,102,101,54,38,12,9,458
62740308,31,61,65,60,34,31,7,12,301
62740309,28,44,60,48,44,24,10,11,269
62740310,59,79,99,77,41,34,10,4,403
62740311,42,55,82,93,44,18,8,8,350
62740312,35,42,75,88,69,46,16,23,394
62740313,30,60,75,98,56,23,17,18,377
62740314,45,45,60,59,49,46,12,24,340
62740315,30,54,59,50,39,21,9,10,272
62740316,38,62,73,58,36,20,6,14,307
62740401,36,57,88,83,51,24,12,11,362
62740402,38,85,83,87,50,33,19,15,410
62740403,32,57,80,84,58,36,10,14,371
62740404,37,52,72,82,57,36,14,18,368
62740405,62,64,52,67,39,22,12,11,329
62740406,29,61,69,60,44,21,9,10,303
62740407,32,42,60,58,30,21,12,11,266
62740408,37,39,46,67,26,18,3,7,243
62740409,48,58,75,78,59,37,20,26,401
62740410,40,67,63,71,39,32,15,15,342
62740411,26,59,42,68,39,25,8,16,283
62740412,48,65,94,116,66,53,18,30,490
62740413,27,56,59,55,49,42,13,17,318
62740414,31,20,47,83,47,36,20,16,300
62740415,23,59,74,74,49,39,10,20,348
62740416,17,49,70,52,45,35,13,17,298
62740417,29,50,58,69,44,26,9,18,303
62740501,46,59,58,56,34,12,4,6,275
62740502,32,59,54,53,34,23,8,6,269
62740503,35,34,64,67,35,20,12,5,272
62740504,43,64,81,68,41,29,13,8,347
62740505,25,25,59,48,40,22,8,14,241
62740506,19,34,49,46,36,21,8,12,225
62740507,30,46,67,70,41,31,18,19,322
62740508,53,77,89,101,56,16,3,6,401
62740509,28,51,55,54,36,27,5,12,268
62740510,34,62,78,70,39,20,6,9,318
62740511,57,62,77,77,54,25,8,6,366
62740512,38,72,81,64,62,20,11,11,359
62740513,33,54,51,77,37,28,12,11,303
62740514,49,53,62,79,54,49,14,14,374
62740515,31,53,70,79,56,37,14,15,355
62740516,69,45,63,45,44,15,16,18,315
62740601,39,76,84,84,57,45,11,9,405
62740602,38,57,74,71,33,25,5,3,306
62740603,35,54,69,63,46,17,6,14,304
62740604,34,61,76,50,45,13,6,8,293
62740605,49,55,102,89,53,34,7,7,396
62740606,47,69,75,77,64,38,18,8,396
62740607,17,42,68,52,35,23,10,8,255
62740608,26,41,48,54,37,19,7,13,245
62740609,27,30,54,60,48,19,3,11,252
62740610,38,63,68,57,30,12,8,3,279
62740611,27,43,50,55,47,20,5,15,262
62740612,27,46,56,77,37,10,9,12,274
62740613,21,39,43,53,39,23,7,13,238
62740614,33,43,47,50,39,26,11,15,264
62740615,26,44,57,76,44,46,20,32,345
62740616,21,28,49,32,35,21,17,17,220
62740617,16,44,49,49,54,34,13,15,274
62740618,15,23,43,40,41,28,13,26,229
62740619,25,24,29,45,28,26,7,14,198
62740620,32,43,64,64,62,49,15,35,364
62740701,34,33,35,50,17,14,5,1,189
62740702,34,51,49,46,31,17,14,10,252
62740703,24,48,58,63,48,26,23,12,302
62740704,30,31,57,61,51,26,13,18,287
62740705,41,58,71,66,47,25,5,11,324
62740706,31,59,71,89,53,33,16,23,375
62740707,29,44,69,85,61,40,15,17,360
62740708,46,84,75,81,51,30,20,30,417
62740709,35,50,68,74,59,30,9,14,339
62740710,25,44,58,70,47,27,16,16,303
62740711,25,37,52,54,28,32,5,6,239
62740712,17,50,60,53,44,34,14,5,277
62740713,38,47,56,65,77,42,20,12,357
62740801,23,39,28,43,30,15,6,5,189
62740802,34,63,54,57,31,20,6,4,269
62740803,33,78,61,51,28,11,0,0,262
62740804,25,48,58,44,41,19,10,12,257
62740805,29,54,57,46,24,24,4,5,243
62740806,23,34,49,29,20,15,11,8,189
62740807,49,57,72,90,47,29,15,17,376
62740808,42,44,58,51,30,23,4,9,261
62740809,30,33,51,53,37,19,12,16,251
62740810,18,34,57,58,48,40,16,30,301
62740811,23,31,50,50,31,25,15,17,242
62740812,24,37,49,54,42,19,18,11,254
62740813,42,60,75,77,63,48,23,28,416
62740814,28,53,79,57,41,33,19,13,323
62740815,28,61,62,84,48,35,7,4,329
62740816,31,54,62,57,43,19,6,11,283
62740817,21,33,55,56,36,19,10,17,247
62740818,29,48,58,54,48,33,7,23,300
62740819,32,52,70,69,47,32,11,12,325
62740820,32,49,66,78,38,35,11,31,340
62740901,47,58,70,61,44,42,3,19,344
62740902,31,53,58,68,37,31,23,11,312
62740903,33,48,67,75,46,23,12,23,327
62740904,23,52,54,63,44,20,16,20,292
62740905,24,39,40,57,38,26,18,14,256
62740906,43,63,97,85,58,43,5,26,420
62740907,22,32,51,54,31,21,8,12,231
62740908,25,37,38,42,23,27,8,8,208
62740909,28,44,47,33,22,21,3,6,204
62740910,32,66,88,73,52,13,8,9,341
62740911,23,21,45,69,34,16,9,9,226
62740912,34,38,50,59,25,18,11,12,247
62740913,24,37,53,57,42,20,8,16,257
62740914,22,41,44,51,30,26,10,24,248
62740915,32,77,73,88,59,30,14,29,402
62740916,27,52,49,40,34,21,13,9,245
62740917,31,38,62,72,37,19,25,13,297
62740918,25,41,73,61,42,26,8,11,287
62740919,39,49,76,71,57,27,14,22,355
62740920,54,59,66,65,47,41,12,20,364
62740921,42,51,89,54,48,26,14,20,344
62740922,31,43,62,55,35,29,11,16,282
62741001,44,53,68,58,46,36,16,15,336
62741002,50,44,52,65,36,36,10,9,302
62741003,37,67,82,85,54,31,16,28,400
62741004,30,39,46,56,42,34,9,16,272
62741005,23,43,47,49,38,24,8,5,237
62741006,9,29,47,46,47,27,7,17,229
62741007,33,56,82,75,54,35,12,19,366
62741008,26,48,75,77,59,26,17,21,349
62741009,12,28,35,41,46,34,15,24,235
62741010,32,46,50,52,49,19,10,20,278
62741011,28,33,38,54,29,13,5,10,210
62741012,35,54,66,52,50,28,8,15,308
62741013,23,25,41,32,17,19,3,5,165
62741014,35,38,51,44,26,24,12,19,249
62741015,40,39,55,48,43,21,16,16,278
62741101,51,51,66,58,42,12,4,9,293
62741102,45,60,71,81,55,15,6,9,342
62741103,18,62,67,65,50,24,8,10,304
62741104,33,69,80,54,35,29,9,7,316
62741105,48,80,95,99,50,35,15,15,437
62741106,60,105,125,154,76,43,20,19,602
62741107,39,40,79,66,42,33,14,11,324
62741108,25,44,77,78,45,28,7,10,314
62741109,50,79,126,115,54,61,16,24,525
62741110,57,73,127,127,77,40,20,18,539
62741111,24,52,58,63,33,17,11,13,271
62741112,39,51,57,61,36,27,11,19,301
62741113,19,46,54,42,47,35,8,23,274
62741114,27,38,59,84,41,23,17,10,299
62741115,36,45,53,69,51,27,13,14,308
62741116,16,45,53,69,46,25,14,10,278
62741117,37,65,84,78,59,40,14,24,401
62741118,32,47,74,65,39,22,7,9,295
62741201,71,95,107,93,56,20,6,7,455
62741202,27,50,52,50,32,17,10,7,245
62741203,44,73,63,69,33,19,6,5,312
62741204,29,55,44,31,14,9,2,2,186
62741205,27,63,39,53,21,8,0,0,211
62741206,31,64,47,35,26,12,6,1,222
62741207,25,40,47,61,32,20,4,3,232
62741208,48,85,99,94,67,31,14,9,447
62741209,46,87,70,84,50,33,9,24,403
62741210,48,49,76,79,44,21,8,6,331
62741211,38,77,65,67,48,39,13,18,365
62741212,28,64,85,88,52,43,18,20,398
62741213,23,44,39,51,32,26,6,11,232
62741214,27,44,51,55,37,16,6,7,243
62741215,21,57,70,81,57,33,12,18,349
62741216,18,43,82,93,52,28,11,4,331
62741217,41,68,70,67,55,22,11,8,342
62741301,62,71,82,89,43,27,11,8,393
62741302,28,44,49,46,15,8,5,4,199
62741303,40,54,55,48,25,7,5,6,240
62741304,31,49,64,66,20,8,7,5,250
62741305,30,35,61,50,39,18,5,8,246
62741306,19,38,60,52,49,31,20,42,311
62741307,33,61,67,53,28,21,4,9,276
62741308,23,51,47,71,24,17,3,6,242
62741309,43,42,55,63,35,16,7,26,287
62741310,31,51,51,57,27,17,4,4,242
62741311,45,52,63,60,28,18,6,1,273
62741312,61,90,75,81,44,22,11,3,387
62741313,29,49,41,31,13,10,4,0,177
62741314,35,50,44,35,21,4,2,0,191
62741315,73,74,36,34,12,7,1,2,239
62741316,53,60,58,58,19,17,2,4,271
62741317,61,100,86,108,50,23,6,6,440
62741401,78,85,93,77,46,27,5,5,416
62741402,83,110,66,63,23,11,4,2,362
62741403,61,69,38,32,16,3,1,0,220
62741404,61,86,73,45,22,7,4,0,298
62741405,86,103,66,73,32,12,3,1,376
62741406,62,56,32,33,19,2,1,0,205
62741407,57,78,52,38,10,3,3,0,241
62741408,61,86,68,59,26,9,2,2,313
62741409,62,111,80,77,28,8,2,2,370
62741410,56,85,73,48,23,5,3,0,293
62741411,66,96,81,79,26,13,1,1,363
62741501,27,53,73,73,32,38,18,22,336
62741502,37,51,70,68,42,32,15,13,328
62741503,27,37,50,63,45,27,7,6,262
62741504,55,78,95,86,64,38,14,10,440
62741505,37,51,45,48,20,21,1,7,230
62741506,30,52,59,44,28,11,10,2,236
62741507,34,50,80,67,32,23,8,10,304
62741508,31,60,55,53,37,34,7,10,287
62741509,31,56,50,65,26,20,5,13,266
62741510,50,69,99,93,58,24,10,25,428
62741511,24,45,59,50,29,25,6,7,245
62741512,25,39,56,47,38,22,10,11,248
62741513,43,59,54,67,31,24,10,17,305
62741514,33,54,56,51,35,18,10,9,266
62741515,37,56,61,45,21,15,11,8,254
62741516,44,71,77,63,44,23,9,12,343
62741517,28,50,90,78,50,35,8,27,366
62741518,61,102,90,75,52,24,8,16,428
62741601,38,42,58,90,70,41,18,16,373
62741602,32,54,69,86,53,43,26,33,396
62741603,49,41,72,79,53,33,21,26,374
62741604,37,63,92,95,70,46,23,43,469
62741605,44,48,59,62,29,14,8,5,269
62741606,38,71,72,75,40,25,5,9,335
62741607,29,38,61,64,41,21,11,9,274
62741608,33,49,51,77,43,24,9,4,290
62741609,22,52,43,48,37,22,7,7,238
62741610,43,59,66,62,45,32,9,15,331
62741611,25,39,44,54,34,21,10,6,233
62741612,24,68,61,58,42,36,6,3,298
62741613,44,67,80,76,58,35,8,16,384
62741614,38,41,61,82,29,31,8,9,299
62741701,47,54,41,42,22,11,5,6,228
62741702,30,58,54,41,36,15,1,9,244
62741703,41,64,53,68,38,19,7,9,299
62741704,36,57,67,60,52,30,7,11,320
62741705,33,53,66,64,37,22,9,10,294
62741706,36,52,72,65,44,17,16,20,322
62741707,30,57,53,49,27,21,4,4,245
62741708,22,59,65,54,22,5,4,4,235
62741709,42,59,84,68,39,21,5,11,329
62741710,33,63,60,79,42,30,12,12,331
62741711,32,47,50,44,32,16,7,10,238
62741712,28,49,53,57,31,22,8,10,258
62741713,36,78,76,83,50,14,12,4,353
62741714,42,98,84,88,51,19,6,6,394
62741801,48,72,103,98,74,44,12,19,470
62741802,34,44,48,58,40,38,10,16,288
62741803,27,45,70,58,31,30,11,8,280
62741804,17,33,50,44,48,18,21,12,243
62741805,19,26,51,50,40,32,16,18,252
62741806,29,47,59,80,73,54,28,38,408
62741807,31,51,65,84,64,35,25,35,390
62741808,15,25,38,38,41,27,23,29,236
62741809,20,34,68,59,53,32,18,22,306
62741810,28,33,69,64,45,44,20,22,325
62741811,34,57,90,82,60,51,19,18,411
62741812,23,29,48,38,29,15,7,13,202
62741813,25,42,69,67,36,29,15,20,303
62741814,24,34,49,45,30,31,14,16,243
62741815,21,38,60,56,27,22,2,4,230
62741816,46,51,96,76,58,38,17,23,405
62741817,33,80,60,81,54,39,16,10,373
62741818,28,68,91,91,83,48,18,20,447
62741901,41,47,82,53,41,28,14,11,317
62741902,46,60,99,78,60,38,16,17,414
62741903,31,40,61,59,40,30,11,28,300
62741904,52,78,80,84,64,41,18,13,430
62741905,49,55,97,95,82,57,23,31,489
62741906,49,65,77,94,56,36,17,19,413
62741907,28,58,88,79,58,50,22,34,417
62741908,25,21,40,50,31,21,9,20,217
62741909,36,21,40,35,42,18,15,16,223
62741910,53,75,81,99,57,59,13,24,461
62741911,41,70,82,100,71,54,16,29,463
62741912,41,41,82,86,66,41,19,20,396
62741913,30,43,47,66,46,33,5,12,282
62742001,28,49,65,91,75,60,18,31,417
62742002,28,66,76,87,62,36,16,25,396
62742003,47,45,67,84,50,22,20,11,346
62742004,52,99,115,128,89,71,28,36,618
62742005,41,95,109,93,69,44,25,18,494
62742006,47,67,84,85,58,30,14,26,411
62742007,32,42,109,101,63,60,26,53,486
62742008,40,56,60,60,49,39,7,12,323
62742009,44,47,72,75,34,28,13,7,320
62742010,27,47,66,58,51,22,8,18,297
62742011,37,59,72,72,43,24,9,16,332
62742012,27,51,86,58,56,33,9,23,343
62742013,34,48,64,93,60,45,14,26,384
62742014,7,9,9,18,8,6,1,5,63
62742015,2,2,1,1,1,1,0,2,10
62742016,17,34,55,57,42,32,19,24,280
62742101,30,44,61,37,23,13,3,2,213
62742102,40,40,48,57,34,9,2,2,232
62742103,53,72,88,92,55,35,10,17,422
62742104,45,52,81,81,48,29,12,15,363
62742105,22,40,58,80,56,72,23,24,375
62742106,8,27,48,87,78,78,34,52,412
62742107,16,25,54,89,73,70,38,45,410
62742108,7,27,54,88,78,67,33,47,401
62742109,26,28,52,54,47,23,14,19,263
62742110,25,43,69,63,35,17,4,9,265
62742111,25,42,62,54,42,16,3,16,260
62742112,29,42,50,32,37,29,5,10,234
62742113,41,62,70,85,63,28,16,15,380
62742114,35,67,60,62,45,20,8,17,314
62742115,49,74,97,95,47,43,12,15,432
62742116,28,49,42,45,37,26,12,10,249
62742117,37,59,88,85,60,29,18,18,394
62742118,33,58,78,70,58,29,9,20,355
62742119,43,42,65,73,52,25,11,16,327
62742120,32,33,61,49,33,14,5,7,234
62742121,23,42,49,50,35,14,8,4,225
62742122,23,37,58,55,37,25,14,12,261
62742123,29,52,69,60,43,31,11,11,306
62742201,27,48,52,47,37,18,13,11,253
62742202,26,47,53,52,26,32,15,15,266
62742203,65,72,82,78,63,44,24,19,447
62742204,23,45,54,48,36,24,18,9,257
62742205,28,37,65,46,36,19,18,10,259
62742206,35,40,53,70,44,37,20,16,315
62742207,7,15,4,8,8,2,2,1,47
62742208,9,16,20,23,11,6,4,4,93
62742209,20,24,24,36,22,10,4,8,148
62742210,54,62,51,68,52,39,8,11,345
62742211,37,61,79,88,71,37,15,14,402
62742212,38,44,49,38,24,26,14,11,244
63710101,48,50,58,71,56,34,14,12,343
63710102,49,56,60,59,29,18,9,8,288
63710103,41,79,77,72,58,43,16,19,405
63710104,30,49,46,48,33,15,3,10,234
63710105,32,23,35,35,28,16,11,9,189
63710106,17,22,31,36,21,19,6,10,162
63710107,16,6,24,16,18,12,2,8,102
63710108,11,11,19,21,21,19,3,6,111
63710109,24,53,59,58,56,42,16,15,323
63710110,45,69,122,94,66,52,16,19,483
63710111,5,3,1,7,0,4,1,0,21
63710201,58,76,87,85,50,24,13,10,403
63710202,54,81,91,81,37,23,7,19,393
63710203,104,109,89,63,29,12,12,8,426
63710204,44,68,91,68,49,39,12,16,387
63710205,54,72,111,136,83,40,12,16,524
63710206,39,84,84,63,36,13,7,7,333
63710207,36,73,44,55,27,16,3,2,256
63710208,44,82,67,45,26,17,4,4,289
63710209,71,112,80,72,36,18,6,3,398
63710210,68,92,107,78,42,23,5,1,416
63710211,31,49,76,55,32,13,2,3,261
63710212,46,79,45,55,23,15,4,1,268
63710301,61,119,122,53,30,15,12,6,418
63710302,36,71,63,48,23,15,5,4,265
63710303,30,39,45,34,17,8,2,1,176
63710304,97,107,126,85,60,19,4,3,501
63710305,66,89,90,76,33,4,1,2,361
63710306,62,89,69,70,35,17,4,3,349
63710307,68,74,85,51,34,12,9,3,336
63710308,63,95,83,76,45,23,10,5,400
63710309,32,22,68,80,36,32,10,12,292
63710310,30,38,55,55,28,20,5,7,238
63710311,39,74,98,67,32,26,7,6,349
63710312,12,14,30,26,15,11,4,3,115
63710313,19,41,62,37,25,13,4,3,204
63710314,43,64,56,32,22,8,3,2,230
63710315,72,98,83,49,41,10,4,3,360
63710401,79,151,97,87,40,16,5,3,478
63710402,72,105,97,67,26,11,4,4,386
63710403,42,51,48,70,20,13,1,4,249
63710404,43,52,40,37,27,7,4,1,211
63710405,62,90,89,71,24,12,4,4,356
63710406,81,109,92,81,35,21,3,6,428
63710407,79,109,77,78,25,14,0,2,384
63710408,58,46,48,35,16,5,1,0,209
63710501,77,84,72,59,23,9,5,2,331
63710502,80,99,68,57,37,14,3,2,360
63710503,38,48,57,25,11,5,1,1,186
63710504,53,59,56,48,16,10,2,1,245
63710505,43,87,53,52,19,4,3,2,263
63710506,62,100,85,82,31,14,2,3,379
63710507,47,69,63,47,24,10,2,3,265
63710508,25,53,47,31,16,7,5,10,194
63710509,75,108,65,83,33,20,5,5,394
63710510,59,108,75,66,37,21,5,11,382
63710601,40,61,48,46,20,15,3,0,233
63710602,44,70,58,53,20,8,3,4,260
63710603,53,71,60,52,31,24,7,4,302
63710604,37,64,60,40,22,8,2,2,235
63710605,40,63,45,53,24,17,4,4,250
63710606,53,81,64,44,34,19,1,5,301
63710607,57,65,64,54,36,25,1,1,303
63710608,36,48,46,62,24,20,6,4,246
63710609,36,51,77,86,44,35,20,23,372
63710610,65,77,88,78,68,24,19,15,434
63710611,54,81,88,76,53,44,16,22,434
63710612,98,74,51,47,25,12,7,10,324
63710701,37,82,44,57,30,22,2,9,283
63710702,53,74,90,96,68,45,17,18,461
63710703,42,54,63,64,50,39,15,8,335
63710704,48,46,65,86,54,33,15,13,360
63710705,28,48,55,72,44,17,12,11,287
63710706,55,90,79,75,52,44,11,20,426
63710707,81,113,119,99,54,38,15,15,534
63710708,43,54,39,47,15,17,7,4,226
63710709,89,101,78,74,37,12,8,3,402
63710710,45,57,41,49,23,6,1,0,222
63710711,48,53,40,39,28,11,5,4,228
63710712,58,86,65,51,34,11,6,6,317
63710713,47,71,71,46,30,9,1,1,276
63710801,65,94,93,96,46,20,11,15,440
63710802,68,88,65,81,37,23,7,2,371
63710803,54,98,63,61,29,11,1,2,319
63710804,50,78,74,66,32,9,3,5,317
63710805,55,86,75,49,27,9,0,2,303
63710806,54,102,92,85,35,26,9,3,406
63710807,50,88,52,52,23,8,3,0,276
63710808,57,112,80,53,38,14,1,4,359
63710809,65,109,70,67,30,10,12,2,365
63710810,68,81,87,63,29,8,3,1,340
63710811,59,104,65,61,23,8,3,3,326
63710812,55,112,76,58,31,16,4,2,354
63710901,63,107,81,78,36,17,6,3,391
63710902,72,117,90,70,29,13,1,6,398
63710903,38,61,66,48,30,9,1,5,258
63710904,28,54,66,38,20,11,1,1,219
63710905,64,79,72,57,25,12,6,2,317
63710906,98,133,116,99,39,14,2,3,504
63710907,35,78,71,65,30,20,6,3,308
63710908,50,113,85,75,27,10,8,3,371
63710909,84,91,81,55,44,26,3,5,389
63710910,72,111,76,69,32,12,6,0,378
63710911,51,52,37,23,20,5,2,0,190
63710912,48,69,50,26,19,12,3,6,233
63710913,41,60,51,44,24,11,3,4,238
63710914,63,74,93,69,27,11,5,3,345
63710915,47,48,41,34,16,7,4,4,201
63710916,48,56,49,42,21,4,2,1,223
63710917,53,90,75,62,27,10,6,9,332
63711001,52,94,60,69,19,4,1,3,302
63711002,67,116,79,66,37,14,2,1,382
63711003,62,95,100,53,31,7,3,1,352
63711004,50,71,50,32,10,7,0,0,220
63711005,34,62,55,46,24,4,1,2,228
63711006,59,86,78,73,43,15,4,3,361
63711007,82,160,78,81,35,15,2,0,453
63711008,59,102,56,58,18,3,3,2,301
63711009,66,87,69,46,29,8,1,3,309
63711010,69,112,74,71,19,10,2,0,357
63711011,56,82,62,56,25,8,0,4,293
63711012,13,24,26,18,14,10,0,3,108
63711013,63,103,97,56,57,24,5,11,416
63711014,60,90,63,52,30,7,2,0,304
63711015,64,110,58,71,29,7,0,0,339
63711016,23,59,47,43,12,7,1,1,193
63711101,62,90,45,54,16,5,0,2,274
63711102,81,73,39,31,9,3,1,0,237
63711103,100,102,71,29,8,5,0,0,315
63711104,122,118,55,29,10,2,1,0,337
63711105,103,100,48,21,7,1,0,0,280
63711106,78,68,48,26,4,4,1,2,231
63711107,62,116,72,78,19,7,2,0,356
63711108,90,75,35,29,12,2,0,2,245
63711109,35,56,41,30,18,1,0,0,181
63711110,77,105,93,72,31,17,4,3,402
63711201,77,112,73,78,29,12,2,1,384
63711202,63,70,82,48,25,6,1,1,296
63711203,54,68,44,43,8,4,1,1,223
63711204,63,118,77,69,29,18,2,2,378
63711205,68,76,39,30,9,2,2,1,227
63711206,42,61,37,39,12,5,0,0,196
63711207,74,109,58,53,18,6,2,2,322
63711208,76,130,96,88,23,12,3,4,432
63711209,69,92,51,39,18,2,1,1,273
63711210,102,98,57,26,8,6,0,0,297
63711301,61,100,51,64,38,17,4,2,337
63711302,45,86,72,60,39,10,5,2,319
63711303,74,105,85,90,37,11,7,2,411
63711304,61,102,69,83,20,12,1,1,349
63711305,60,73,67,73,34,12,0,2,321
63711306,61,90,88,68,34,20,4,5,370
63711307,70,112,89,64,27,25,2,4,393
63711308,66,99,70,55,28,9,1,1,329
63711309,84,108,84,93,33,17,5,5,429
63711310,59,119,79,85,32,13,5,4,396
63711311,66,93,76,45,33,15,1,0,329
63711312,72,98,65,84,35,15,1,3,373
63711401,67,112,81,66,39,26,5,7,403
63711402,55,74,64,47,26,17,3,2,288
63711403,28,46,41,42,20,12,2,1,192
63711404,31,36,42,46,39,31,10,13,248
63711405,26,31,43,37,30,21,7,7,202
63711406,43,55,80,90,49,39,9,20,385
63711407,18,23,40,27,28,27,14,20,197
63711408,36,30,45,45,37,26,16,19,254
63711409,33,28,46,62,28,24,15,10,246
63711410,38,38,52,62,28,19,5,10,252
63711411,39,63,65,57,30,14,3,7,278
63711412,49,79,48,55,31,13,1,5,281
63711413,52,81,61,44,16,11,0,3,268
63711414,25,50,57,59,41,38,10,20,300
63711501,5,6,17,16,9,8,3,6,70
63711502,21,33,42,47,43,27,5,18,236
63711503,38,60,80,63,62,36,23,20,382
63711504,20,25,15,30,15,30,5,5,145
63711505,71,92,130,173,82,66,14,26,654
63711506,82,62,120,107,35,20,20,14,460
63711507,33,18,38,47,28,15,15,9,203
63711508,17,3,40,46,44,23,3,6,182
63711509,38,34,39,42,20,14,7,4,198
63711510,21,20,27,25,10,12,6,3,124
63711511,49,66,95,75,47,37,9,3,381
63711512,37,52,62,59,40,20,9,12,291
63711513,40,38,44,50,40,24,9,6,251
63711514,48,45,64,56,26,29,12,9,289
63711601,14,30,28,40,39,23,14,24,212
63711602,13,32,34,33,34,20,4,15,185
63711603,18,16,35,41,31,11,5,17,174
63711604,42,50,61,63,48,39,13,20,336
63711605,21,16,21,17,12,18,3,3,111
63711606,23,42,44,42,12,14,6,7,190
63711607,39,69,61,57,11,11,2,0,250
63711608,59,77,79,63,32,19,8,4,341
63711609,70,92,96,76,22,6,8,4,374
63711610,45,51,56,55,25,17,6,6,261
63711611,36,55,58,68,37,18,5,8,285
63711612,38,31,36,16,3,4,0,0,128
63711613,52,87,70,80,22,21,5,8,345
63711614,37,59,44,64,35,17,5,4,265
63711701,63,96,87,60,29,15,10,2,362
63711702,56,94,83,56,23,12,3,4,331
63711703,54,95,72,59,26,12,4,1,323
63711704,53,80,78,60,37,8,3,2,321
63711705,60,90,54,56,19,7,2,0,288
63711706,73,97,61,67,22,11,1,1,333
63711707,49,99,60,66,21,9,0,1,305
63711708,57,84,73,58,18,11,2,1,304
63711709,57,86,58,63,31,7,5,2,309
63711710,54,104,89,87,50,15,9,4,412
63711711,43,102,88,73,28,10,0,2,346
63711712,39,65,60,58,24,10,1,1,258
63711713,60,92,81,78,28,15,9,5,368
63711714,64,82,82,67,26,16,1,5,343
63711801,58,132,82,92,27,4,2,2,399
63711802,59,77,49,31,22,5,1,0,244
63711803,101,138,61,55,19,5,2,1,382
63711804,79,111,73,71,20,10,4,2,370
63711805,53,102,78,64,23,18,2,0,340
63711806,64,105,70,77,33,17,3,1,370
63711807,64,95,80,74,35,11,5,8,372
63711808,40,70,53,58,32,15,4,3,275
63711809,46,76,75,48,25,6,2,1,279
63711810,48,59,44,46,21,13,3,2,236
63711811,80,121,97,77,44,12,2,1,434
63711812,34,62,47,44,22,10,2,6,227
63711813,71,94,99,72,58,26,2,12,434
63711814,76,102,104,102,53,10,7,6,460
63711815,69,111,99,86,47,22,15,2,451
63711901,61,69,37,25,11,4,2,1,210
63711902,111,118,57,27,7,3,0,0,323
63711903,84,91,58,48,22,4,1,1,309
63711904,61,98,48,64,27,9,0,1,308
63711905,57,100,73,63,28,7,1,1,330
63711906,36,53,53,50,22,17,5,6,242
63711907,56,123,78,85,20,5,1,2,370
63711908,60,114,66,68,21,8,2,0,339
63711909,93,121,74,76,19,8,1,2,394
63712001,76,114,73,71,24,7,3,4,372
63712002,73,79,90,73,29,18,4,7,373
63712003,57,79,68,55,24,11,7,1,302
63712004,101,87,95,60,39,14,4,4,404
63712005,61,73,69,50,17,11,3,2,286
63712006,70,102,96,74,27,3,1,2,375
63712007,56,125,86,86,29,13,7,3,405
63712008,39,65,49,39,22,8,3,0,225
63712101,58,83,60,69,26,13,2,1,312
63712102,68,97,68,83,35,17,0,0,368
63712103,86,66,52,33,11,2,0,1,251
63712104,43,38,45,36,10,3,0,1,176
63712105,65,120,93,90,34,12,6,1,421
63712106,15,26,30,30,10,5,2,1,119
63712107,41,59,55,78,22,11,7,1,274
63712108,55,88,98,94,22,12,3,3,375
63712109,84,109,73,47,17,4,1,1,336
63712110,65,88,62,61,31,14,1,2,324
63712111,91,129,83,70,23,5,3,0,404
63712112,16,57,45,52,14,15,1,0,200
63712113,60,91,57,44,22,15,1,2,292
63712114,60,76,59,60,25,8,1,3,292
63712115,56,104,64,80,28,11,0,0,343
63712201,68,86,69,62,19,6,1,3,314
63712202,67,65,36,48,34,5,3,1,259
63712203,42,70,69,43,29,18,4,1,276
63712204,84,106,64,57,10,7,0,0,328
63712205,35,70,51,33,17,5,0,0,211
63712206,61,63,25,26,7,7,0,1,190
63712207,73,88,83,48,21,13,4,5,335
63712208,72,64,49,32,9,3,0,1,230
63712209,56,65,44,17,6,0,0,0,188
63712210,51,62,43,22,9,2,0,0,189
63712211,56,42,14,15,6,1,0,0,134
63712212,70,72,29,24,10,2,1,0,208
63712213,52,60,44,41,10,5,0,1,213
63712214,75,84,40,27,8,7,0,0,241
63712301,85,89,66,37,12,5,3,0,297
63712302,71,99,83,102,38,13,6,2,414
63712303,53,46,20,17,11,3,0,0,150
63712304,53,74,41,33,14,1,2,2,220
63712305,86,83,40,22,7,0,0,1,239
63712306,62,80,41,51,15,10,0,1,260
63712307,73,73,68,39,12,4,1,4,274
63712308,52,83,60,61,22,11,3,4,296
63712309,93,100,40,32,5,0,0,1,271
63712310,69,64,34,21,10,2,0,0,200
63712311,58,49,69,43,20,6,4,4,253
63712312,56,50,62,34,19,6,3,3,233
63712313,61,63,54,34,26,7,2,2,249
63712314,66,78,72,58,24,12,2,2,314
63712315,74,119,93,85,37,13,10,2,433
63712316,75,132,81,78,31,17,5,7,426
63712317,52,96,45,50,12,17,3,3,278
63712401,75,96,74,63,32,20,6,5,371
63712402,41,49,53,46,23,9,3,3,227
63712403,87,111,90,62,36,16,4,5,411
63712404,31,54,42,33,8,2,2,4,176
63712405,44,45,43,40,15,13,3,2,205
63712406,50,66,42,34,15,10,1,4,222
63712407,41,79,46,41,23,5,0,0,235
63712408,45,65,41,44,11,6,3,2,217
63712501,51,77,45,55,29,9,4,1,271
63712502,69,86,52,56,22,8,3,0,296
63712503,49,57,41,29,15,9,0,0,200
63712504,57,85,60,44,26,16,4,5,297
63712505,61,86,80,60,35,8,4,6,340
63712506,43,83,68,57,28,12,2,6,299
63712507,60,97,63,65,29,12,0,1,327
63712508,53,86,57,63,15,14,2,2,292
63712601,66,104,83,79,30,6,1,2,371
63712602,40,73,55,37,17,11,1,2,236
63712603,66,90,68,52,28,12,4,2,322
63712604,67,84,71,67,33,6,4,2,334
63712605,46,57,46,48,18,7,1,0,223
63712606,56,84,61,69,25,16,4,6,321
63712607,52,84,42,38,17,12,3,4,252
63712608,46,68,51,42,24,10,3,4,248
63712701,53,62,57,41,19,12,1,0,245
63712702,66,88,75,48,30,23,3,6,339
63712703,76,119,107,105,55,37,11,14,524
63712704,71,107,80,65,30,20,3,3,379
63712705,68,76,55,59,26,15,4,3,306
63712706,28,49,45,32,16,7,0,2,179
63712707,34,58,46,39,11,8,1,0,197
63712708,38,53,51,38,26,7,1,1,215
63712801,19,34,40,26,22,13,4,14,172
63712802,12,15,7,6,3,4,0,0,47
63712803,7,11,4,5,3,1,1,0,32
63712804,19,26,30,11,9,4,1,4,104
63712805,15,13,19,10,6,3,1,0,67
63712806,36,64,47,61,42,17,4,13,284
63712807,17,18,21,10,5,10,0,2,83
63712808,48,96,86,48,28,12,1,2,321
63712901,71,94,70,50,16,5,0,1,307
63712902,55,69,39,30,10,2,0,0,205
63712903,52,48,44,34,15,8,1,2,204
63712904,64,95,76,54,22,9,3,3,326
63712905,75,89,99,85,32,21,0,3,404
63712906,32,42,46,30,15,10,2,1,178
63712907,89,136,100,100,40,22,7,7,501
63712908,135,172,143,107,48,30,10,9,654
63712909,83,94,82,68,22,4,2,0,355
63713001,54,80,66,48,25,13,6,0,292
63713002,69,96,76,77,43,18,7,8,394
63713003,46,98,72,75,21,25,3,8,348
63713004,43,74,45,49,17,11,7,5,251
63713005,73,80,50,50,29,8,1,6,297
63713006,48,75,64,61,35,9,2,3,297
63713007,44,64,50,39,17,5,2,1,222
63713008,63,68,59,37,19,7,2,1,256
63713009,24,61,45,39,30,18,8,9,234
63713010,16,20,28,19,21,17,4,7,132
63713011,70,80,67,50,26,10,7,0,310
63713101,58,83,75,56,32,20,6,1,331
63713102,38,58,52,40,13,13,4,0,218
63713103,65,105,85,68,42,24,8,1,398
63713104,25,65,32,31,10,7,1,0,171
63713105,46,92,65,55,25,14,3,1,301
63713106,73,147,78,99,39,10,6,1,453
63713107,56,70,58,63,23,14,4,0,288
63713108,58,68,67,76,23,10,2,0,304
63713201,1,8,18,23,8,6,2,0,66
63713202,79,82,89,109,47,15,12,9,442
63713203,37,82,107,87,43,11,10,9,386
63713204,39,72,84,81,35,24,12,11,358
63713205,40,64,66,60,40,27,11,13,321
63713206,168,90,42,51,30,16,5,1,403
63713207,57,59,71,49,22,22,4,7,291
63713208,65,103,97,94,54,25,6,12,456
63713209,39,66,61,46,15,9,2,2,240
63713210,76,90,82,101,54,24,5,8,440
63713211,49,91,88,100,45,32,3,4,412
63713212,68,69,69,89,35,24,6,10,370
63713213,56,96,79,64,30,30,10,7,372
63713214,72,94,90,92,61,32,4,18,463
63713215,51,71,62,45,28,17,8,8,290
63713301,37,52,52,41,41,20,16,8,267
63713302,48,69,76,79,68,38,19,23,420
63713303,57,90,88,99,46,20,8,7,415
63713304,50,75,65,51,33,24,4,5,307
63713305,72,116,87,82,40,18,4,5,424
63713306,59,103,86,85,50,20,7,5,415
63713307,44,72,71,61,41,17,8,3,317
63713308,40,72,52,50,22,12,7,2,257
63713309,62,85,74,76,24,19,1,8,349
63713310,64,53,33,30,8,9,2,0,199
63713401,42,54,61,56,26,8,1,3,251
63713402,70,95,82,86,27,24,3,5,392
63713403,31,45,35,36,6,5,0,2,160
63713404,46,66,46,50,20,7,3,4,242
63713405,65,97,92,82,54,48,11,11,460
63713406,46,60,57,77,29,11,1,3,284
63713407,50,84,67,75,22,23,4,5,330
63713408,64,112,68,55,25,13,6,6,349
63713409,37,76,61,44,21,7,0,1,247
63713501,49,93,78,77,48,18,6,4,373
63713502,28,55,53,43,25,10,3,4,221
63713503,38,56,63,46,24,17,3,8,255
63713504,37,46,57,47,28,10,3,7,235
63713505,23,65,56,51,26,14,6,3,244
63713506,45,108,78,77,35,20,4,3,370
63713507,1,4,12,4,3,5,3,3,35
63713508,3,7,15,10,5,8,2,4,54
63713509,1,6,9,8,8,3,2,3,40
63713510,43,57,60,64,29,20,6,11,290
63713511,35,67,99,87,65,32,16,17,418
63713512,25,37,73,62,41,36,11,7,292
63713513,56,60,77,67,37,14,10,7,328
63713514,31,53,46,49,24,19,1,4,227
63713601,47,94,136,127,81,66,22,30,603
63713602,41,63,88,68,44,28,4,9,345
63713603,23,57,79,93,75,43,13,19,402
63713604,69,129,122,115,64,44,5,10,558
63713605,31,72,61,61,34,30,4,3,296
63713606,35,59,61,61,37,25,12,9,299
63713607,45,67,96,95,48,28,10,12,401
63713608,51,85,87,74,34,11,3,2,347
63713609,69,123,99,105,54,25,10,11,496
63713610,60,92,74,74,26,20,4,3,353
63713611,72,108,101,89,30,9,4,2,415
63713701,60,45,61,56,37,27,8,8,302
63713702,48,52,67,77,48,44,17,10,363
63713703,22,25,30,53,33,22,6,7,198
63713704,19,25,38,17,24,13,3,4,143
63713705,18,26,36,39,25,22,9,7,182
63713706,18,38,47,42,19,17,8,18,207
63713707,39,92,111,86,66,34,10,12,450
63713708,69,108,146,158,77,46,22,15,641
63713709,61,97,105,109,78,30,8,13,501
63713710,41,91,90,92,66,44,10,14,448
63713711,29,54,71,94,56,48,27,31,410
63713712,51,68,78,64,46,35,9,20,371
63713713,49,92,92,97,59,32,10,16,447
63713714,51,79,65,89,39,32,10,12,377
63713715,58,89,84,92,45,23,13,7,411
63713716,53,118,110,91,61,25,10,12,480
64080101,74,95,86,57,37,13,6,5,373
64080102,55,86,60,54,21,8,4,0,288
64080103,64,87,74,65,27,19,11,4,351
64080104,82,118,72,69,37,15,0,1,394
64080105,52,68,81,80,34,44,3,5,367
64080106,41,62,41,49,16,7,0,1,217
64080107,70,106,87,73,36,16,9,2,399
64080108,62,90,89,93,53,21,10,7,425
64080109,60,103,97,90,58,19,8,7,442
64080110,33,58,54,60,22,10,2,0,239
64080111,112,138,128,106,53,31,8,8,584
64080112,56,115,82,90,40,19,7,7,416
64080113,61,87,86,106,39,17,11,4,411
64080114,5,8,4,8,4,2,2,1,34
64080115,20,27,27,21,9,1,1,1,107
64080116,25,61,36,47,17,7,0,2,195
64080117,64,72,60,72,28,7,2,0,305
64080201,50,58,65,62,36,29,10,8,318
64080202,59,92,85,67,27,24,14,5,373
64080203,59,107,83,77,32,19,3,9,389
64080204,53,100,74,85,46,5,8,17,388
64080205,50,61,56,44,20,7,3,2,243
64080206,73,95,62,79,14,6,1,1,331
64080207,98,104,90,85,34,13,6,7,437
64080208,85,98,91,93,63,37,8,13,488
64080209,66,126,130,98,52,26,7,5,510
64080210,51,115,104,88,55,21,7,6,447
64080211,55,72,79,76,30,15,0,5,332
64080301,11,20,27,12,12,13,5,5,105
64080302,11,20,30,20,8,5,4,2,100
64080303,45,73,76,82,49,29,16,11,381
64080304,48,65,71,53,42,15,5,8,307
64080305,45,69,70,59,27,13,3,8,294
64080306,53,59,73,62,45,31,5,7,335
64080307,63,100,103,106,66,42,11,14,505
64080308,71,125,133,107,87,52,18,28,621
64080309,48,79,77,71,31,14,4,3,327
64080310,31,48,41,48,25,17,3,8,221
64080401,41,57,95,85,52,36,13,16,395
64080402,64,104,150,130,81,47,20,30,626
64080403,24,40,64,60,38,24,5,9,264
64080404,45,96,107,121,78,26,18,17,508
64080405,38,76,81,77,43,26,8,11,360
64080406,34,48,64,69,34,20,8,7,284
64080407,40,72,88,69,54,33,14,18,388
64080408,52,123,107,127,82,39,16,17,563
64080409,61,72,104,93,42,31,8,6,417
64080410,93,132,116,127,70,26,8,10,582
64080411,41,70,64,65,46,19,6,11,322
64080412,39,64,92,87,44,20,7,6,359
64080501,33,47,53,63,35,19,4,8,262
64080502,25,61,67,69,47,23,9,11,312
64080503,45,77,85,67,42,22,5,13,356
64080504,50,50,66,60,42,20,8,17,313
64080505,11,31,28,26,20,12,4,3,135
64080506,41,36,48,49,35,20,6,5,240
64080507,28,47,66,72,29,15,7,6,270
64080508,34,49,70,66,30,19,6,7,281
64080509,40,58,58,73,41,17,6,11,304
64080510,35,65,55,46,25,17,7,3,253
64080511,41,68,53,64,35,6,1,3,271
64080512,45,53,49,46,21,14,7,6,241
64080601,83,123,80,82,41,11,7,2,429
64080602,28,45,31,42,19,11,1,0,177
64080603,56,116,69,65,34,8,2,2,352
64080604,38,89,51,55,29,12,0,0,274
64080605,66,100,83,79,28,11,4,1,372
64080606,13,31,21,21,12,4,1,0,103
64080607,52,100,64,80,28,16,3,1,344
64080608,36,89,63,58,26,5,5,2,284
64080609,61,108,85,59,27,10,0,1,351
64080701,54,88,62,77,41,6,4,1,333
64080702,41,44,62,57,28,15,6,14,267
64080703,33,47,57,63,31,18,5,9,263
64080704,72,123,93,76,32,14,10,4,424
64080705,56,98,81,73,27,13,2,1,351
64080706,68,87,69,66,24,6,2,1,323
64080707,12,34,16,18,11,3,0,0,94
64080708,53,112,66,74,23,2,4,3,337
64080709,40,43,56,44,19,9,7,0,218
64080710,33,54,72,55,26,11,7,2,260
64080801,44,63,71,68,46,18,11,7,328
64080802,44,69,62,59,37,31,9,13,324
64080803,28,42,50,45,21,15,1,4,206
64080804,30,56,48,46,16,4,4,1,205
64080805,56,47,48,50,24,8,5,3,241
64080806,44,74,68,63,33,17,3,8,310
64080807,28,63,74,57,26,13,2,4,267
64080808,79,91,68,63,24,8,0,3,336
64080809,49,50,58,52,31,8,4,1,253
64080810,54,88,72,60,38,12,7,4,335
64080811,43,78,82,71,53,13,6,8,354
64080812,20,46,40,47,15,18,11,5,202
64080813,40,41,60,45,33,17,8,11,255
64080814,68,92,93,94,53,31,11,10,452
64080901,77,94,96,74,30,17,3,1,392
64080902,42,43,42,48,30,13,3,4,225
64080903,43,70,66,49,29,16,7,2,282
64080904,42,74,69,51,18,4,0,3,261
64080905,57,104,93,53,26,16,0,2,351
64080906,77,88,88,69,27,11,1,2,363
64080907,56,97,106,93,42,20,9,11,434
64080908,50,92,92,73,47,10,9,1,374
64081001,40,95,74,63,36,9,4,4,325
64081002,39,73,73,62,29,18,4,5,303
64081003,75,97,87,93,49,23,4,8,436
64081004,55,101,77,82,31,15,2,5,368
64081005,66,99,107,92,50,19,5,4,442
64081006,39,71,71,66,38,13,6,5,309
64081007,57,113,78,81,55,21,3,7,415
64081008,39,63,46,57,25,10,1,3,244
64081101,31,51,56,71,39,15,8,3,274
64081102,40,69,79,74,42,19,3,5,331
64081103,75,93,72,63,30,7,2,0,342
64081104,45,90,74,65,29,23,7,4,337
64081105,69,78,101,122,70,27,7,8,482
64081106,42,71,65,87,37,6,7,6,321
64081107,11,19,21,22,7,2,0,1,83
64081108,30,53,81,68,50,23,16,13,334
64081109,7,8,18,20,7,5,4,4,73
64081110,22,31,37,40,24,15,6,9,184
64081111,7,14,21,15,13,1,1,2,74
64081201,28,44,102,152,182,139,11,17,675
64081202,13,29,58,72,33,28,8,9,250
64081203,43,70,65,65,39,21,11,12,326
64081204,40,54,68,84,45,43,6,12,352
64081205,63,97,111,98,64,32,9,14,488
64081206,85,111,142,123,86,36,15,25,623
64081207,42,72,91,77,54,18,6,10,370
64081208,66,95,108,97,61,22,14,11,474
64081209,29,75,78,65,26,16,2,6,297
64081301,77,97,89,101,50,24,4,10,452
64081302,36,56,52,59,41,22,9,19,294
64081303,42,55,74,54,42,28,16,9,320
64081304,42,55,60,63,38,16,4,11,289
64081305,44,54,61,60,29,10,2,4,264
64081306,46,91,82,81,42,22,7,14,385
64081307,53,89,69,72,36,21,4,15,359
64081308,30,74,68,64,41,21,4,12,314
64081309,25,39,61,66,38,28,9,13,279
64081310,36,76,79,72,56,38,9,9,375
64081311,38,76,77,81,52,25,3,11,363
64081312,37,85,76,71,47,22,2,4,344
64081313,26,51,46,46,23,22,4,8,226
64081401,79,108,89,67,34,18,6,5,406
64081402,84,82,87,83,28,24,7,4,399
64081403,64,90,90,73,48,24,6,8,403
64081404,63,120,98,73,48,29,9,5,445
64081405,34,46,44,35,9,15,3,4,190
64081406,39,56,48,53,32,14,2,2,246
64081407,37,64,61,50,23,10,1,2,248
64081408,31,52,64,39,30,11,3,5,235
64081409,50,63,43,48,35,12,2,9,262
64081410,42,65,58,50,32,17,5,4,273
64081411,42,66,65,58,45,18,1,5,300
64081412,50,82,65,66,29,8,9,3,312
64081413,52,94,67,58,35,15,1,6,328
64081501,73,100,89,66,52,18,5,2,405
64081502,67,93,83,97,58,36,3,5,442
64081503,5,13,9,8,11,5,0,0,51
64081504,45,58,76,68,44,32,13,6,342
64081505,107,111,109,84,49,13,9,10,492
64081506,30,28,26,13,4,3,0,2,106
64081507,36,49,59,88,22,13,4,3,274
64081508,28,61,44,50,34,13,5,0,235
64081509,62,97,65,70,38,11,6,3,352
64081510,34,59,44,44,23,5,3,0,212
64081511,58,76,44,52,25,9,2,4,270
64081512,26,36,36,17,17,3,2,3,140
64081513,64,89,84,65,27,12,3,3,347
64100101,65,70,81,68,62,31,5,15,397
64100102,41,58,83,100,40,36,11,12,381
64100103,41,76,86,90,39,22,15,15,384
64100104,53,104,94,101,45,26,10,14,447
64100105,32,58,50,57,36,17,3,5,258
64100106,25,54,51,64,29,6,1,1,231
64100107,24,45,51,60,29,16,1,1,227
64100108,52,80,84,115,54,25,8,3,421
64100109,24,65,60,61,28,17,2,8,265
64100110,20,55,84,95,45,23,7,10,339
64100111,103,156,185,169,99,59,24,22,817
64100112,45,73,82,77,40,18,7,7,349
64100113,19,46,40,55,16,5,1,1,183
64100201,44,60,65,71,27,15,4,3,289
64100202,36,66,67,71,37,15,3,2,297
64100203,19,52,58,59,26,7,5,0,226
64100204,10,15,11,14,6,2,1,2,61
64100205,41,79,96,91,43,25,9,13,397
64100206,12,14,21,13,19,5,2,2,88
64100207,35,55,49,51,33,13,3,3,242
64100208,59,92,93,99,57,25,7,6,438
64100209,48,79,84,80,33,14,4,2,344
64100210,38,78,63,64,23,17,4,0,287
64100301,64,79,58,93,54,24,6,7,385
64100302,52,73,83,63,48,19,2,7,347
64100303,35,56,48,66,28,12,4,2,251
64100304,41,70,67,77,44,24,13,6,342
64100305,48,61,81,93,42,24,9,7,365
64100306,43,54,86,56,27,19,3,9,297
64100307,37,42,60,62,40,17,7,11,276
64100308,36,68,68,52,29,19,8,7,287
64100309,71,89,107,94,51,34,8,11,465
64100310,34,55,63,62,43,25,10,9,301
64100311,26,49,50,64,24,17,11,3,244
64100312,17,35,29,49,19,4,0,2,155
64100401,42,86,80,90,43,18,11,11,381
64100402,36,75,69,80,43,24,4,5,336
64100403,66,93,89,85,44,18,7,5,407
64100404,32,66,54,57,23,14,4,4,254
64100405,25,52,67,51,24,8,4,2,233
64100406,43,82,98,84,37,14,3,3,364
64100407,36,46,59,62,31,11,2,4,251
64100408,46,59,78,52,30,15,8,3,291
64100409,59,91,102,92,66,35,11,20,476
64100410,41,57,48,39,29,16,6,10,246
64100411,39,46,42,55,28,16,4,3,233
64100412,45,64,78,78,53,28,10,13,369
64100413,44,51,62,49,38,26,6,10,286
64100414,45,76,76,79,48,27,14,10,375
64100415,11,20,20,21,2,4,4,5,87
64100416,35,38,35,40,27,5,0,1,181
64100501,36,61,48,55,20,17,6,8,251
64100502,38,55,68,63,35,25,6,7,297
64100503,62,88,94,76,49,21,11,11,412
64100504,24,61,47,58,33,20,4,2,249
64100505,33,49,63,56,45,24,10,9,289
64100506,20,41,53,50,26,21,1,7,219
64100507,28,33,42,41,28,15,7,6,200
64100508,38,89,72,73,41,28,4,13,358
64100509,75,93,88,64,33,16,9,7,385
64100510,46,71,84,82,36,29,13,11,372
64100511,40,52,50,62,32,27,4,15,282
64100512,25,62,71,74,34,38,5,10,319
64100513,52,100,74,81,46,29,8,4,394
64100514,34,56,56,47,38,28,11,11,281
64100515,34,52,99,105,90,51,23,33,487
64100601,44,59,67,78,43,48,5,12,356
64100602,28,62,60,82,46,26,13,14,331
64100603,45,101,86,94,30,14,6,4,380
64100604,54,102,86,68,28,18,1,1,358
64100605,48,85,70,69,31,16,1,3,323
64100606,38,89,73,67,29,8,1,1,306
64100607,43,77,77,68,35,21,3,3,327
64100608,69,110,111,86,40,19,3,2,440
64100609,53,85,59,52,23,3,6,5,286
64100610,38,63,57,64,29,17,6,3,277
64100611,32,49,54,38,30,15,1,4,223
64100612,73,95,85,74,53,35,15,8,438
64100613,71,103,96,97,47,17,7,2,440
64100614,67,109,94,72,31,13,3,2,391
64100615,65,96,65,63,28,11,0,6,334
64100701,33,62,48,52,20,6,0,1,222
64100702,40,52,41,34,19,5,1,3,195
64100703,54,92,75,50,32,7,3,0,313
64100704,85,109,87,94,41,15,6,3,440
64100705,72,83,83,76,35,18,11,1,379
64100706,60,93,61,47,21,9,3,1,295
64100707,68,106,102,90,59,27,6,6,464
64100708,50,59,71,54,32,18,14,5,303
64100709,37,84,77,57,30,12,4,4,305
64100710,83,91,100,76,42,13,8,4,417
64100711,46,65,64,63,46,9,6,2,301
64100712,42,58,66,63,32,11,3,7,282
64100713,52,94,96,89,35,17,5,6,394
64100714,46,62,54,61,45,20,7,11,306
64100715,31,56,49,50,19,29,6,12,252
64100716,64,101,105,88,56,25,11,7,457
64100801,39,57,56,43,17,13,0,2,227
64100802,35,49,64,61,30,10,2,1,252
64100803,55,103,106,72,43,19,1,3,402
64100804,40,57,57,57,30,13,0,5,259
64100805,39,57,68,63,37,18,3,4,289
64100806,53,86,94,101,47,27,7,5,420
64100807,60,89,101,70,51,13,0,3,387
64100808,52,75,72,71,32,11,3,0,316
64100809,82,99,98,100,47,24,8,6,464
64100901,56,104,89,93,37,14,2,3,398
64100902,47,74,65,56,19,9,0,1,271
64100903,66,114,105,83,48,17,4,3,440
64100904,56,103,66,100,31,16,2,2,376
64100905,69,99,92,101,40,10,6,0,417
64100906,44,86,77,60,33,9,3,2,314
64100907,66,75,74,51,26,10,1,3,306
64100908,43,93,65,46,26,7,1,1,282
64100909,38,88,78,55,16,6,1,2,284
64101001,57,119,106,83,34,13,4,4,420
64101002,71,105,99,97,41,11,4,2,430
64101003,54,88,85,68,41,16,3,2,357
64101004,68,122,76,97,32,15,1,1,412
64101005,57,86,64,71,24,10,3,2,317
64101006,52,89,65,60,28,10,1,5,310
64101007,76,104,97,105,55,21,3,5,466
64101008,41,83,64,68,33,12,4,3,308
64101009,43,110,74,65,37,11,6,4,350
64101010,54,91,98,75,24,7,4,3,356
64101101,65,116,79,62,27,7,3,1,360
64101102,60,120,74,56,34,6,1,1,352
64101103,47,87,66,66,23,3,1,1,294
64101104,38,88,79,58,15,10,1,2,291
64101105,48,57,38,32,17,5,2,1,200
64101106,41,64,48,38,15,3,0,0,209
64101107,51,84,63,53,30,15,1,0,297
64101108,42,78,79,72,19,6,1,2,299
64101109,72,130,81,66,32,6,3,3,393
64101110,64,88,79,79,22,10,6,0,348
64101111,68,88,68,61,34,7,1,1,328
64101201,65,101,66,66,22,8,2,1,331
64101202,72,111,78,61,29,8,1,0,360
64101203,40,61,50,42,12,3,2,2,212
64101204,50,56,52,52,19,12,0,1,242
64101205,38,56,50,55,28,9,4,5,245
64101206,67,69,60,55,19,9,3,4,286
64101207,55,89,48,46,19,8,6,0,271
64101208,32,45,40,37,17,5,2,0,178
64101209,23,59,60,50,20,7,3,2,224
64101210,36,49,55,51,22,10,1,2,226
64101211,60,77,53,54,20,19,4,6,293
64101212,48,60,67,70,31,15,4,5,300
64101213,68,113,119,100,33,28,7,4,472
64101301,58,105,101,78,32,14,8,8,404
64101302,38,67,64,43,32,9,2,1,256
64101303,33,61,58,47,21,7,3,2,232
64101304,29,46,67,48,24,5,2,2,223
64101305,42,66,60,47,16,13,9,3,256
64101306,74,106,101,90,54,16,6,9,456
64101307,78,110,112,100,51,27,10,7,495
64101308,33,62,61,63,32,12,5,5,273
64101309,39,58,71,53,31,12,5,2,271
64101310,28,77,58,45,21,14,1,6,250
64101311,43,63,68,60,37,22,7,4,304
64120101,28,50,44,42,23,11,6,8,212
64120102,25,40,31,47,24,9,1,0,177
64120103,10,13,6,11,15,6,2,0,63
64120104,18,23,36,40,23,14,3,7,164
64120105,12,23,13,18,16,9,2,6,99
64120106,32,65,65,68,37,20,4,8,299
64120107,14,23,22,26,8,4,4,2,103
64120108,17,26,33,22,18,9,4,5,134
64120109,28,72,63,77,48,22,9,10,329
64120110,37,78,101,94,49,28,9,10,406
64120111,17,38,42,45,33,17,3,11,206
64120112,36,40,48,70,60,26,15,22,317
64120113,28,38,54,60,50,36,15,19,300
64120114,41,47,74,57,53,39,5,16,332
64120115,34,61,71,63,40,29,6,9,313
64120116,56,78,82,97,67,41,19,26,466
64120117,37,48,92,87,58,55,19,37,433
64120118,32,61,96,74,71,52,26,33,445
64120201,21,26,29,32,15,8,3,2,136
64120202,39,62,79,71,46,19,9,10,335
64120203,39,76,65,83,36,22,10,13,344
64120204,49,58,84,85,55,36,14,20,401
64120205,51,85,100,76,50,34,15,10,421
64120206,26,59,53,59,29,25,15,6,272
64120207,25,60,69,79,41,37,13,7,331
64120208,62,76,85,79,47,24,5,7,385
64120209,45,97,86,81,56,36,8,7,416
64120210,46,85,72,68,38,19,1,5,334
64120211,41,63,66,67,36,19,5,2,299
64120301,38,66,74,97,50,33,15,7,380
64120302,51,79,100,91,65,38,8,16,448
64120303,66,88,97,95,60,19,10,6,441
64120304,60,71,84,90,58,26,5,11,405
64120305,51,103,106,84,52,20,6,4,426
64120306,59,102,67,61,27,13,2,1,332
64120307,54,104,96,85,45,17,6,12,419
64120308,47,52,71,72,32,25,3,9,311
64120309,35,68,63,61,35,15,10,4,291
64120310,40,65,88,72,39,23,2,5,334
64120311,70,86,67,69,35,19,2,0,348
64120312,28,47,31,26,11,11,4,1,159
64120313,28,52,46,47,19,12,2,2,208
64120401,50,89,79,95,45,32,9,8,407
64120402,61,76,72,74,59,21,5,9,377
64120403,34,86,87,96,45,26,15,20,409
64120404,61,93,100,104,70,27,10,13,478
64120405,40,51,58,57,33,23,4,8,274
64120406,39,53,66,56,33,19,9,11,286
64120407,55,79,67,73,47,17,7,9,354
64120408,23,44,43,44,32,11,5,3,205
64120409,43,55,50,39,21,17,3,2,230
64120410,46,94,75,67,54,28,10,10,384
64120411,30,95,85,60,47,23,7,17,364
64120412,75,109,119,94,58,29,16,6,506
64120501,36,50,56,50,32,12,2,0,238
64120502,57,96,74,75,35,13,5,1,356
64120503,66,107,70,73,35,18,4,2,375
64120504,34,61,51,52,24,8,8,4,242
64120505,28,61,54,41,18,12,1,0,215
64120506,28,44,53,52,22,9,1,3,212
64120507,51,83,60,84,28,14,12,6,338
64120508,63,74,79,73,46,19,12,5,371
64120509,35,75,77,85,63,31,19,16,401
64120510,42,80,77,89,51,33,14,13,399
64120511,36,50,62,82,42,23,7,11,313
64120512,43,79,74,66,34,21,3,5,325
64120513,53,97,88,84,44,25,4,8,403
64120514,40,72,65,67,29,14,4,6,297
64120601,36,50,35,30,13,4,1,2,171
64120602,48,60,71,56,33,7,5,3,283
64120603,63,72,55,61,24,8,4,5,292
64120604,37,99,55,41,25,4,1,3,265
64120605,58,86,59,50,18,9,2,0,282
64120606,78,106,90,75,38,10,9,4,410
64120607,45,96,73,97,34,27,10,13,395
64120608,65,89,94,81,64,43,9,16,461
64120609,36,48,50,53,36,28,9,13,273
64120610,34,41,66,68,29,18,4,9,269
64120611,63,100,114,97,53,29,12,7,475
64120612,55,100,82,69,39,25,6,6,382
64120613,42,84,74,75,36,24,6,1,342
64120701,29,55,83,87,46,37,9,24,370
64120702,34,64,59,90,56,34,9,26,372
64120703,40,60,100,95,51,42,9,15,412
64120704,40,58,50,60,28,34,13,11,294
64120705,34,67,49,48,33,25,8,10,274
64120706,26,49,42,49,29,28,8,12,243
64120707,19,39,41,57,36,16,10,6,224
64120708,27,63,69,67,30,21,14,3,294
64120709,28,60,56,43,16,9,3,0,215
64120710,45,92,88,93,52,27,8,11,416
64120711,59,84,65,85,49,24,14,16,396
64120712,41,59,78,75,49,30,13,14,359
64120713,40,70,68,84,56,31,10,15,374
64120714,30,57,61,61,60,17,14,5,305
64120715,21,47,52,61,29,30,6,11,257
64120716,32,58,63,56,37,15,13,11,285
64120717,27,65,68,53,37,30,1,9,290
64120801,66,90,101,90,56,43,7,11,464
64120802,56,91,77,77,52,32,5,10,400
64120803,18,55,51,46,25,20,3,2,220
64120804,20,41,48,56,33,14,10,10,232
64120805,47,66,60,56,17,11,4,6,267
64120806,23,56,61,65,45,41,8,17,316
64120807,27,40,51,62,37,30,14,14,275
64120808,19,38,65,60,36,28,5,7,258
64120809,47,69,72,60,52,31,9,7,347
64120810,24,53,51,61,45,48,9,12,303
64120811,38,56,52,49,46,36,4,12,293
64120812,27,44,56,66,51,21,7,12,284
64120813,38,53,65,78,60,34,16,28,372
64120814,37,34,57,62,40,28,20,33,311
64120815,30,49,56,65,43,26,10,12,291
64120901,15,30,47,38,31,35,9,13,218
64120902,21,35,56,49,29,61,4,14,269
64120903,34,49,77,80,57,51,16,13,377
64120904,24,48,69,84,61,35,15,21,357
64120905,28,44,72,74,49,38,20,24,349
64120906,9,26,17,19,10,2,0,3,86
64120907,11,27,24,31,21,11,4,8,137
64120908,21,51,82,86,61,33,7,25,366
64120909,35,46,76,68,51,41,13,24,354
64120910,42,61,75,73,53,43,12,20,379
64120911,20,49,83,64,72,45,19,29,381
64120912,19,31,39,43,40,29,7,18,226
64120913,18,41,43,44,31,38,10,15,240
64120914,38,67,84,78,67,47,23,22,426
64120915,44,50,67,77,50,50,13,21,372
64120916,9,24,46,53,25,17,9,20,203
64120917,29,41,35,48,30,15,14,14,226
64120918,40,48,92,87,64,38,17,21,407
64121001,41,63,81,83,57,50,9,17,401
64121002,39,59,84,85,47,27,13,20,374
64121003,46,53,104,88,62,32,15,18,418
64121004,32,75,90,97,72,50,16,16,448
64121005,25,50,77,88,62,39,14,16,371
64121006,24,61,74,77,45,36,12,16,345
64121007,39,61,72,74,47,29,7,10,339
64121008,27,61,70,88,63,40,10,17,376
64121009,25,43,60,74,48,21,4,5,280
64121010,32,44,56,62,43,36,11,18,302
64121011,40,50,74,63,47,30,10,17,331
64121012,16,37,53,48,37,26,7,12,236
64121013,35,47,44,47,29,31,14,12,259
64121014,35,59,96,82,47,40,14,24,397
64121015,21,45,58,70,51,34,11,16,306
64121016,12,41,64,58,83,33,15,29,335
64121017,45,78,89,127,79,64,18,16,516
64121018,17,49,95,88,60,38,11,14,372
64121019,17,45,91,114,61,39,16,29,412
64121020,27,52,95,89,56,41,14,25,399
64121021,27,36,57,68,70,37,15,20,330
64121101,24,46,55,67,77,48,17,25,359
64121102,42,51,55,67,43,37,14,14,323
64121103,49,96,116,92,61,45,16,21,496
64121104,19,38,42,41,40,25,14,19,238
64121105,39,55,85,86,56,50,9,22,402
64121106,38,44,69,74,40,43,11,18,337
64121107,23,38,53,67,38,23,11,16,269
64121108,28,48,55,51,39,27,13,13,274
64121109,14,37,49,56,34,31,11,23,255
64121110,24,55,51,40,37,25,4,6,242
64121111,25,38,52,66,48,25,8,17,279
64121112,22,40,43,45,33,29,14,10,236
64121113,21,41,55,60,37,21,10,10,255
64121114,29,42,51,61,31,20,6,12,252
64121115,34,72,80,79,43,29,10,15,362
64121116,22,36,57,59,57,34,14,10,289
64121117,16,27,56,41,30,19,8,14,211
64121118,26,39,77,60,56,45,13,16,332
64121119,37,67,74,92,56,45,18,22,411
64121120,52,77,106,93,70,68,16,21,503
64121201,35,43,83,58,50,29,11,13,322
64121202,22,65,78,51,58,40,13,16,343
64121203,33,60,84,84,58,24,22,21,386
64121204,58,77,111,83,57,38,14,20,458
64121205,42,75,77,84,66,56,12,29,441
64121206,21,48,64,82,57,41,15,13,341
64121207,56,66,86,91,56,46,24,23,448
64121208,46,49,98,87,45,37,12,17,391
64121209,36,74,91,86,57,33,16,21,414
64121301,32,56,75,79,43,41,6,16,348
64121302,33,77,74,70,55,39,17,16,381
64121303,26,33,28,46,30,14,9,20,206
64121304,29,56,48,55,43,22,7,7,267
64121305,50,75,91,80,69,66,17,22,470
64121306,62,75,83,78,72,67,8,13,458
64121307,19,43,59,67,39,30,16,26,299
64121308,46,76,83,88,61,38,10,22,424
64121309,46,50,58,61,40,27,3,10,295
64121310,29,48,51,39,32,24,8,6,237
64121311,37,47,77,58,39,28,12,16,314
64121312,44,55,88,103,56,48,8,22,424
64121401,28,54,61,51,31,12,8,5,250
64121402,34,58,85,65,43,22,9,10,326
64121403,42,85,114,110,66,32,18,18,485
64121404,31,45,59,56,42,25,7,15,280
64121405,42,56,76,77,44,18,9,9,331
64121406,41,73,93,100,53,26,16,9,411
64121407,27,70,103,81,42,39,14,19,395
64121408,24,64,87,100,65,32,17,18,407
64121409,42,58,70,69,50,40,6,6,341
64121410,32,64,76,69,54,25,10,15,345
64121411,30,75,75,89,49,41,8,11,378
64121412,29,51,82,70,58,48,22,17,377
64121413,34,53,56,68,41,25,5,17,299
64121501,27,45,50,58,34,21,7,8,250
64121502,63,92,117,91,50,28,15,10,466
64121503,67,103,101,106,67,38,16,7,505
64121504,33,80,70,66,57,45,8,12,371
64121505,22,45,56,55,40,28,3,5,254
64121506,33,58,69,56,33,24,13,13,299
64121507,33,50,64,61,36,25,12,16,297
64121508,23,42,62,54,45,25,9,10,270
64121509,32,58,69,55,33,22,12,10,291
64121510,36,57,66,57,43,19,9,11,298
64121511,44,73,81,80,35,29,17,17,376
64121512,45,67,68,107,91,50,17,17,462
64270101,97,82,20,17,2,1,0,1,220
64270102,101,66,30,9,1,0,0,0,207
64270103,261,183,68,33,11,1,1,0,558
64270104,37,41,18,16,4,1,0,0,117
64270105,79,38,13,5,3,0,0,0,138
64270106,133,162,88,51,13,4,1,1,453
64270107,174,145,63,35,19,8,1,1,446
64270108,78,100,55,32,10,3,1,1,280
64270109,72,91,61,33,4,1,0,0,262
64270110,69,98,63,49,21,6,1,0,307
64270111,103,113,53,42,14,11,0,0,336
64270112,96,87,50,30,9,8,1,0,281
64270113,77,98,60,41,16,11,1,3,307
64270201,51,32,14,108,3,13,0,1,222
64270202,23,42,51,61,7,9,1,0,194
64270203,47,55,20,18,4,0,0,0,144
64270204,151,122,48,23,7,2,0,0,353
64270205,85,76,27,25,7,6,0,0,226
64270206,72,59,21,11,4,7,1,1,176
64270207,94,85,46,19,6,8,1,0,259
64270208,62,82,55,35,9,8,0,0,251
64270209,106,108,54,29,8,1,1,0,307
64270210,91,88,52,29,10,9,0,3,282
64270211,34,26,7,11,5,2,0,1,86
64270212,34,32,27,38,42,22,0,0,195
64270213,86,79,40,16,8,8,0,1,238
64270214,34,59,46,32,11,0,1,1,184
64270215,47,60,35,28,7,3,1,0,181
64270216,63,71,17,19,3,1,1,2,177
64270217,65,83,54,34,5,3,0,2,246
64270218,72,105,56,55,15,5,2,0,310
64270301,74,88,50,21,11,6,1,2,253
64270302,150,123,50,46,16,4,1,0,390
64270303,47,75,50,31,12,3,0,0,218
64270304,57,77,39,41,16,1,1,1,233
64270305,53,81,57,47,10,13,1,0,262
64270306,61,99,88,56,21,11,3,5,344
64270307,53,80,57,43,24,9,2,0,268
64270308,47,79,54,51,15,7,0,4,257
64270309,39,62,42,29,21,11,0,0,204
64270310,148,116,68,34,9,6,0,1,382
64270311,71,67,74,62,23,15,0,2,314
64270312,125,126,79,51,15,9,1,0,406
64270401,53,69,61,61,32,19,1,5,301
64270402,79,88,74,86,41,15,5,0,388
64270403,88,120,89,109,50,13,3,3,475
64270404,64,92,81,39,27,5,1,3,312
64270405,96,76,67,58,39,12,3,5,356
64270406,63,72,66,64,31,14,9,3,322
64270407,57,117,64,56,27,13,7,3,344
64270408,64,100,64,73,27,17,5,5,355
64270409,74,104,90,84,41,21,6,7,427
64270501,68,111,116,126,69,25,1,2,518
64270502,41,63,51,65,39,16,1,0,276
64270503,29,71,53,57,43,15,0,1,269
64270504,40,99,102,89,54,28,2,3,417
64270505,93,101,101,90,39,28,2,5,459
64270506,61,99,73,66,50,35,5,3,392
64270507,66,117,93,82,57,21,6,5,447
64270508,62,63,64,36,22,8,1,1,257
64270509,40,62,63,45,17,8,2,3,240
64270510,70,71,67,49,31,20,0,2,310
64270511,51,75,77,70,26,15,4,2,320
64270601,61,58,66,97,41,20,1,2,346
64270602,74,107,88,148,59,27,2,5,510
64270603,55,64,51,75,39,26,7,2,319
64270604,81,122,111,132,86,39,2,1,574
64270605,41,61,46,34,15,13,0,2,212
64270606,47,77,52,43,24,6,0,0,249
64270607,48,70,51,39,17,10,3,3,241
64270608,33,56,54,46,13,6,0,0,208
64270609,59,116,75,84,33,15,3,1,386
64270610,41,61,45,46,31,12,2,1,239
64270611,45,56,42,46,27,9,2,3,230
64270612,37,61,66,73,19,6,2,1,265
64270613,59,82,78,58,16,9,0,0,302
64270614,52,66,66,58,20,8,5,1,276
64270701,76,94,101,79,34,18,3,3,408
64270702,65,101,91,90,45,17,2,2,413
64270703,49,100,66,62,31,23,3,0,334
64270704,64,97,71,69,36,24,1,0,362
64270705,53,88,67,57,28,52,8,3,356
64270706,51,78,52,51,38,11,1,1,283
64270707,60,47,53,44,20,3,1,1,229
64270708,45,79,79,56,17,9,1,3,289
64270709,58,86,83,66,26,5,0,2,326
64270710,73,104,104,80,66,67,7,8,509
64270711,51,67,84,72,42,21,1,2,340
64270712,48,82,94,93,51,39,2,0,409
64270713,37,58,50,64,54,26,1,6,296
64270801,51,90,80,75,37,52,6,2,393
64270802,61,107,86,82,36,46,1,2,421
64270803,65,81,80,69,26,40,1,2,364
64270804,51,98,97,92,33,63,6,2,442
64270805,44,74,88,49,31,55,2,6,349
64270806,89,115,78,86,38,77,0,4,487
64270807,56,104,82,61,31,50,5,3,392
64270808,33,47,36,34,20,37,2,0,209
64270809,50,54,37,32,10,26,5,4,218
64270810,51,113,79,77,34,95,4,3,456
64270811,66,91,92,70,24,61,3,2,409
64270812,76,107,93,84,44,51,2,7,464
64270901,49,95,92,59,119,18,2,3,437
64270902,57,89,65,59,84,32,3,1,390
64270903,70,109,92,76,148,37,9,9,550
64270904,75,102,114,112,147,25,4,6,585
64270905,50,93,88,67,107,28,4,8,445
64270906,67,87,93,70,150,36,12,10,525
64270907,55,78,80,73,38,39,9,7,379
64270908,51,78,73,72,35,17,6,7,339
64270909,21,34,31,38,24,24,5,3,180
64270910,37,45,48,66,42,46,7,11,302
64270911,42,66,84,66,45,27,6,7,343
64270912,33,37,43,57,57,30,10,15,282
64271001,94,101,78,88,77,28,5,2,473
64271002,30,55,47,60,45,13,3,2,255
64271003,42,59,44,53,43,14,1,2,258
64271004,65,88,68,83,86,23,6,2,421
64271005,53,89,76,85,62,26,2,7,400
64271006,48,81,73,64,53,33,1,1,354
64271007,67,94,83,73,62,26,7,2,414
64271008,63,83,81,70,47,36,5,5,390
64271009,81,97,90,77,77,36,10,8,476
64271010,36,58,46,44,29,14,2,1,230
64271011,37,52,38,40,17,14,0,1,199
64271012,59,103,94,73,34,40,6,1,410
64271101,89,104,94,79,47,17,7,2,439
64271102,67,84,92,65,35,22,2,10,377
64271103,89,90,104,96,32,48,5,8,472
64271104,64,102,72,72,38,14,2,2,366
64271105,59,90,82,67,26,13,2,7,346
64271106,73,118,80,90,29,22,6,5,423
64271107,63,95,80,57,29,28,5,2,359
64271108,48,98,88,95,44,30,6,4,413
64271109,51,98,85,82,43,24,7,3,393
64271110,47,70,54,46,27,20,5,6,275
64271111,46,73,47,51,25,21,1,3,267
64271201,67,101,107,122,38,25,2,2,464
64271202,59,116,85,127,34,12,3,2,438
64271203,18,46,34,56,13,7,0,0,174
64271204,30,52,49,50,21,10,1,3,216
64271205,47,73,76,100,45,23,6,1,371
64271206,81,108,86,97,44,13,5,2,436
64271207,39,50,58,58,27,14,0,0,246
64271208,34,61,35,59,20,4,1,3,217
64271209,38,55,46,61,21,9,5,5,240
64271210,35,47,57,57,31,4,4,0,235
64271301,50,114,84,118,38,17,3,5,429
64271302,73,83,82,115,57,35,2,4,451
64271303,47,98,76,67,20,20,2,2,332
64271304,35,67,126,134,53,90,5,0,510
64271305,61,102,91,112,75,75,5,4,525
64271306,27,54,48,39,22,55,0,1,246
64271307,68,52,55,78,9,18,1,1,282
64271308,41,58,45,56,29,48,2,3,282
64271309,36,47,49,48,53,49,1,3,286
64271310,67,91,57,79,55,45,3,4,401
64271311,60,118,87,100,52,15,2,3,437
64271401,52,72,49,101,43,25,6,7,355
64271402,29,70,51,64,57,35,2,10,318
64271403,19,44,48,105,51,40,1,10,318
64271404,19,34,42,53,97,54,6,7,312
64271405,25,57,49,76,99,80,2,11,399
64271406,19,30,30,26,23,12,0,6,146
64271407,62,78,50,114,136,90,0,0,530
64271408,59,118,121,211,184,132,21,24,870
64271409,40,85,99,81,52,25,2,9,393
64271410,128,145,155,152,103,98,19,18,818
64271411,95,188,182,184,101,74,12,22,858
64271412,20,25,47,52,27,28,7,13,219
64271413,93,179,203,197,81,31,10,3,797
64271414,25,40,42,35,25,11,1,0,179
64271415,44,73,75,61,21,23,2,2,301
64271416,45,103,84,73,44,51,1,0,401
64271417,38,47,47,57,38,28,3,0,258
64271418,48,63,48,51,26,17,3,1,257
64271419,38,69,68,94,21,26,4,3,323
64271420,29,50,59,64,29,6,0,2,239
64271501,42,74,50,49,39,27,1,2,284
64271502,48,50,48,46,26,25,5,5,253
64271503,54,79,67,47,17,3,2,0,269
64271504,77,112,88,93,32,13,4,0,419
64271505,34,60,58,47,31,21,1,2,254
64271506,37,69,80,53,28,20,6,5,298
64271507,39,73,52,41,28,15,3,6,257
64271508,44,66,51,51,34,16,3,4,269
64271509,51,55,57,45,31,13,1,5,258
64271510,43,71,63,42,29,21,2,0,271
64271511,43,62,53,50,22,9,2,5,246
64271512,72,96,83,86,43,20,5,8,413
64271513,41,51,61,47,27,10,4,1,242
64271514,45,59,68,66,34,25,9,18,324
64271515,54,79,69,64,30,16,4,4,320
64271601,80,102,90,78,46,26,5,2,429
64271602,100,126,119,93,25,6,3,3,475
64271603,44,94,99,91,42,26,6,4,406
64271604,36,64,70,71,46,35,6,8,336
64271605,112,117,134,135,68,53,7,14,640
64271606,35,60,72,94,47,42,8,14,372
64271607,49,74,85,71,56,34,12,7,388
64271608,34,42,52,46,39,24,8,9,254
64271609,46,86,68,88,41,29,10,18,386
64271610,38,52,51,46,25,13,4,7,236
64271611,110,115,71,61,30,20,3,1,411
64271612,90,114,91,51,21,16,4,1,388
64271613,26,34,21,31,17,13,3,1,146
64271701,64,100,73,67,27,47,2,2,382
64271702,69,101,74,54,17,8,2,2,327
64271703,61,91,108,77,41,25,12,8,423
64271704,29,49,48,45,28,28,5,14,246
64271705,49,48,48,45,30,17,8,14,259
64271706,10,14,38,53,26,51,6,16,214
64271707,101,177,257,262,206,247,29,91,1370
64271708,51,83,100,88,69,78,10,37,516
64271709,28,59,42,50,30,40,8,18,275
64271710,64,77,97,88,82,91,14,36,549
64271711,79,109,192,198,139,192,26,81,1016
64271801,49,71,76,101,43,64,4,41,449
64271802,63,63,70,62,36,121,17,43,475
64271803,14,24,32,36,37,87,8,34,272
64271804,62,65,101,117,78,144,20,54,641
64271805,109,152,166,172,128,249,19,85,1080
64271806,0,2,6,8,2,21,0,4,43
64271807,63,64,90,109,61,100,18,57,562
64271808,40,73,66,112,83,93,10,53,530
64271809,60,103,107,122,74,157,10,59,692
64271810,40,66,73,70,61,84,13,35,442
64271811,30,74,81,92,64,78,7,21,447
64271812,2,4,8,15,5,17,0,16,67
64271813,106,164,196,200,138,233,32,97,1166
64271901,38,56,43,53,30,10,4,1,235
64271902,32,52,41,33,36,13,3,2,212
64271903,74,102,89,117,67,24,3,0,476
64271904,24,56,55,68,34,26,1,4,268
64271905,32,49,54,54,36,11,0,2,238
64271906,51,57,87,85,41,29,7,13,370
64271907,56,90,89,78,45,15,1,4,378
64271908,59,118,87,86,45,19,6,2,422
64271909,45,95,90,65,48,40,10,6,399
64271910,56,81,70,66,33,19,6,4,335
64272001,26,34,32,44,36,28,17,25,242
64272002,36,48,50,51,36,17,5,8,251
64272003,47,58,45,67,32,11,5,9,274
64272004,36,63,43,43,17,23,2,2,229
64272005,38,46,37,37,16,7,1,2,184
64272006,50,75,82,63,29,19,7,5,330
64272007,52,99,62,42,18,6,1,0,280
64272008,69,107,65,46,20,2,0,0,309
64272009,74,106,74,57,25,10,2,2,350
64272010,41,66,56,63,39,13,10,10,298
64272011,90,97,87,111,41,29,1,3,459
64272012,13,15,24,33,21,6,0,2,114
64272013,29,45,40,40,21,23,1,1,200
64272014,66,82,113,160,103,124,12,24,684
64272015,31,50,50,69,49,77,2,2,330
64272016,71,89,130,130,94,115,8,16,653
64272101,58,99,79,75,55,70,1,0,437
64272102,51,101,86,87,44,61,8,11,449
64272103,74,121,82,83,38,92,2,6,498
64272104,80,105,90,79,44,80,4,1,483
64272105,44,82,70,39,32,38,6,4,315
64272106,62,71,85,73,30,25,11,9,366
64272107,44,82,89,52,31,12,3,7,320
64272108,56,103,90,70,46,21,4,9,399
64272201,38,73,49,60,26,24,5,4,279
64272202,36,63,48,53,26,7,4,4,241
64272203,70,104,89,85,45,35,4,6,438
64272204,56,98,84,77,48,24,10,8,405
64272205,72,100,74,56,31,21,5,3,362
64272206,41,55,61,59,39,32,7,14,308
64272207,72,121,97,79,37,27,8,1,442
64272208,51,89,53,70,25,7,8,6,309
64272209,66,91,83,91,39,15,3,4,392
64272301,31,39,39,22,10,6,0,3,150
64272302,65,90,65,76,40,13,5,4,358
64272303,80,166,153,112,57,28,8,5,609
64272304,92,135,141,102,48,24,8,8,558
64272305,81,115,89,75,42,8,3,3,416
64272306,72,107,78,79,38,29,12,3,418
64272307,75,95,78,77,46,28,4,3,406
64272308,72,94,113,96,46,38,4,4,467
64272309,96,147,130,100,67,43,9,10,602
64272310,107,123,105,110,52,27,9,7,540
64272311,103,144,142,102,58,24,4,12,589
64272401,74,100,79,79,48,14,8,6,408
64272402,5,20,7,37,74,41,0,4,188
64272403,12,14,26,25,24,288,3,19,411
64272404,13,22,54,48,25,66,4,10,242
64272405,32,41,63,77,61,180,2,17,473
64272406,60,75,78,69,45,23,5,7,362
64272407,65,116,118,118,69,33,10,13,542
64272408,59,118,90,80,34,11,2,3,397
64272409,74,75,89,69,35,22,9,5,378
64272410,24,45,53,46,33,37,4,8,250
64272501,45,55,57,50,17,7,2,3,236
64272502,45,83,51,63,23,18,2,0,285
64272503,69,96,87,86,36,11,3,3,391
64272504,39,82,77,58,39,14,3,4,316
64272505,18,42,87,145,115,98,1,5,511
64272506,43,68,73,72,27,17,1,2,303
64272507,47,67,40,36,13,10,1,0,214
64272508,17,35,40,38,15,7,1,0,153
64272509,70,114,83,62,38,13,6,1,387
64272510,66,124,182,215,166,169,13,29,964
64272511,70,145,144,154,101,105,21,33,773
64272512,89,154,157,154,107,128,24,36,849
64272513,27,56,37,38,19,6,0,1,184
64272514,34,50,35,31,17,7,2,4,180
64272515,62,63,87,45,28,17,8,3,313
64272601,62,71,42,39,15,7,3,3,242
64272602,34,55,68,90,42,21,0,0,310
64272603,66,87,91,124,49,15,4,0,436
64272604,54,94,77,113,54,24,2,1,419
64272605,46,82,70,72,29,31,1,1,332
64272606,35,64,52,53,24,9,1,2,240
64272607,75,124,124,108,48,21,4,7,511
64272608,83,111,93,79,31,7,3,2,409
64272609,57,109,74,68,37,28,2,6,381
64272610,66,104,85,65,28,12,0,1,361
64272611,85,110,92,78,38,19,1,3,426
64272701,85,171,116,126,48,27,9,0,582
64272702,26,51,47,45,20,5,1,0,195
64272703,42,73,63,46,28,10,0,2,264
64272704,47,82,50,51,21,11,3,2,267
64272705,46,74,59,56,19,17,1,2,274
64272706,68,125,84,54,25,13,3,2,374
64272707,70,111,95,94,28,14,0,0,412
64272708,57,120,89,81,21,15,4,6,393
64272709,66,124,111,91,38,19,5,5,459
64272801,76,112,78,74,30,14,1,0,385
64272802,44,82,62,46,15,9,0,1,259
64272803,51,76,54,51,24,15,1,2,274
64272804,41,72,68,67,22,9,0,1,280
64272805,57,64,51,44,26,18,1,1,262
64272806,44,107,93,82,33,21,3,2,385
64272807,66,129,87,74,26,10,2,1,395
64272808,44,91,66,68,29,6,1,0,305
64272809,28,70,54,63,21,8,0,2,246
64272810,70,129,95,95,30,11,2,0,432
64272811,56,109,82,57,26,17,0,1,348
64272812,69,126,89,71,35,5,0,1,396
64272901,81,113,76,61,22,36,4,3,396
64272902,64,102,77,72,19,31,0,1,366
64272903,50,64,42,47,9,15,1,4,232
64272904,47,63,49,54,11,17,2,1,244
64272905,97,104,62,76,18,9,2,0,368
64272906,42,96,78,84,19,5,1,1,326
64272907,70,119,79,101,36,22,5,2,434
64272908,61,129,88,82,29,20,2,9,420
64272909,38,63,32,37,15,10,0,0,195
64272910,48,62,43,41,11,9,1,0,215
64272911,59,96,82,97,39,30,2,7,412
64272912,54,140,81,106,28,17,2,4,432
64272913,17,89,45,78,31,25,5,2,292
64272914,57,96,85,66,36,39,1,2,382
64273001,126,96,46,25,13,15,1,0,322
64273002,102,139,78,56,30,16,1,1,423
64273003,87,87,49,28,10,17,2,1,281
64273004,151,121,42,11,10,6,0,0,341
64273005,60,56,29,24,5,7,0,0,181
64273006,128,87,37,34,18,28,0,7,339
64273007,123,103,54,34,19,17,1,3,354
64273008,67,69,21,16,9,7,0,0,189
64273009,83,65,19,19,5,7,2,2,202
64273010,104,99,51,25,15,11,1,0,306
64273011,61,64,23,11,9,1,0,1,170
64273012,69,73,44,25,15,15,0,0,241
64273013,68,78,59,50,36,22,2,3,318
64273101,111,94,43,29,8,10,0,0,295
64273102,75,89,63,44,18,19,0,1,309
64273103,37,84,73,85,33,17,2,1,332
64273104,60,87,73,57,23,15,1,0,316
64273105,72,129,95,85,23,20,3,2,429
64273106,76,139,83,64,26,4,0,1,393
64273107,50,92,57,48,24,6,3,3,283
64273108,32,52,41,34,8,5,0,0,172
64273109,51,67,67,54,20,5,1,1,266
64273110,52,102,66,48,12,7,0,0,287
64273201,51,75,46,49,22,8,1,0,252
64273202,44,79,62,52,19,14,1,0,271
64273203,58,86,44,41,17,15,0,1,262
64273204,52,63,42,59,16,14,0,3,249
64273205,82,96,80,66,36,22,3,4,389
64273206,57,99,59,41,20,9,1,1,287
64273207,58,104,80,78,23,18,3,2,366
64273208,73,108,90,86,47,19,6,1,430
64273209,49,49,49,38,25,5,1,0,216
64273210,48,54,52,43,12,8,2,3,222
64273211,46,73,70,53,14,5,3,1,265
64273212,36,53,42,52,17,12,0,2,214
64273301,44,72,41,60,16,7,1,1,242
64273302,84,123,91,72,23,12,3,3,411
64273303,46,56,24,52,15,13,3,6,215
64273304,42,46,30,15,10,3,0,4,150
64273305,47,58,42,38,10,8,2,6,211
64273306,47,57,29,28,11,5,1,4,182
64273307,57,64,22,37,17,7,1,7,212
64273308,42,85,68,57,22,11,1,2,288
64273309,43,68,65,56,19,7,3,1,262
64273310,45,89,66,69,29,12,4,2,316
64273311,38,101,80,60,38,7,3,0,327
64273312,64,136,126,106,51,15,8,2,508
64273313,31,92,69,63,31,10,3,1,300
64273314,61,94,93,77,34,19,5,8,391
64273315,35,105,61,64,25,4,1,1,296
64273401,49,93,83,88,27,5,4,2,351
64273402,26,66,71,71,16,14,2,2,268
64273403,63,148,123,104,45,19,3,0,505
64273404,57,78,86,83,17,7,2,1,331
64273405,50,83,89,82,24,10,2,3,343
64273406,66,118,138,138,59,30,14,6,569
64273407,38,86,100,89,31,10,2,1,357
64273408,61,101,74,57,29,11,2,1,336
64273409,65,125,94,81,37,13,2,3,420
64273410,36,47,56,61,23,9,2,3,237
64273411,66,52,63,43,19,10,2,0,255
64273412,97,120,100,91,38,21,4,10,481
64273413,53,65,96,60,22,12,2,1,311
64273414,40,74,86,65,29,8,6,0,308
64273415,66,136,94,84,40,10,2,1,433
64273501,76,101,84,78,40,12,3,7,401
64273502,55,69,60,33,16,3,1,1,238
64273503,52,49,53,34,18,7,1,0,214
64273504,56,61,40,44,25,14,2,3,245
64273505,56,85,73,55,32,12,6,7,326
64273506,56,118,89,75,45,17,4,4,408
64273507,62,99,49,39,19,7,1,2,278
64273508,47,90,64,68,38,21,5,10,343
64273509,77,145,79,99,38,32,5,2,477
64273510,38,70,56,61,12,8,1,4,250
64273511,69,109,92,89,29,20,5,4,417
64273512,66,106,97,67,38,20,3,2,399
64273513,37,81,71,51,26,8,2,3,279
64273601,38,65,59,39,13,20,1,2,237
64273602,67,80,70,48,36,27,1,5,334
64273603,56,91,56,47,21,12,0,0,283
64273604,58,38,42,30,22,19,3,0,212
64273605,53,76,41,43,19,11,3,1,247
64273606,23,33,40,37,27,36,1,6,203
64273607,29,49,32,38,10,5,1,1,165
64273608,20,14,7,7,6,21,2,15,92
64273609,74,128,78,60,28,8,3,1,380
64273610,57,95,63,52,24,16,2,0,309
64273611,80,114,73,51,25,7,2,3,355
64273612,27,51,38,40,11,12,0,0,179
64273701,33,52,37,40,17,3,2,4,188
64273702,35,39,50,41,29,11,3,3,211
64273703,32,47,42,50,24,16,0,1,212
64273704,91,109,103,83,36,29,4,6,461
64273705,47,68,68,51,32,21,0,2,289
64273706,105,163,144,102,58,18,3,5,598
64273707,51,93,84,76,51,41,8,10,414
64273708,70,93,80,64,39,15,5,9,375
64273709,72,91,99,102,51,23,8,10,456
64273710,59,103,122,148,72,65,6,4,579
64273801,32,52,64,97,63,44,2,9,363
64273802,34,53,61,95,68,60,3,4,378
64273803,60,99,90,108,102,95,7,17,578
64273804,24,33,42,47,44,25,10,10,235
64273805,33,55,55,67,50,33,6,6,305
64273806,43,50,62,61,55,24,1,8,304
64273807,71,102,77,83,40,35,5,9,422
64273808,81,106,102,72,37,35,3,3,439
64273809,43,40,39,42,13,10,0,1,188
64273810,78,86,87,68,47,32,4,8,410
64273901,53,93,83,87,130,33,2,4,485
64273902,25,52,83,67,53,31,3,13,327
64273903,22,48,63,62,36,22,3,1,257
64273904,38,88,85,88,61,28,8,8,404
64273905,33,78,78,87,66,35,9,11,397
64273906,34,62,62,63,43,17,6,6,293
64273907,37,56,61,70,45,22,4,5,300
64273908,2,2,6,6,5,0,1,0,22
64273909,54,105,89,82,50,27,8,7,422
64273910,46,57,59,72,54,19,8,7,322
64273911,34,65,70,85,57,27,2,3,343
64274001,38,54,57,67,52,51,7,16,342
64274002,55,73,90,103,55,54,6,22,458
64274003,40,32,49,56,29,28,13,15,262
64274004,47,74,98,79,65,59,11,13,446
64274005,57,60,65,75,41,53,7,18,376
64274006,44,79,71,58,46,57,7,16,378
64274007,41,90,102,120,93,229,15,51,741
64274008,51,105,72,119,56,153,14,26,596
64274009,25,48,52,37,21,19,6,7,215
64274010,64,98,104,108,68,73,14,23,552
64274011,45,90,92,78,71,48,10,27,461
64274012,24,50,42,55,36,24,0,6,237
64274101,74,106,94,138,68,116,3,4,603
64274102,54,102,121,169,87,116,3,7,659
64274103,61,101,126,136,68,105,3,4,604
64274104,57,99,107,69,46,38,5,3,424
64274105,47,106,71,85,40,24,7,6,386
64274106,20,40,60,93,66,49,12,34,374
64274107,80,99,161,160,155,189,43,37,924
64274108,68,107,99,142,105,109,20,17,667
64274109,64,99,107,131,89,64,17,33,604
64274110,23,42,75,78,40,43,5,17,323
64274201,53,79,91,79,54,67,2,1,426
64274202,45,96,74,108,84,53,6,10,476
64274203,55,97,120,139,95,79,9,10,604
64274204,57,102,115,133,83,78,9,7,584
64274205,49,56,63,84,53,80,6,3,394
64274206,53,69,66,55,44,28,2,3,320
64274207,63,62,61,51,33,19,3,4,296
64274208,42,63,65,50,25,10,5,1,261
64274209,83,111,118,96,60,27,10,13,518
64274210,42,55,51,54,29,13,5,4,253
64274211,40,58,57,81,34,15,5,7,297
64274301,58,93,106,100,47,21,3,2,430
64274302,77,101,108,77,42,25,4,6,440
64274303,51,102,105,96,57,21,5,7,444
64274304,56,101,86,87,35,11,1,4,381
64274305,63,111,101,106,55,18,4,2,460
64274306,72,113,116,107,43,34,5,10,500
64274307,60,102,84,66,37,21,6,6,382
64274308,56,78,92,78,39,18,3,2,366
64274309,60,104,71,70,41,25,6,2,379
64274310,42,76,81,53,35,18,5,3,313
64274311,45,69,57,62,37,20,2,3,295
64274401,65,68,137,115,61,73,3,6,528
64274402,39,72,55,63,34,25,3,4,295
64274403,74,106,100,83,44,48,2,7,464
64274404,71,113,95,73,42,35,1,2,432
64274405,41,57,44,43,17,11,1,0,214
64274406,45,62,55,61,20,20,2,1,266
64274407,24,53,36,40,24,23,0,0,200
64274408,50,61,51,54,23,7,0,2,248
64274409,36,64,52,51,18,14,1,1,237
64274410,52,70,65,56,26,33,6,2,310
64274411,37,57,39,37,20,17,2,3,212
64274412,68,101,90,95,44,35,8,6,447
64274501,75,121,120,111,73,31,11,9,551
64274502,42,77,100,87,37,25,2,3,373
64274503,44,80,74,56,36,14,2,2,308
64274504,55,136,111,96,52,21,3,2,476
64274505,41,84,70,69,35,18,0,3,320
64274506,37,58,63,54,37,10,5,4,268
64274507,57,106,126,121,65,23,9,13,520
64274508,57,106,115,123,64,31,6,8,510
64274509,47,73,65,81,29,8,4,4,311
64274510,25,87,75,67,39,26,6,5,330
64274511,55,84,73,84,32,21,10,5,364
64274601,55,81,83,92,33,33,4,5,386
64274602,26,28,41,45,25,30,9,23,227
64274603,62,121,122,126,70,58,12,8,579
64274604,72,117,122,136,65,36,18,17,583
64274605,75,113,125,119,65,42,5,15,559
64274606,82,148,125,112,67,45,11,16,606
64274607,51,79,84,73,46,22,7,16,378
64274608,31,44,51,41,28,20,4,7,226
64274609,154,238,248,240,151,136,31,30,1228
64274610,35,74,73,71,43,23,6,4,329
64274611,69,79,57,82,46,25,9,10,377
64274612,48,80,87,103,45,20,13,10,406
64274613,47,89,107,107,49,30,6,16,451
64274701,31,71,82,69,23,16,5,4,301
64274702,4,13,17,29,37,100,7,35,242
64274703,3,8,8,12,24,79,2,7,143
64274704,37,51,46,43,23,9,12,4,225
64274705,32,53,70,42,37,18,6,4,262
64274706,8,8,11,14,24,92,1,9,167
64274707,1,4,6,21,29,142,4,15,222
64274708,0,1,1,17,15,107,1,14,156
64274709,30,57,65,46,20,20,5,2,245
64274710,33,59,77,69,50,13,9,8,318
64274711,38,69,72,60,35,19,1,1,295
64274712,4,12,24,75,124,259,1,12,511
64274801,11,29,32,29,35,23,6,7,172
64274802,66,116,113,114,63,81,9,16,578
64274803,55,86,93,90,70,50,12,17,473
64274804,50,75,66,79,51,44,9,5,379
64274805,51,80,67,56,27,16,4,3,304
64274806,95,105,130,104,70,92,5,14,615
64274807,53,93,95,79,57,26,12,4,419
64274808,61,110,124,108,60,46,10,8,527
64274809,59,107,102,87,56,40,12,9,472
64274810,55,91,100,92,58,54,8,17,475
64274811,76,85,133,95,57,39,13,19,517
64274812,74,116,107,99,72,44,14,12,538
64274813,56,94,87,90,44,34,7,3,415
64274814,64,90,100,116,52,40,12,13,487
64274901,61,88,83,109,82,66,13,46,548
64274902,45,56,60,55,36,38,6,18,314
64274903,29,62,62,69,43,59,11,16,351
64274904,37,54,66,78,71,53,9,22,390
64274905,49,67,75,69,62,30,7,19,378
64274906,61,79,92,87,83,160,14,43,619
64274907,42,73,80,107,71,54,12,24,463
64274908,26,50,90,74,65,48,8,14,375
64274909,31,84,126,107,77,75,20,17,537
64274910,40,58,68,60,38,59,13,43,379
64274911,29,28,30,42,32,37,12,13,223
64274912,24,50,41,47,37,35,10,18,262
64275001,59,101,91,81,43,33,10,2,420
64275002,34,85,67,68,37,27,8,3,329
64275003,63,87,93,70,33,26,4,9,385
64275004,54,102,93,83,52,18,7,3,412
64275005,45,79,94,87,33,27,1,1,367
64275006,62,99,102,108,61,33,3,7,475
64275007,56,97,89,78,45,25,10,5,405
64275008,30,46,71,83,41,22,4,4,301
64275009,28,65,65,78,30,34,1,1,302
64275010,33,65,88,73,45,34,3,4,345
64275011,48,90,87,87,39,39,3,6,399
64275012,76,115,116,95,45,28,6,6,487
64275013,13,49,58,58,46,18,7,2,251
64275101,13,45,83,100,60,7,4,1,313
64275102,16,53,73,123,40,14,3,6,328
64275103,28,73,70,68,35,14,4,4,296
64275104,44,76,63,72,29,21,4,5,314
64275105,33,65,68,72,38,34,3,4,317
64275106,19,47,55,67,32,33,4,2,259
64275107,32,43,89,73,39,44,6,5,331
64275108,89,114,138,94,48,47,2,9,541
64275109,48,108,80,93,37,29,7,3,405
64275110,22,99,82,93,41,18,4,12,371
64275111,63,102,89,67,29,23,0,11,384
64275112,69,121,69,66,24,29,0,5,383
64275113,21,61,101,123,51,26,3,6,392
64275114,40,132,133,105,49,30,2,9,500
64275115,7,13,19,21,8,10,5,2,85
64275201,33,58,68,87,52,117,8,30,453
64275202,55,86,76,78,70,88,8,32,493
64275203,36,49,58,61,41,58,7,27,337
64275204,42,56,98,95,51,56,6,15,419
64275205,43,68,90,101,55,64,7,20,448
64275206,38,51,64,70,51,83,12,26,395
64275207,74,45,56,57,60,60,5,19,376
64275208,38,43,63,65,58,78,12,17,374
64275209,24,54,71,86,66,81,21,47,450
64275210,18,34,39,61,47,77,5,16,297
64275211,24,36,60,60,40,52,6,16,294
64275212,12,32,59,80,69,64,13,25,354
64275213,46,61,99,84,68,63,18,33,472
64275301,54,72,87,80,76,103,12,38,522
64275302,16,30,33,56,38,47,7,29,256
64275303,11,27,41,43,43,40,7,16,228
64275304,30,53,80,83,65,80,24,42,457
64275305,74,87,116,115,85,75,18,37,607
64275306,36,80,100,101,77,72,31,38,535
64275307,40,61,66,91,57,75,12,32,434
64275308,54,63,92,73,66,89,6,9,452
64275309,24,42,34,40,34,32,2,3,211
64275310,40,69,84,89,67,72,13,34,468
64275401,44,57,90,85,66,56,16,20,434
64275402,57,73,96,130,86,84,9,25,560
64275403,35,56,62,53,46,53,14,15,334
64275404,29,40,67,64,47,34,13,11,305
64275405,36,47,55,73,40,29,8,10,298
64275406,25,57,48,51,43,28,7,13,272
64275407,48,56,81,83,67,46,15,19,415
64275408,46,88,87,60,54,36,15,15,401
64275409,56,88,81,86,75,49,14,18,467
64275410,92,142,168,196,126,127,35,59,945
64275411,36,46,79,65,42,40,14,10,332
64275412,65,99,85,117,58,41,7,9,481
64275501,33,66,50,56,36,23,1,4,269
64275502,54,72,50,46,27,15,0,4,268
64275503,35,66,60,54,19,16,2,3,255
64275504,45,50,56,51,41,21,2,5,271
64275505,82,88,80,86,58,42,6,9,451
64275506,54,95,90,106,73,32,3,8,461
64275507,51,54,59,50,31,17,3,3,268
64275508,47,64,82,78,40,23,6,5,345
64275509,26,50,73,59,45,31,16,10,310
64275510,36,56,88,100,70,54,9,12,425
64275511,38,109,102,98,66,60,11,10,494
64275512,36,76,119,117,80,45,8,20,501
64275513,58,89,90,81,66,50,8,12,454
64275601,35,57,59,64,31,28,7,12,293
64275602,59,116,101,104,70,42,14,6,512
64275603,42,76,130,153,192,434,33,97,1157
64275604,25,59,52,47,40,24,4,9,260
64275605,20,54,52,59,26,34,8,15,268
64275606,54,110,91,123,58,35,9,8,488
64275607,32,49,53,43,27,12,3,2,221
64275608,66,90,83,83,33,19,3,4,381
64275609,39,73,68,78,47,30,4,8,347
64275610,67,84,100,85,57,22,6,6,427
64275611,74,81,81,73,35,22,0,7,373
64275612,42,127,101,72,52,22,9,8,433
64275613,38,61,58,61,41,17,9,7,292
64275701,58,69,84,71,57,31,11,7,388
64275702,32,66,62,81,40,35,7,9,332
64275703,31,48,62,63,41,32,5,10,292
64275704,33,58,46,84,51,32,5,6,315
64275705,31,52,68,75,52,30,9,10,327
64275706,51,70,100,94,67,32,11,8,433
64275707,60,92,114,86,51,35,6,8,452
64275708,36,44,58,56,37,27,10,8,276
64275709,17,38,75,36,25,10,7,4,212
64275710,29,54,68,77,41,25,6,8,308
64275711,24,57,61,60,39,26,4,4,275
64275712,49,86,91,94,50,35,14,7,426
64275713,48,82,86,97,54,55,11,15,448
64275714,23,49,50,44,26,21,8,10,231
64275715,24,38,42,42,28,18,6,9,207
64275801,60,96,118,108,57,37,17,8,501
64275802,45,84,98,85,65,33,12,12,434
64275803,41,65,91,71,53,31,7,11,370
64275804,47,78,69,83,50,33,4,18,382
64275805,24,49,57,45,43,20,3,7,248
64275806,34,50,54,45,26,28,2,9,248
64275807,37,42,73,79,45,51,4,16,347
64275808,54,94,101,107,57,31,12,19,475
64275809,9,30,26,43,25,17,0,1,151
64275810,26,50,85,72,49,19,10,2,313
64275811,22,46,45,57,34,12,9,9,234
64275812,40,62,59,35,45,27,5,8,281
64275813,31,55,62,58,36,19,12,9,282
64275814,35,65,44,44,38,20,6,7,259
64275815,14,51,118,121,68,147,7,17,543
64275901,50,93,123,125,76,57,8,11,543
64275902,15,30,37,50,30,15,0,5,182
64275903,52,103,95,141,85,71,7,7,561
64275904,23,43,50,50,41,24,10,16,257
64275905,36,79,102,128,79,53,16,11,504
64275906,16,46,44,62,41,17,2,8,236
64275907,24,34,57,65,42,10,7,4,243
64275908,45,53,77,68,36,33,12,12,336
64275909,42,55,49,69,26,25,7,1,274
64275910,45,81,85,67,53,20,5,6,362
64275911,36,71,78,74,43,39,11,3,355
64275912,35,56,57,75,37,21,10,5,296
64275913,34,62,75,59,42,11,9,6,298
64276001,43,61,74,84,70,150,2,4,488
64276002,44,59,63,52,64,102,1,6,391
64276003,23,30,29,53,61,111,4,4,315
64276004,34,53,60,54,60,50,2,6,319
64276005,69,96,99,100,59,89,8,5,525
64276006,50,86,96,106,105,91,11,10,555
64276007,49,78,98,88,83,111,8,3,518
64276008,58,89,94,119,92,116,9,5,582
64276009,36,66,79,85,89,93,13,11,472
64276010,41,55,51,77,54,91,6,9,384
64276011,40,61,71,71,60,124,9,1,437
64276012,30,35,40,40,48,109,6,1,309
64276013,31,51,59,52,34,23,13,9,272
64276014,47,68,62,41,18,15,5,2,258
64276015,33,62,58,59,27,21,6,6,272
64276016,75,100,88,95,55,27,9,11,460
64276017,41,74,69,46,39,29,6,8,312
64276018,27,51,69,53,50,29,5,11,295
64276101,59,117,101,97,64,74,4,16,532
64276102,58,98,109,113,60,68,5,44,555
64276103,61,88,103,94,68,34,6,16,470
64276104,72,115,95,96,83,73,5,10,549
64276105,66,93,96,122,78,83,12,32,582
64276106,30,33,67,60,49,117,6,13,375
64276107,42,63,66,70,70,57,17,28,413
64276108,52,85,81,75,64,68,20,25,470
64276109,44,68,93,98,88,75,14,27,507
64276110,46,87,105,111,95,68,14,27,553
64276111,36,72,45,69,43,26,5,5,301
64276112,34,52,66,64,40,28,12,9,305
64276113,34,69,70,65,51,25,12,14,340
64276114,48,79,85,78,40,30,12,15,387
64276201,39,60,46,61,50,38,8,9,311
64276202,31,72,80,102,64,59,8,9,425
64276203,36,56,60,65,44,48,9,8,326
64276204,33,65,62,66,47,47,10,5,335
64276205,66,100,115,116,109,92,21,31,650
64276206,30,69,66,68,54,33,6,13,339
64276207,41,57,72,57,46,47,5,10,335
64276208,36,51,62,66,26,10,6,1,258
64276209,33,66,57,63,35,75,3,8,340
64276210,70,106,99,110,56,93,2,18,554
64276211,19,41,54,45,44,80,7,24,314
64276212,38,67,85,65,36,39,3,7,340
64276213,35,70,78,77,44,53,8,18,383
64276214,37,46,41,42,29,39,0,6,240
64276215,39,68,62,56,45,34,8,3,315
64276216,45,71,101,84,43,66,2,6,418
64276301,48,104,96,82,49,62,12,19,472
64276302,9,7,14,15,24,25,4,6,104
64276303,41,45,66,51,46,60,8,8,325
64276304,31,52,48,49,39,54,8,10,291
64276305,36,39,44,47,35,62,6,14,283
64276306,51,66,83,70,44,72,9,16,411
64276307,34,68,75,77,43,48,4,15,364
64276308,85,101,100,83,58,42,10,12,491
64276309,88,87,83,79,46,148,9,11,551
64276310,55,89,116,110,72,174,12,16,644
64276311,51,43,83,87,66,151,12,18,511
64276312,30,58,73,79,42,66,12,15,375
64276401,17,40,39,58,42,33,10,13,252
64276402,39,37,37,34,43,43,8,13,254
64276403,36,63,96,73,59,78,12,21,438
64276404,29,53,50,65,47,27,6,8,285
64276405,35,40,65,60,47,51,10,21,329
64276406,36,62,61,51,55,38,5,11,319
64276407,29,63,91,91,44,87,17,23,445
64276408,30,53,71,59,35,34,9,7,298
64276409,73,85,110,93,57,45,18,14,495
64276410,45,74,92,113,61,61,14,24,484
64276411,35,44,65,52,28,26,1,10,261
64276412,39,52,88,60,52,61,7,10,369
64276413,22,37,50,46,29,28,7,13,232
64276414,25,52,69,68,35,35,9,8,301
64276415,30,42,70,68,38,85,12,27,372
64276416,12,14,33,48,39,219,7,50,422
64276417,36,64,69,64,34,19,1,3,290
64276501,36,45,83,82,74,133,19,20,492
64276502,39,72,92,85,58,117,13,17,493
64276503,59,71,77,76,60,49,6,7,405
64276504,43,65,89,90,92,104,23,23,529
64276505,17,30,46,45,33,44,7,12,234
64276506,20,40,65,44,51,83,13,19,335
64276507,43,64,89,96,78,59,21,28,478
64276508,22,44,66,57,43,34,5,0,271
64276509,21,45,52,43,28,31,6,8,234
64276510,22,32,58,51,48,45,10,13,279
64276511,50,88,124,102,72,75,23,22,556
64276512,34,51,43,74,36,48,9,6,301
64276513,25,32,42,73,52,28,11,9,272
64276514,22,58,60,70,45,37,4,13,309
64276515,41,66,90,84,42,62,8,13,406
64276516,51,93,108,100,59,60,10,15,496
64276517,51,117,88,107,83,68,6,14,534
64276601,25,50,46,84,47,72,4,13,341
64276602,19,49,64,72,47,64,1,7,323
64276603,35,67,88,126,90,123,11,14,554
64276604,37,66,69,93,49,82,10,14,420
64276605,58,69,114,97,63,61,15,7,484
64276606,34,52,54,59,46,41,11,7,304
64276607,38,55,55,77,46,21,6,7,305
64276608,28,56,73,75,47,47,3,6,335
64276609,27,53,58,59,49,39,5,12,302
64276610,34,54,79,88,37,27,13,14,346
64276611,38,50,63,72,52,24,7,18,324
64276701,40,40,73,80,47,48,18,12,358
64276702,26,60,73,75,52,159,7,18,470
64276703,26,37,67,55,45,39,7,12,288
64276704,69,89,120,180,133,191,17,41,840
64276705,13,30,52,52,51,74,12,28,312
64276706,40,72,78,72,62,53,16,23,416
64276707,30,73,66,68,50,41,8,19,355
64276708,24,63,83,70,55,33,4,10,342
64276709,36,33,44,48,38,68,5,10,282
64276710,22,37,48,55,31,46,4,7,250
64276711,43,40,53,66,49,52,6,5,314
64276712,51,69,89,76,55,58,7,23,428
64276713,20,42,55,69,30,49,14,27,306
64276714,17,37,57,35,43,60,8,22,279
64276715,16,42,54,44,43,62,4,34,299
64276716,23,25,48,51,40,59,12,31,289
64276717,38,52,54,77,48,50,11,23,353
64276718,46,61,76,98,42,51,8,43,425
64276801,34,44,68,43,33,52,10,4,288
64276802,56,45,61,74,37,65,6,16,360
64276803,30,31,33,35,19,51,6,3,208
64276804,38,37,59,57,23,44,4,5,267
64276805,42,68,49,40,20,40,3,5,267
64276806,47,89,75,72,38,60,1,3,385
64276807,44,69,54,52,41,32,4,3,299
64276808,52,74,64,71,42,23,10,4,340
64276809,40,77,59,58,35,29,12,11,321
64276810,35,45,57,47,44,25,4,4,261
64276901,32,49,39,54,50,54,3,8,289
64276902,26,46,65,65,61,91,8,8,370
64276903,39,56,46,67,41,88,10,7,354
64276904,32,54,63,72,55,84,10,9,379
64276905,40,67,93,130,88,205,13,18,654
64276906,26,45,40,70,45,72,7,7,312
64276907,37,59,79,84,61,59,10,3,392
64276908,39,54,62,75,47,37,2,9,325
64276909,63,93,114,92,70,75,8,8,523
64276910,38,55,40,52,25,8,2,1,221
64276911,42,66,53,49,27,22,0,3,262
64276912,30,53,56,64,28,26,5,6,268
64276913,52,81,93,110,62,51,7,3,459
64276914,28,72,78,82,49,53,7,11,380
64276915,45,84,91,68,50,43,14,14,409
64276916,33,39,66,72,45,31,9,12,307
64276917,41,72,75,78,50,41,10,18,385
64277001,9,15,19,32,76,168,4,39,362
64277002,35,55,65,60,40,70,6,10,341
64277003,27,54,57,56,45,65,9,12,325
64277004,54,80,84,102,49,78,9,23,479
64277005,39,60,77,71,46,67,11,26,397
64277006,30,54,60,58,42,57,3,11,315
64277007,27,48,42,51,35,53,6,7,269
64277008,35,52,72,68,40,96,13,13,389
64277009,27,39,42,48,31,92,4,15,298
64277010,26,54,62,64,32,41,8,6,293
64277011,24,59,71,58,29,31,7,8,287
64277012,32,55,64,85,38,86,11,19,390
64277013,41,55,38,61,29,20,5,7,256
64277014,30,61,75,73,37,31,6,11,324
64277015,35,38,46,43,37,24,9,12,244
64277016,32,50,63,54,33,23,4,10,269
64277017,23,52,52,58,40,26,5,6,262
64277018,30,60,44,44,33,26,4,8,249
64277101,81,55,92,77,46,32,8,6,397
64277102,49,81,101,99,46,31,10,10,427
64277103,34,39,72,62,24,29,7,10,277
64277104,21,42,54,53,24,25,15,6,240
64277105,29,29,51,66,29,23,3,6,236
64277106,28,60,72,58,34,17,2,2,273
64277107,59,75,110,115,52,38,7,13,469
64277108,27,36,50,53,35,26,4,6,237
64277109,21,63,47,66,24,24,8,7,260
64277110,24,51,41,52,24,22,6,6,226
64277111,25,47,67,70,42,20,11,9,291
64277112,49,94,115,100,59,41,10,26,494
64277113,23,40,73,70,63,41,13,41,364
64277114,23,65,94,96,58,36,11,27,410
64277115,35,57,78,63,64,43,8,19,367
64277116,42,62,96,89,60,37,16,18,420
64277201,25,52,70,144,75,184,5,17,572
64277202,29,48,48,61,36,27,16,14,279
64277203,29,46,44,65,34,21,3,5,247
64277204,28,60,75,84,50,32,13,8,350
64277205,39,52,83,81,74,47,21,9,406
64277206,18,43,63,68,42,21,10,8,273
64277207,28,50,75,69,33,23,9,11,298
64277208,39,41,46,65,29,22,8,16,266
64277209,45,66,78,69,45,29,8,15,355
64277210,29,58,55,67,42,35,14,12,312
64277211,49,77,99,105,69,42,19,17,477
64277212,34,68,70,84,54,39,8,16,373
64277301,28,63,90,86,65,76,11,22,441
64277302,39,69,99,132,59,68,18,23,507
64277303,37,53,76,81,42,56,2,14,361
64277304,20,41,55,61,48,47,13,12,297
64277305,32,52,94,79,54,59,12,15,397
64277306,43,72,95,98,60,44,12,11,435
64277307,14,24,42,73,110,250,7,59,579
64277308,37,89,100,121,72,59,15,17,510
64277309,45,65,116,113,71,66,9,24,509
64277310,33,59,92,107,60,81,15,29,476
64277311,27,47,54,53,38,41,13,13,286
64277312,39,51,58,54,52,62,5,4,325
64277313,27,51,75,69,66,82,14,26,410
64277314,21,27,56,46,49,50,12,26,287
64277315,21,26,45,71,44,58,11,24,300
64277316,24,43,66,75,42,54,13,12,329
64277401,33,54,64,79,64,79,11,37,421
64277402,53,80,97,110,75,79,10,35,539
64277403,37,47,76,73,80,83,12,25,433
64277404,8,16,34,45,53,120,2,34,312
64277405,58,75,86,69,54,63,8,14,427
64277406,39,91,97,91,81,59,14,25,497
64277407,47,68,99,76,62,49,14,21,436
64277408,42,60,61,74,68,52,10,24,391
64277409,21,59,60,58,33,29,8,8,276
64277410,25,51,59,59,58,78,17,37,384
64277411,30,55,96,105,102,173,15,55,631
64277412,37,70,88,88,72,56,18,11,440
64277413,27,43,57,71,50,29,7,16,300
64277414,36,53,80,82,62,64,14,22,413
64277415,22,43,55,58,66,54,13,31,342
64277416,19,33,51,66,47,33,9,22,280
64277417,32,49,61,65,51,41,11,21,331
64277418,50,107,185,226,178,188,35,74,1043
64277501,20,37,103,153,109,79,8,11,520
64277502,10,38,102,144,108,145,10,22,579
64277503,39,50,78,103,70,51,9,10,410
64277504,31,57,105,111,87,79,21,29,520
64277505,50,51,92,102,67,75,27,29,493
64277506,27,56,94,88,73,44,15,21,418
64277507,45,59,96,95,67,38,17,19,436
64277508,37,58,78,95,60,46,10,12,396
64277509,26,33,44,85,67,29,13,22,319
64277510,42,56,108,111,73,36,15,30,471
64277511,37,43,62,91,85,49,30,37,434
64277512,33,43,58,71,67,60,9,15,356
64277513,33,36,56,78,67,57,12,18,357
64277514,29,48,64,58,60,44,9,9,321
64277515,30,43,71,86,69,43,9,19,370
64277516,26,58,86,82,58,43,15,24,392
64277601,50,66,97,103,59,57,8,24,464
64277602,25,62,107,137,84,86,13,21,535
64277603,57,91,120,132,89,105,18,25,637
64277604,38,66,107,114,76,62,20,20,503
64277605,74,91,105,105,52,38,21,26,512
64277606,64,91,95,101,54,37,13,11,466
64277607,51,71,113,140,61,95,19,23,573
64277608,33,65,117,131,72,74,11,8,511
64277609,29,46,84,119,76,46,26,26,452
64277610,32,88,108,119,67,55,18,15,502
64277611,50,85,125,145,86,75,11,20,597
64277612,50,67,122,121,77,92,24,25,578
64277613,21,38,47,49,32,43,5,4,239
64277614,25,40,52,65,40,39,11,12,284
64277615,32,59,82,131,62,92,16,17,491
64277616,27,63,84,127,85,74,12,21,493
64277617,18,33,55,78,36,29,11,16,276
64277618,36,52,62,63,46,22,6,11,298
64277701,40,73,80,83,54,27,12,19,388
64277702,37,80,98,108,53,40,8,16,440
64277703,68,84,108,119,69,36,17,15,516
64277704,60,93,116,136,79,33,16,12,545
64277705,14,41,67,82,54,28,7,8,301
64277706,42,62,108,117,73,57,10,17,486
64277707,33,51,77,83,53,43,6,14,360
64277708,29,58,75,59,47,25,6,7,306
64277709,31,37,59,70,30,21,10,10,268
64277710,37,74,96,93,77,38,16,17,448
64277711,30,68,81,73,46,28,12,17,355
64277712,42,86,132,99,66,43,13,25,506
64277713,43,71,72,73,37,24,10,9,339
64277714,31,58,68,61,42,26,9,6,301
64277715,28,51,54,59,34,21,7,14,268
64277716,47,47,68,53,40,18,6,14,293
64277801,12,33,41,97,200,251,5,14,653
64277802,22,37,40,69,174,265,3,6,616
64277803,49,63,94,90,46,33,17,24,416
64277804,30,55,70,95,46,29,11,6,342
64277805,52,61,93,96,70,49,13,19,453
64277806,33,55,56,71,38,33,14,16,316
64277807,53,65,92,84,53,40,21,19,427
64277808,25,35,49,48,50,29,17,14,267
64277809,37,49,69,63,45,27,12,17,319
64277810,31,44,72,87,53,35,12,23,357
64277811,27,52,59,62,35,38,14,15,302
64277812,32,61,92,88,65,45,10,18,411
64277813,32,53,104,82,83,43,19,22,438
64277901,21,52,77,123,111,153,12,19,568
64277902,32,67,61,62,34,25,4,10,295
64277903,32,59,76,77,46,30,7,12,339
64277904,31,46,74,76,49,29,15,23,343
64277905,46,92,98,113,60,40,22,19,490
64277906,45,58,68,67,42,31,10,10,331
64277907,25,44,41,62,31,20,11,12,246
64277908,23,44,59,48,47,30,6,7,264
64277909,27,69,71,65,33,18,6,8,297
64277910,54,92,99,91,53,45,15,13,462
64277911,50,80,97,109,86,39,19,15,495
64278001,17,54,113,186,187,185,11,56,809
64278002,51,72,104,102,67,41,17,21,475
64278003,30,60,93,90,74,71,14,33,465
64278004,37,51,67,48,39,21,17,10,290
64278005,37,50,88,81,62,74,9,10,411
64278006,43,63,100,101,71,42,25,25,470
64278007,27,50,55,83,55,56,11,13,350
64278008,46,69,99,87,68,55,17,17,458
64278009,17,41,63,59,61,42,11,19,313
64278010,17,22,47,48,29,27,7,8,205
64278011,23,30,43,49,42,40,6,14,247
64278012,24,35,41,54,32,35,18,12,251
64278013,17,19,44,51,20,27,15,16,209
64278014,14,36,53,64,45,31,12,17,272
64278015,17,42,40,51,28,30,10,12,230
64278016,21,33,58,54,50,44,9,24,293
64278101,33,62,88,100,82,61,12,24,462
64278102,21,66,65,75,45,60,7,8,347
64278103,43,48,69,70,72,32,7,32,373
64278104,15,32,47,60,40,104,7,13,318
64278105,21,20,38,50,32,59,9,7,236
64278106,19,29,24,46,25,54,2,3,202
64278107,15,32,46,32,27,41,2,10,205
64278108,2,3,12,8,4,2,2,2,35
64278109,7,10,22,32,18,15,0,2,106
64278110,9,13,18,28,15,21,4,9,117
64278111,23,30,58,51,44,64,1,9,280
64278112,4,9,14,11,8,12,4,3,65
64278201,20,51,94,87,79,92,15,23,461
64278202,25,49,51,54,56,55,11,8,309
64278203,30,47,81,86,57,52,11,16,380
64278204,20,60,59,58,56,46,2,11,312
64278205,15,24,59,80,106,127,2,2,415
64278206,9,7,37,114,129,132,1,4,433
64278207,27,62,86,98,80,86,19,24,482
64278208,26,46,81,107,70,55,14,21,420
64278209,22,49,117,220,145,170,11,13,747
64278210,22,67,71,67,54,54,12,13,360
64278211,25,43,50,66,69,52,7,6,318
64278212,33,40,54,70,54,30,6,14,301
64278213,33,62,69,76,49,43,8,9,349
64278301,42,66,88,70,64,31,4,10,375
64278302,24,57,67,84,59,44,16,16,367
64278303,33,71,86,92,55,44,10,22,413
64278304,58,76,83,89,65,83,10,13,477
64278305,36,49,100,107,69,131,2,12,506
64278306,35,49,83,71,74,71,10,8,401
64278307,35,34,42,80,57,40,9,5,302
64278308,27,46,58,73,54,40,20,21,339
64278309,23,54,57,77,42,45,15,21,334
64278310,32,45,68,87,47,46,13,17,355
64278311,45,62,68,63,47,48,10,8,351
64278312,37,63,91,65,44,30,11,26,367
64278313,53,70,84,97,68,44,10,21,447
64278314,31,55,97,69,61,27,13,15,368
64278401,19,32,55,59,43,22,4,9,243
64278402,14,36,55,64,40,32,9,10,260
64278403,37,48,71,65,51,47,9,14,342
64278404,33,46,93,79,58,54,19,17,399
64278405,52,81,116,100,80,53,14,12,508
64278406,43,66,62,68,46,22,12,15,334
64278407,36,66,64,66,62,56,17,18,385
64278408,33,50,73,90,72,52,15,18,403
64278409,39,65,119,121,84,61,25,36,550
64278410,20,51,62,65,55,46,16,22,337
64278411,32,57,91,96,65,63,22,28,454
64278412,39,76,84,100,44,36,12,10,401
64278413,54,55,123,105,85,60,18,18,518
64278414,22,45,62,43,39,15,7,10,243
64278415,42,55,107,120,90,69,32,34,549
64278416,46,55,83,106,61,43,16,12,422
64278417,38,48,95,105,77,34,22,21,440
64278501,41,71,103,108,89,109,8,17,546
64278502,39,60,87,103,91,99,10,17,506
64278503,41,58,72,83,77,38,13,21,403
64278504,26,47,58,69,58,15,7,20,300
64278505,34,49,67,59,32,55,8,11,315
64278506,56,86,81,82,49,47,5,10,416
64278507,53,57,84,88,68,55,6,20,431
64278508,45,47,44,53,34,20,1,3,247
64278509,62,99,123,110,54,52,6,6,512
64278510,26,75,65,61,23,26,3,3,282
64278511,58,90,84,84,64,46,3,12,441
64278512,42,58,76,85,66,45,23,12,407
64278513,36,57,102,120,62,60,13,16,466
64278601,68,89,98,79,46,16,9,4,409
64278602,39,59,59,75,36,26,12,12,318
64278603,26,70,91,78,53,21,9,13,361
64278604,44,67,79,93,39,31,13,7,373
64278605,28,50,63,74,42,33,10,8,308
64278606,32,59,71,74,33,31,3,6,309
64278607,46,67,109,86,51,55,10,12,436
64278608,21,51,48,67,40,31,6,11,275
64278609,26,41,77,77,43,39,4,10,317
64278610,40,44,60,63,43,37,8,8,303
64278611,30,47,71,67,37,65,8,4,329
64278612,30,58,62,79,36,36,5,7,313
64278613,40,67,70,79,51,55,10,14,386
64278614,32,60,68,87,52,46,14,15,374
64278701,35,55,82,77,35,36,15,7,342
64278702,33,50,74,61,43,43,3,18,325
64278703,27,58,55,57,38,19,10,7,271
64278704,33,69,88,78,58,35,9,12,382
64278705,52,102,115,100,59,38,10,19,495
64278706,34,56,57,61,42,27,7,11,295
64278707,28,57,73,72,47,28,13,20,338
64278708,55,80,106,105,57,68,1,5,477
64278709,26,46,69,51,49,24,15,13,293
64278710,40,68,77,65,42,25,21,15,353
64278711,7,7,12,6,6,4,2,1,45
64278712,66,43,58,69,30,18,7,6,297
64278713,41,59,75,76,38,29,13,5,336
64278714,44,59,64,59,53,15,7,14,315
64278715,20,33,49,53,29,27,8,11,230
64278801,30,66,83,96,37,37,9,15,373
64278802,40,99,120,116,86,55,15,15,546
64278803,36,78,132,132,79,48,18,20,543
64278804,62,102,125,105,67,77,8,15,561
64278805,43,99,129,129,98,105,22,19,644
64278806,34,56,50,72,33,39,6,2,292
64278807,25,62,83,75,45,34,8,8,340
64278808,33,67,108,102,57,46,18,9,440
64278809,32,67,94,98,70,43,15,8,427
64278810,46,81,97,73,56,21,12,9,395
64278811,25,32,47,46,27,9,11,6,203
64278812,34,68,78,91,43,14,7,4,339
64278813,35,80,85,87,49,32,15,16,399
64278901,21,47,102,196,162,256,8,20,812
64278902,24,42,77,142,123,154,3,7,572
64278903,58,46,98,134,85,79,22,27,549
64278904,53,78,116,141,91,52,26,31,588
64278905,41,81,89,136,82,60,14,19,522
64278906,38,61,75,120,70,71,18,26,479
64278907,49,51,78,115,112,112,15,29,561
64278908,50,74,95,116,84,80,18,18,535
64278909,19,32,45,59,57,40,3,7,262
64278910,17,44,74,87,43,71,4,5,345
64278911,48,90,116,119,77,58,14,23,545
64278912,44,56,92,145,85,67,18,31,538
64278913,53,81,102,107,83,89,10,21,546
64278914,41,53,101,121,96,87,22,38,559
64279001,66,113,97,94,74,31,6,11,492
64279002,45,85,132,108,70,49,12,19,520
64279003,29,37,51,47,27,27,8,10,236
64279004,24,53,63,76,43,51,6,9,325
64279005,32,43,59,49,35,37,7,14,276
64279006,36,53,85,77,43,27,13,13,347
64279007,46,61,65,59,39,23,2,5,300
64279008,35,61,81,73,37,73,7,6,373
64279009,35,58,105,125,95,148,12,21,599
64279010,48,95,106,115,92,128,8,15,607
64279011,29,49,62,54,45,53,2,1,295
64279012,21,42,50,58,38,45,3,5,262
64279013,22,46,49,43,31,46,6,5,248
64279014,24,46,53,67,55,66,8,14,333
64279101,38,61,95,91,46,183,9,8,531
64279102,32,51,94,66,38,31,3,3,318
64279103,26,66,80,98,65,65,15,19,434
64279104,43,66,64,66,42,74,10,9,374
64279105,35,55,61,75,33,13,6,5,283
64279106,35,52,87,66,36,21,6,5,308
64279107,40,56,85,78,41,29,6,7,342
64279108,24,65,100,81,53,41,2,8,374
64279109,22,55,55,69,40,47,8,1,297
64279110,17,30,39,26,27,39,2,8,188
64279111,28,50,74,57,21,27,4,0,261
64279112,84,136,118,98,42,73,4,6,561
64279113,22,52,45,25,15,4,1,0,164
64279114,10,28,50,25,9,7,2,1,132
64279115,19,21,14,21,11,20,2,3,111
64279116,13,18,24,4,12,14,1,1,87
64279201,38,39,66,57,38,110,17,24,389
64279202,40,44,75,69,50,100,21,17,416
64279203,15,36,39,44,37,47,7,10,235
64279204,26,71,67,80,69,92,24,18,447
64279205,43,49,74,87,54,93,11,21,432
64279206,44,59,74,87,66,115,11,36,492
64279207,42,72,75,82,81,111,24,39,526
64279208,45,60,87,78,50,125,17,26,488
64279209,35,44,87,84,48,110,14,19,441
64279210,40,40,70,87,65,76,22,21,421
64279211,17,35,72,106,62,62,22,21,397
64279212,55,72,77,64,44,44,5,10,371
64279213,32,47,69,79,55,37,14,14,347
64279214,43,73,73,74,57,64,10,18,412
64279215,18,35,55,54,36,32,7,12,249
64279216,40,53,74,68,51,65,10,6,367
64279217,21,16,38,54,36,37,8,19,229
64279218,23,33,57,45,31,16,10,13,228
64279219,46,58,76,94,63,37,20,19,413
64279301,37,30,39,59,57,121,11,9,363
64279302,28,39,57,77,51,131,8,15,406
64279303,29,31,49,52,66,75,17,15,334
64279304,28,56,54,81,62,82,10,20,393
64279305,38,48,80,80,55,65,8,17,391
64279306,53,74,119,129,75,48,18,27,543
64279307,60,58,71,73,54,86,18,28,448
64279308,37,67,68,108,67,82,10,7,446
64279309,65,83,85,92,60,50,6,10,451
64279310,75,84,88,71,43,68,5,11,445
64279311,45,63,102,94,63,86,11,22,486
64279312,45,59,87,91,55,53,12,13,415
64279313,39,57,99,99,73,51,15,20,453
64279314,40,74,95,97,73,49,20,15,463
64279315,52,68,82,104,77,76,12,15,486
64279401,35,54,88,87,62,125,9,17,477
64279402,37,57,81,86,40,118,12,13,444
64279403,53,70,85,73,54,128,12,6,481
64279404,22,77,68,83,60,131,14,15,470
64279405,30,46,75,81,82,160,18,23,515
64279406,26,41,89,113,68,166,29,40,572
64279407,18,23,50,74,71,44,10,19,309
64279408,41,34,66,58,45,36,17,13,310
64279409,49,67,83,103,67,33,12,12,426
64279410,37,56,83,86,46,39,12,21,380
64279411,46,85,84,100,61,46,15,17,454
64279412,36,75,73,98,70,54,11,18,435
64279413,54,57,72,78,58,31,24,25,399
64279501,27,43,59,70,43,55,9,16,322
64279502,36,52,76,87,81,62,17,14,425
64279503,33,57,88,94,61,104,18,30,485
64279504,49,54,117,111,86,118,10,30,575
64279505,48,56,87,95,55,99,16,21,477
64279506,40,64,72,73,55,79,20,21,424
64279507,41,52,70,113,98,544,12,10,940
64279508,34,29,37,51,38,274,5,2,470
64279509,40,45,70,85,39,86,11,10,386
64279510,45,77,91,84,55,78,10,13,453
64279511,36,58,83,76,59,49,26,24,411
64279512,62,65,115,127,76,83,17,21,566
64279513,29,50,86,79,49,69,13,10,385
64279514,30,53,80,70,51,79,15,11,389
64279601,62,43,55,76,59,126,12,19,452
64279602,27,44,64,73,51,107,10,13,389
64279603,65,44,55,57,45,113,14,16,409
64279604,29,37,88,127,96,203,13,21,614
64279605,29,35,47,93,75,172,7,4,462
64279606,46,90,75,95,66,117,10,7,506
64279607,26,45,60,62,43,65,11,14,326
64279608,54,58,91,98,40,117,10,9,477
64279609,40,80,93,109,74,90,12,16,514
64279610,28,54,83,97,68,129,19,20,498
64279611,28,47,54,56,33,77,9,8,312
64279612,34,45,57,64,49,111,10,21,391
64279613,3,10,8,4,2,12,1,0,40
64279614,39,41,64,87,48,132,14,12,437
64279615,32,45,57,38,38,25,5,8,248
64279616,18,40,22,27,13,15,1,7,143
64279701,33,45,58,56,46,69,5,14,326
64279702,10,45,114,173,170,398,4,20,934
64279703,21,37,59,96,84,144,14,20,475
64279704,39,59,78,87,68,81,16,19,447
64279705,11,29,39,48,40,23,6,12,208
64279706,26,34,110,104,80,112,11,15,492
64279707,28,36,54,65,52,160,11,6,412
64279708,30,46,70,73,46,106,6,10,387
64279709,35,55,49,45,32,37,13,12,278
64279710,30,31,44,51,32,12,12,13,225
64279711,17,27,24,12,16,7,3,2,108
64279712,13,15,34,26,22,19,4,7,140
64279713,27,56,59,57,33,32,8,1,273
64279714,39,61,102,85,41,32,3,14,377
64279715,31,34,49,38,33,22,3,6,216
64279716,17,16,15,20,22,23,10,10,133
64279717,30,46,48,55,42,26,9,21,277
64279718,13,40,42,43,29,14,7,5,193
64279719,30,26,55,44,30,16,8,7,216
64279720,22,55,80,78,41,52,16,14,358
64279721,40,58,61,66,51,25,14,13,328
64279722,26,33,27,44,35,21,8,11,205
64279723,28,44,45,60,53,29,13,17,289
64279724,32,47,53,64,30,15,6,8,255
64340101,71,106,111,95,78,41,16,13,531
64340102,62,70,56,51,26,17,3,0,285
64340103,49,77,51,51,24,9,4,2,267
64340104,70,101,72,62,20,11,1,0,337
64340105,75,97,94,59,23,7,5,2,362
64340106,83,97,83,68,29,18,2,0,380
64340107,49,81,40,44,27,14,4,4,263
64340108,82,68,61,49,23,6,5,5,299
64340109,58,69,51,42,24,10,2,0,256
64340110,51,95,67,62,29,8,1,0,313
64340111,58,87,69,60,18,10,5,2,309
64340201,54,65,50,50,24,14,1,2,260
64340202,4,15,16,12,4,3,1,0,55
64340203,48,90,66,52,23,9,2,1,291
64340204,36,65,40,44,17,10,2,3,217
64340205,60,101,61,39,22,6,2,2,293
64340206,61,91,63,40,33,2,2,2,294
64340207,13,18,9,13,5,2,0,0,60
64340208,33,65,37,38,16,6,1,1,197
64340209,13,13,15,7,3,0,1,1,53
64340210,60,58,43,25,18,4,2,1,211
64340211,73,101,82,69,18,10,4,2,359
64340212,55,89,71,60,13,5,3,3,299
64340301,51,116,76,49,32,9,4,3,340
64340302,65,86,75,47,9,12,0,0,294
64340303,97,144,116,98,43,17,5,2,522
64340304,47,87,67,66,27,9,2,2,307
64340305,63,92,55,77,22,11,4,0,324
64340306,50,72,61,53,17,4,3,0,260
64340307,84,83,66,54,35,12,6,1,341
64340308,69,134,93,78,55,12,5,8,454
64340309,84,145,100,101,42,20,5,5,502
64340310,62,93,65,66,24,12,2,2,326
64340401,79,99,77,64,32,9,2,0,362
64340402,53,71,71,60,20,6,2,3,286
64340403,59,99,74,36,18,4,3,0,293
64340404,39,69,44,38,18,7,2,0,217
64340405,51,65,52,53,16,3,3,0,243
64340406,62,126,70,53,31,16,1,1,360
64340407,33,49,67,42,18,5,1,3,218
64340408,27,46,33,21,12,3,2,0,144
64340409,37,62,42,38,16,5,0,0,200
64340410,77,111,77,65,26,8,3,1,368
64340501,88,105,97,76,40,17,3,1,427
64340502,64,110,85,73,30,16,3,2,383
64340503,51,105,54,41,25,5,2,0,283
64340504,75,106,72,46,20,8,0,0,327
64340505,56,67,75,87,29,16,2,1,333
64340506,51,69,51,53,18,11,2,2,257
64340507,62,88,75,86,29,14,1,0,355
64340508,55,95,62,55,25,12,3,3,310
64340601,63,89,73,63,29,11,2,4,334
64340602,54,73,71,51,32,18,5,3,307
64340603,51,88,63,62,41,22,4,4,335
64340604,56,83,86,74,26,11,4,1,341
64340605,54,88,68,48,18,9,2,1,288
64340606,67,110,91,78,25,8,0,3,382
64340607,60,82,76,63,29,14,1,4,329
64340608,55,83,87,80,27,17,2,2,353
64340609,48,69,64,72,34,25,8,18,338
64340701,39,52,42,39,20,21,11,12,236
64340702,37,55,62,67,22,16,7,4,270
64340703,57,75,78,37,36,13,5,3,304
64340704,46,58,48,43,20,11,1,3,230
64340705,42,62,55,44,32,24,12,13,284
64340706,26,39,23,40,15,7,2,4,156
64340707,177,301,308,282,131,54,15,18,1286
64340708,41,48,29,30,16,10,2,2,178
64340709,20,42,46,35,17,12,3,2,177
64340710,34,57,44,42,22,11,3,3,216
64340711,30,35,31,29,21,13,4,2,165
64340801,37,53,42,40,19,15,3,0,209
64340802,66,113,94,89,45,24,6,6,443
64340803,25,47,53,41,24,17,5,4,216
64340804,79,62,69,62,32,27,5,5,341
64340805,42,71,62,48,34,17,7,6,287
64340806,59,93,118,80,61,46,14,15,486
64340807,25,36,48,47,30,23,4,11,224
64340808,10,12,23,14,13,7,0,9,88
64340809,28,29,52,45,42,35,11,17,259
64340810,49,45,60,60,59,42,9,28,352
64340811,27,46,64,69,42,30,11,20,309
64340812,69,80,93,77,54,53,16,21,463
64340813,37,57,63,72,38,30,8,16,321
64340814,36,55,41,37,27,14,9,4,223
64340815,65,78,90,82,35,30,21,20,421
64340816,50,88,79,103,46,21,10,7,404
64340901,37,47,46,39,40,19,5,15,248
64340902,40,64,61,79,37,42,16,14,353
64340903,26,60,79,72,52,37,11,16,353
64340904,21,42,50,42,34,18,7,14,228
64340905,24,32,52,51,25,26,8,4,222
64340906,34,41,60,61,36,22,10,18,282
64340907,34,43,48,45,46,26,13,15,270
64340908,33,40,60,51,37,30,9,11,271
64340909,30,65,65,62,42,29,12,10,315
64340910,28,51,80,60,42,17,8,8,294
64340911,31,46,39,49,25,17,9,12,228
64340912,26,45,48,54,45,12,8,11,249
64340913,30,43,66,50,32,24,12,9,266
64340914,50,60,86,77,52,32,10,14,381
64340915,51,74,80,76,42,24,4,8,359
64340916,29,51,71,68,36,35,3,13,306
64340917,28,46,41,31,35,16,7,7,211
64340918,21,51,62,56,40,28,1,15,274
64341001,31,71,66,59,28,15,8,12,290
64341002,32,39,38,30,13,7,6,2,167
64341003,39,38,41,39,28,11,0,0,196
64341004,22,52,43,36,26,15,5,6,205
64341005,31,73,52,48,20,11,1,3,239
64341006,43,78,58,70,38,17,6,5,315
64341007,52,69,86,63,40,12,6,4,332
64341008,55,112,86,66,25,13,7,2,366
64341009,38,85,86,66,48,16,6,5,350
64341010,53,49,77,77,46,24,8,8,342
64341011,30,72,58,78,46,36,23,36,379
64341012,36,58,67,61,39,16,10,10,297
64341101,56,81,67,69,26,23,5,6,333
64341102,64,76,82,80,52,21,5,13,393
64341103,40,61,49,46,32,10,4,5,247
64341104,36,53,63,57,34,12,4,10,269
64341105,41,55,50,52,26,14,8,3,249
64341106,27,52,42,55,27,15,7,14,239
64341107,34,48,34,40,27,10,2,3,198
64341108,23,45,46,52,26,18,5,5,220
64341109,49,62,48,60,22,15,4,8,268
64341110,23,52,41,40,15,12,5,1,189
64341111,46,65,57,68,25,12,7,9,289
64341112,80,81,95,73,40,15,6,4,394
64341113,58,100,79,65,31,26,5,6,370
64341114,41,54,44,60,18,18,2,5,242
64341201,57,115,72,53,30,12,3,3,345
64341202,53,106,94,78,32,10,4,3,380
64341203,67,95,87,57,22,8,2,4,342
64341204,51,103,80,72,34,10,3,2,355
64341205,60,81,65,60,28,12,3,4,313
64341206,46,88,79,76,31,16,8,6,350
64341207,85,77,94,81,43,25,4,4,413
64341208,68,95,65,64,23,7,2,0,324
64341301,69,89,81,55,26,17,4,1,342
64341302,30,61,51,50,21,5,0,1,219
64341303,45,92,62,52,29,5,0,0,285
64341304,35,49,41,38,19,4,3,1,190
64341305,67,96,78,78,32,14,0,2,367
64341306,63,74,62,44,24,7,2,2,278
64341307,56,84,71,56,22,9,0,0,298
64341308,55,89,77,73,36,7,7,3,347
64341309,66,98,81,75,29,7,1,3,360
64341310,61,78,67,74,31,18,3,2,334
64341311,72,89,95,91,51,19,6,8,431
64341312,42,76,71,59,28,26,10,7,319
64341401,56,87,57,51,27,3,3,2,286
64341402,44,65,48,35,15,7,3,1,218
64341403,53,64,42,54,19,5,0,0,237
64341404,53,87,69,52,21,12,0,0,294
64341405,45,78,52,46,24,3,1,2,251
64341406,73,83,77,54,23,12,0,0,322
64341407,57,113,67,56,28,11,4,1,337
64341408,73,106,77,59,24,5,3,0,347
64341501,48,63,30,25,11,1,1,1,180
64341502,85,115,55,34,6,3,0,0,298
64341503,66,66,27,13,3,2,0,0,177
64341504,40,67,51,51,7,2,0,0,218
64341505,49,68,53,44,11,9,1,0,235
64341506,50,60,47,32,9,1,0,1,200
64341507,72,91,48,18,8,7,0,2,246
64341508,75,69,60,40,5,0,0,0,249
64341509,46,65,26,33,11,6,2,0,189
64341510,46,62,37,22,7,3,1,0,178
64341511,60,52,31,21,7,1,1,0,173
64341512,42,63,30,9,5,1,0,0,150
64341513,63,111,74,61,21,7,1,0,338
64341514,55,65,48,48,20,5,1,2,244
64341515,57,84,77,50,23,5,1,0,297
64341601,55,97,76,49,16,13,7,4,317
64341602,55,75,67,55,23,4,4,1,284
64341603,65,87,66,53,21,7,1,0,300
64341604,58,75,50,28,11,1,0,1,224
64341605,49,69,37,27,13,1,0,0,196
64341606,32,51,40,36,16,4,0,0,179
64341607,58,76,59,47,10,3,1,0,254
64341608,30,54,48,41,15,2,2,1,193
64341609,65,98,66,77,28,2,1,2,339
64341610,71,101,85,76,33,8,2,2,378
64341611,72,89,65,59,25,5,1,4,320
64341612,93,134,93,59,33,13,3,2,430
64341613,67,105,79,85,30,8,4,2,380
64341701,46,86,62,43,24,4,2,1,268
64341702,67,94,66,67,21,8,2,3,328
64341703,77,102,72,66,21,9,3,2,352
64341704,57,95,64,50,21,8,1,1,297
64341705,63,95,58,57,20,3,2,0,298
64341706,33,58,40,43,18,3,2,1,198
64341707,30,51,35,26,11,6,1,0,160
64341708,63,80,58,41,16,10,0,2,270
64341709,62,78,46,38,14,10,0,2,250
64341710,33,45,20,22,6,5,0,0,131
64341711,42,82,60,57,20,3,1,0,265
64341801,61,118,89,55,19,11,4,0,357
64341802,52,69,50,59,16,5,1,0,252
64341803,76,117,77,76,32,14,1,3,396
64341804,34,66,55,46,14,4,0,0,219
64341805,70,95,65,56,19,9,0,3,317
64341806,115,126,69,53,17,2,1,1,384
64341807,48,65,34,26,7,3,1,0,184
64341808,81,81,46,40,7,5,1,0,261
64341809,56,65,44,29,3,0,1,0,198
64341810,65,55,26,13,6,1,1,0,167
64341811,64,71,37,18,5,0,0,0,195
64341812,44,75,35,29,14,1,0,1,199
64341813,69,92,70,48,19,3,1,0,302
64341814,32,36,28,13,4,0,0,0,113
64341901,73,86,59,77,29,14,2,1,341
64341902,61,116,76,73,29,6,4,2,367
64341903,68,95,82,56,34,17,2,3,357
64341904,57,90,69,59,29,9,0,0,313
64341905,59,96,81,77,25,7,9,0,354
64341906,59,75,82,62,32,9,4,2,325
64341907,59,102,70,54,18,7,3,2,315
64341908,45,59,45,51,26,4,3,1,234
64341909,57,91,57,50,18,5,1,0,279
64342001,48,77,64,36,18,4,9,0,256
64342002,51,85,73,80,28,12,6,2,337
64342003,70,93,88,76,36,8,2,8,381
64342004,47,58,43,41,14,2,0,1,206
64342005,74,89,66,60,16,10,2,1,318
64342006,75,108,94,70,33,16,7,3,406
64342007,41,67,45,55,22,4,3,3,240
64342008,65,102,72,53,31,14,2,3,342
64342009,57,77,72,54,16,13,1,2,292
64342010,58,82,69,45,32,7,0,2,295
64342101,67,89,81,75,17,10,2,3,344
64342102,50,66,49,53,21,8,3,2,252
64342103,65,77,48,50,18,10,0,1,269
64342104,29,51,40,35,21,8,0,3,187
64342105,42,66,60,40,30,8,1,2,249
64342106,32,53,41,43,26,8,3,2,208
64342107,41,48,33,47,19,7,1,1,197
64342108,31,75,53,54,28,10,0,1,252
64342109,47,57,45,31,18,10,4,1,213
64342110,37,53,44,34,10,10,4,1,193
64342111,43,56,49,37,14,8,2,1,210
64342112,62,80,64,50,35,14,3,5,313
64342113,63,96,64,65,25,9,5,5,332
64342201,44,60,64,61,33,27,4,8,301
64342202,48,52,89,51,25,23,9,6,303
64342203,19,50,48,29,18,14,9,3,190
64342204,41,58,75,64,35,17,12,9,311
64342205,52,59,49,36,27,25,5,7,260
64342206,44,64,73,71,44,14,0,4,314
64342207,33,56,58,33,29,15,3,5,232
64342208,43,75,63,56,29,26,10,11,313
64342209,37,63,56,60,57,33,15,19,340
64342210,78,124,109,93,42,23,9,9,487
64342211,59,68,65,72,19,12,5,5,305
64342212,56,90,65,48,31,17,1,3,311
64342213,76,96,87,68,38,16,5,2,388
64342214,51,93,59,55,35,13,6,1,313
64342301,68,82,75,72,34,24,10,6,371
64342302,40,63,48,55,36,24,6,12,284
64342303,52,71,69,65,49,29,17,15,367
64342304,63,92,91,85,54,33,10,10,438
64342305,59,84,68,70,49,38,13,13,394
64342306,51,83,90,76,57,40,9,9,415
64342307,40,42,27,39,19,15,7,2,191
64342308,52,63,61,67,48,41,7,19,358
64342309,33,52,46,62,30,31,3,10,267
64342310,24,53,57,59,25,23,8,8,257
64342311,67,63,78,76,53,31,10,15,393
64342312,42,66,64,47,39,19,7,6,290
64342313,3,3,3,3,1,0,0,1,14
64342314,26,38,33,46,37,28,12,15,235
64342315,47,63,57,63,38,33,11,5,317
64342401,34,49,51,46,31,14,4,10,239
64342402,36,50,52,32,18,11,2,0,201
64342403,118,41,25,32,19,3,0,4,242
64342404,37,58,49,55,16,10,2,4,231
64342405,61,68,55,40,18,8,4,7,261
64342406,45,62,63,37,19,12,6,0,244
64342407,40,52,59,42,17,9,4,5,228
64342408,64,83,87,78,37,27,11,14,401
64342409,46,64,64,63,32,5,5,1,280
64342410,50,87,51,58,20,13,2,2,283
64342501,58,90,84,80,46,17,8,11,394
64342502,35,57,39,43,19,9,3,2,207
64342503,27,52,33,43,14,8,0,2,179
64342504,27,43,44,47,25,5,3,3,197
64342505,30,56,41,58,29,13,4,2,233
64342506,22,40,44,58,41,30,8,4,247
64342507,27,44,66,60,34,24,14,14,283
64342508,52,74,71,71,30,19,7,5,329
64342509,29,60,53,40,24,12,3,4,225
64342510,29,70,44,55,33,21,3,2,257
64342511,51,72,59,48,41,11,5,7,294
64342512,32,50,59,45,23,11,3,2,225
64342513,39,60,58,50,31,12,9,6,265
64342514,39,62,54,54,21,14,2,3,249
64342515,28,50,54,45,17,14,2,4,214
64342516,45,79,69,62,38,16,7,7,323
64342517,44,49,64,42,36,13,1,4,253
64342518,29,37,41,47,20,14,4,3,195
64342601,37,72,67,49,49,41,16,22,353
64342602,41,30,36,34,19,16,9,8,193
64342603,101,65,86,75,54,36,8,13,438
64342604,44,54,61,74,50,43,10,25,361
64342605,12,12,17,27,20,13,6,12,119
64342606,18,19,18,23,19,16,8,7,128
64342607,17,32,43,36,25,19,3,11,186
64342608,26,46,56,49,31,34,18,17,277
64342609,18,39,55,45,28,11,9,15,220
64342610,43,50,63,73,55,31,10,18,343
64342611,23,32,50,40,29,17,8,15,214
64342612,20,52,50,37,28,14,6,13,220
64342613,51,46,79,80,46,33,11,15,361
64342614,26,44,69,84,40,29,10,20,322
64342615,34,28,48,42,21,14,4,4,195
64342616,31,36,58,60,39,17,8,13,262
64342617,33,53,61,55,41,28,6,16,293
64342618,46,49,64,67,54,37,10,15,342
64342619,37,72,75,71,51,35,15,12,368
64342701,50,80,68,55,27,8,3,4,295
64342702,56,85,68,55,30,14,5,3,316
64342703,79,125,92,84,32,12,3,6,433
64342704,50,59,59,48,25,25,5,4,275
64342705,28,47,52,37,13,11,1,1,190
64342706,57,77,73,65,30,23,3,4,332
64342707,46,70,44,63,26,19,7,8,283
64342708,44,66,62,62,29,11,6,0,280
64342709,76,88,74,74,33,17,2,8,372
64342710,54,74,97,81,56,33,11,17,423
64342801,43,83,78,87,43,18,4,6,362
64342802,57,78,85,69,59,28,10,6,392
64342803,66,87,98,90,51,29,11,14,446
64342804,48,67,67,61,31,17,8,9,308
64342805,41,61,65,58,24,14,4,4,271
64342806,68,90,88,40,43,18,7,4,358
64342807,35,64,62,48,30,15,4,2,260
64342808,73,124,96,76,68,25,8,9,479
64342809,63,122,107,76,38,21,1,2,430
64342810,62,111,83,61,33,19,8,8,385
64342811,43,56,50,46,16,9,3,7,230
64342812,33,54,45,66,25,13,1,1,238
64342813,41,56,54,54,17,7,4,1,234
64342814,38,63,66,53,32,20,3,8,283
64342901,75,81,86,69,29,10,6,1,357
64342902,63,102,80,82,34,12,6,5,384
64342903,62,86,66,61,22,14,3,1,315
64342904,63,83,65,58,19,12,2,3,305
64342905,46,83,65,63,24,5,1,1,288
64342906,69,74,62,56,16,10,5,1,293
64342907,54,98,71,68,33,13,3,0,340
64342908,51,68,58,62,30,13,0,3,285
64342909,57,96,84,62,29,19,2,1,350
64342910,24,45,39,40,21,11,2,4,186
64342911,33,52,47,43,14,4,2,2,197
64343001,43,69,59,48,20,8,2,3,252
64343002,37,62,52,44,18,5,3,1,222
64343003,57,85,58,62,18,3,2,4,289
64343004,70,73,69,77,25,8,3,1,326
64343005,66,89,66,56,24,10,2,3,316
64343006,63,83,88,59,27,7,0,2,329
64343007,55,102,89,56,33,11,1,0,347
64343008,48,73,60,34,15,6,4,0,240
64343009,56,86,57,60,31,12,3,2,307
64343101,57,100,87,82,30,9,0,2,367
64343102,45,53,43,34,24,10,1,1,211
64343103,71,68,63,45,10,9,1,1,268
64343104,40,64,46,40,16,8,1,1,216
64343105,87,140,79,47,19,6,0,0,378
64343106,110,92,44,38,9,0,0,0,293
64343107,49,66,30,31,7,1,0,1,185
64343108,46,68,36,22,8,2,1,0,183
64343109,87,78,46,20,4,2,0,0,237
64343110,45,78,23,20,6,0,1,0,173
64343111,53,71,41,18,6,2,0,0,191
64343112,82,69,52,28,6,1,0,0,238
64343113,94,114,57,27,3,2,0,0,297
64343114,105,89,47,24,5,0,1,0,271
64343115,36,43,33,19,4,5,0,0,140
64343201,94,111,74,44,12,1,1,0,337
64343202,91,115,58,39,10,2,0,0,315
64343203,65,81,31,32,5,0,1,0,215
64343204,53,50,30,15,2,1,0,0,151
64343205,50,67,27,30,6,2,0,2,184
64343206,31,48,43,29,7,3,0,0,161
64343207,62,103,71,60,22,3,1,1,323
64343208,47,77,66,51,24,7,1,0,273
64343209,71,99,69,71,28,6,3,2,349
64343210,66,104,61,64,27,7,2,3,334
64343211,40,72,63,49,21,2,0,1,248
64343212,54,70,51,42,18,2,0,1,238
64343213,76,88,68,45,11,4,2,0,294
64343301,59,66,65,47,24,16,5,3,285
64343302,76,100,77,59,34,12,7,3,368
64343303,64,97,77,65,24,13,2,3,345
64343304,46,64,52,47,16,8,3,1,237
64343305,66,90,74,65,24,3,1,1,324
64343306,53,84,73,69,24,12,6,4,325
64343307,60,83,79,64,27,7,1,5,326
64343308,52,77,44,42,25,7,0,1,248
64343401,53,92,72,67,25,12,4,4,329
64343402,71,98,87,67,37,11,4,1,376
64343403,33,79,70,59,22,11,4,5,283
64343404,29,64,55,45,22,11,2,1,229
64343405,35,56,46,49,23,9,6,1,225
64343406,37,72,62,49,19,13,4,4,260
64343407,43,70,67,54,27,8,1,4,274
64343408,47,60,39,51,13,15,2,1,228
64343409,50,46,46,38,18,7,3,0,208
64343410,50,90,72,74,37,15,3,5,346
64343411,84,75,65,51,39,22,4,7,347
64343412,76,111,99,91,63,27,9,16,492
64343413,57,79,84,69,33,18,2,5,347
64343414,40,44,65,56,43,35,11,15,309
64343501,68,91,92,74,26,15,2,3,371
64343502,39,64,45,33,11,7,1,1,201
64343503,23,53,40,33,16,9,1,2,177
64343504,70,83,78,91,50,38,8,11,429
64343505,25,41,34,20,17,4,2,2,145
64343506,56,70,53,58,28,11,4,5,285
64343507,47,68,47,47,27,17,6,6,265
64343508,62,80,67,94,48,44,10,15,420
64343509,56,74,54,52,30,11,4,4,285
64343510,42,48,62,53,38,26,9,16,294
64343511,70,60,55,65,38,36,4,6,334
64343512,14,36,32,37,16,15,4,10,164
64343513,46,70,64,56,36,16,3,11,302
64343601,72,99,77,63,30,17,6,2,366
64343602,75,102,82,82,28,16,5,1,391
64343603,49,90,73,66,31,13,1,2,325
64343604,61,94,72,60,22,11,1,4,325
64343605,51,79,66,42,29,14,4,3,288
64343606,47,98,76,70,32,14,2,3,342
64343607,47,70,67,35,20,7,3,2,251
64343608,59,64,55,53,15,6,0,1,253
64343701,40,56,54,41,14,6,5,3,219
64343702,75,71,79,47,16,5,1,1,295
64343703,40,67,61,34,20,7,3,1,233
64343704,50,95,62,51,33,7,4,1,303
64343705,55,87,78,61,22,12,3,2,320
64343706,76,94,61,68,24,11,0,2,336
64343707,49,90,62,56,22,14,2,0,295
64343708,39,64,65,45,16,4,1,1,235
64343801,33,48,38,33,8,6,1,1,168
64343802,59,91,60,65,20,9,1,3,308
64343803,88,114,70,37,20,4,1,1,335
64343804,108,92,78,38,15,6,1,1,339
64343805,85,92,50,32,6,0,1,1,267
64343806,70,96,69,49,23,11,1,1,320
64343807,65,86,27,28,8,2,1,0,217
64343808,79,107,66,55,18,9,0,0,334
64343809,56,78,55,36,19,6,1,1,252
64343901,54,89,65,44,15,2,2,0,271
64343902,38,68,43,51,19,3,1,0,223
64343903,61,83,52,37,21,9,6,1,270
64343904,54,63,45,38,21,7,0,0,228
64343905,67,87,58,63,27,6,2,0,310
64343906,52,86,58,58,21,5,1,0,281
64343907,53,79,69,39,26,9,3,1,279
64343908,43,54,33,25,13,5,1,1,175
64343909,27,41,43,52,34,15,9,19,240
64344001,48,91,80,69,38,13,8,1,348
64344002,78,103,70,63,32,14,2,2,364
64344003,42,49,45,40,16,12,2,0,206
64344004,36,44,36,30,6,4,0,2,158
64344005,37,45,52,36,14,7,2,2,195
64344006,38,63,52,34,20,7,3,4,221
64344007,57,66,47,31,14,10,1,2,228
64344008,90,117,77,55,23,5,2,3,372
64344101,33,76,69,53,22,7,2,1,263
64344102,48,87,49,45,21,9,4,4,267
64344103,86,111,88,71,16,13,3,4,392
64344104,48,75,74,62,35,16,3,8,321
64344105,46,81,69,68,31,5,1,5,306
64344106,42,62,74,62,40,18,9,9,316
64344107,22,44,49,32,16,11,2,2,178
64344108,52,108,73,59,30,10,4,3,339
64344201,45,73,67,62,33,32,8,10,330
64344202,55,81,83,70,25,20,5,4,343
64344203,36,61,40,44,15,5,3,2,206
64344204,56,77,56,41,26,14,4,10,284
64344205,43,63,55,54,28,9,4,5,261
64344206,43,62,60,41,38,14,6,9,273
64344207,49,62,57,50,25,10,4,4,261
64344208,48,73,53,51,27,12,5,1,270
64344301,72,100,81,74,28,11,2,4,372
64344302,45,60,75,48,28,6,1,4,267
64344303,74,119,81,72,16,12,6,2,382
64344304,77,78,59,50,31,10,0,1,306
64344305,43,67,62,38,19,7,4,4,244
64344306,42,90,64,51,31,7,4,1,290
64344307,44,57,56,62,25,10,4,3,261
64344308,37,64,55,40,25,8,2,0,231
64344401,21,37,24,28,22,17,4,3,156
64344402,44,67,60,46,34,16,4,5,276
64344403,44,57,57,72,25,11,1,4,271
64344404,22,39,42,42,16,12,5,4,182
64344405,24,37,58,74,38,32,15,19,297
64344406,54,71,98,80,72,48,15,25,463
64344407,73,113,106,90,36,24,8,6,456
64344408,36,62,35,52,25,8,5,1,224
64344409,41,61,37,36,17,11,3,1,207
64344410,36,84,63,51,31,6,3,2,276
64344411,45,60,66,52,20,11,2,1,257
64344412,61,110,77,70,36,13,4,7,378
64344501,37,98,71,66,37,14,3,9,335
64344502,45,93,105,126,52,42,9,13,485
64344503,27,43,63,58,43,36,10,15,295
64344504,49,58,62,74,33,25,6,13,320
64344505,54,87,67,70,47,27,9,11,372
64344506,33,32,51,45,23,27,10,5,226
64344507,29,47,68,62,51,24,9,20,310
64344508,53,73,75,69,44,34,7,10,365
64344509,34,48,59,53,16,21,3,12,246
64344510,41,52,40,47,29,23,5,12,249
64344511,73,77,79,76,38,14,3,3,363
64344512,66,115,113,86,59,30,11,9,489
64900101,28,34,26,40,22,10,7,29,196
64900102,58,63,38,88,9,26,2,22,306
64900103,57,28,29,24,15,31,3,15,202
64900104,45,40,30,50,16,23,4,23,231
64900105,56,41,34,48,21,22,6,30,258
64900106,57,36,30,42,12,24,3,18,222
64900107,54,41,35,46,11,25,2,15,229
64900108,26,34,31,41,31,7,10,27,207
64900109,29,46,47,49,40,18,10,4,243
64900110,36,30,22,38,7,22,1,10,166
64900111,33,41,37,47,30,18,9,21,236
64900112,35,51,48,68,36,21,13,14,286
64900113,23,25,22,32,13,14,6,12,147
64900114,27,36,36,38,38,7,10,22,214
64900201,53,84,75,93,78,39,12,24,458
64900202,79,77,93,111,70,60,15,29,534
64900203,37,42,82,70,53,50,7,15,356
64900204,45,57,63,61,52,28,5,17,328
64900205,48,75,62,83,60,23,5,16,372
64900206,47,64,80,77,52,30,14,12,376
64900207,40,61,103,67,68,60,19,23,441
64900208,68,98,124,90,79,54,17,19,549
64900209,61,81,100,79,71,36,10,17,455
64900210,44,66,77,65,49,36,16,15,368
64900301,50,66,73,63,36,35,9,10,342
64900302,56,71,86,71,51,35,9,11,390
64900303,38,69,46,60,23,26,7,8,277
64900304,23,15,34,27,19,10,1,5,134
64900305,30,35,36,34,21,15,3,5,179
64900306,35,90,90,84,53,32,7,15,406
64900307,42,63,54,49,33,18,9,6,274
64900308,22,55,59,40,25,21,8,6,236
64900309,42,97,71,62,42,19,10,9,352
64900310,69,82,79,92,77,53,17,34,503
64900311,48,28,25,20,19,8,5,6,159
64900312,40,66,65,51,45,28,5,15,315
64900313,70,76,69,50,41,22,2,12,342
64900401,46,94,88,93,45,30,8,7,411
64900402,33,67,51,72,43,36,7,9,318
64900403,30,42,74,49,35,30,11,10,281
64900404,26,35,43,47,45,26,8,16,246
64900405,42,40,78,83,34,34,21,12,344
64900406,37,66,61,71,46,32,14,21,348
64900407,41,70,94,75,64,40,12,18,414
64900408,35,56,73,57,56,46,9,13,345
64900409,22,30,26,36,32,33,13,16,208
64900410,38,56,56,51,48,25,11,16,301
64900411,62,80,86,101,57,37,9,9,441
64900412,23,38,47,40,33,25,11,5,222
64900413,37,54,53,48,43,33,5,10,283
64900414,58,105,100,100,65,45,12,9,494
64900501,25,53,41,57,33,30,9,16,264
64900502,63,61,82,66,53,43,5,6,379
64900503,58,72,55,51,31,10,4,5,286
64900504,24,50,56,55,37,12,6,2,242
64900505,64,46,48,36,23,23,4,1,245
64900506,32,70,64,47,42,31,10,4,300
64900507,45,67,60,61,32,12,5,3,285
64900508,59,92,93,88,43,27,12,13,427
64900509,22,58,55,59,36,16,8,5,259
64900510,57,91,116,85,47,40,6,16,458
64900511,44,78,68,67,34,23,8,7,329
64900512,54,109,87,90,64,37,5,8,454
64900513,12,45,56,50,24,13,4,5,209
64900514,28,59,71,82,43,23,5,9,320
64900515,52,88,90,109,65,32,10,17,463
64900516,99,95,122,102,67,38,9,7,539
64900601,37,74,50,43,25,15,8,0,252
64900602,66,99,82,74,29,10,4,4,368
64900603,53,59,53,48,24,12,1,0,250
64900604,48,96,74,79,28,13,2,3,343
64900605,40,52,53,40,20,14,2,1,222
64900606,36,58,59,33,14,4,4,2,210
64900607,49,80,68,79,29,17,7,3,332
64900608,44,76,90,80,39,23,8,6,366
64900609,36,52,63,48,23,15,5,4,246
64900610,34,61,50,40,21,18,1,3,228
64900611,62,74,66,50,24,6,2,0,284
64900612,92,91,84,48,19,1,2,0,337
64900613,79,143,76,57,19,6,1,0,381
64900614,57,76,76,87,39,13,3,4,355
64900615,32,60,78,88,38,9,1,2,308
64900701,33,57,57,41,30,12,4,8,242
64900702,37,54,65,53,28,20,10,7,274
64900703,54,94,78,64,50,24,6,11,381
64900704,39,54,54,46,31,19,7,10,260
64900705,63,88,65,82,30,20,7,6,361
64900706,49,90,76,63,32,23,7,8,348
64900707,26,49,62,55,43,33,9,16,293
64900708,52,54,43,36,18,12,2,2,219
64900709,30,49,54,40,24,12,4,5,218
64900710,45,76,73,52,27,23,5,7,308
64900711,31,49,36,38,22,22,5,8,211
64900712,53,80,84,67,39,21,7,0,351
64900713,44,78,56,38,18,9,4,0,247
64900714,43,72,52,47,21,15,7,5,262
64900715,44,56,73,69,32,16,5,6,301
64900801,51,60,57,43,15,11,3,3,243
64900802,43,74,46,41,21,8,2,3,238
64900803,65,120,81,103,22,11,4,2,408
64900804,29,41,52,38,10,2,1,2,175
64900805,34,48,31,22,15,5,1,1,157
64900806,62,73,35,33,8,8,1,2,222
64900807,46,77,30,31,9,0,0,0,193
64900808,58,113,78,83,21,3,1,0,357
64900809,81,97,87,74,33,8,4,1,385
64900901,59,108,82,69,33,11,2,5,369
64900902,62,75,60,66,23,7,1,1,295
64900903,37,54,40,45,15,7,4,3,205
64900904,25,51,39,40,15,7,2,3,182
64900905,71,116,74,85,28,14,2,2,392
64900906,76,96,71,67,28,7,0,2,347
64900907,42,67,56,56,21,7,1,1,251
64900908,47,77,55,58,19,4,2,0,262
64900909,45,72,40,35,16,5,2,0,215
64901001,36,66,50,46,26,4,4,1,233
64901002,58,133,85,64,37,8,1,2,388
64901003,42,98,72,62,19,3,3,1,300
64901004,84,97,63,78,20,7,2,0,351
64901005,71,108,74,72,22,5,2,0,354
64901006,48,62,46,39,13,1,1,0,210
64901007,38,56,42,38,25,7,1,0,207
64901008,50,90,68,61,21,2,0,0,292
64901009,42,72,51,51,27,8,4,8,263
64901010,50,97,62,69,23,16,0,0,317
64901011,82,114,86,71,34,7,1,1,396
64901012,56,87,74,55,32,6,0,0,310
64901013,71,86,74,63,29,7,1,0,331
64901014,34,63,57,58,18,10,3,0,243
64901015,47,75,48,52,24,10,2,0,258
64901101,42,45,36,33,13,3,1,0,173
64901102,52,102,47,53,24,5,2,2,287
64901103,70,100,59,58,12,6,0,0,305
64901104,67,95,68,56,18,10,1,0,315
64901105,107,94,67,58,18,7,1,0,352
64901106,58,55,30,22,6,1,0,0,172
64901107,79,58,28,14,5,1,0,0,185
64901108,68,63,21,14,3,0,0,0,169
64901109,75,78,33,19,3,1,0,1,210
64901110,83,68,39,17,6,0,2,1,216
64901111,71,53,29,18,5,5,2,1,184
64901112,91,84,33,20,9,1,0,1,239
64901113,60,101,51,53,26,5,0,0,296
64901114,73,75,77,59,17,8,4,2,315
64901115,45,79,48,44,8,5,0,0,229
64901116,85,125,71,51,18,7,0,0,357
64901117,104,109,56,37,18,5,1,0,330
64901118,49,68,65,44,18,7,1,0,252
64901201,67,78,58,50,25,4,1,1,284
64901202,78,112,90,72,27,8,1,1,389
64901203,78,107,64,62,21,8,0,1,341
64901204,40,44,48,41,12,2,2,0,189
64901205,42,67,38,35,13,2,1,0,198
64901206,75,106,72,69,23,5,2,2,354
64901207,62,101,76,54,22,10,3,1,329
64901208,44,95,71,54,20,7,2,0,293
64901209,57,90,62,68,28,7,0,2,314
64901210,56,102,69,70,23,8,3,1,332
64901301,79,102,96,62,27,11,0,4,381
64901302,46,105,77,76,30,12,4,0,350
64901303,59,82,77,60,23,14,2,3,320
64901304,42,65,45,36,23,6,1,1,219
64901305,39,68,41,38,19,14,7,3,229
64901306,67,83,63,69,40,22,6,8,358
64901307,42,71,61,49,15,3,1,1,243
64901308,41,92,59,46,26,6,3,3,276
64901309,57,94,74,97,41,26,1,4,394
64901310,61,94,80,66,50,29,6,7,393
64901311,60,97,64,81,43,24,2,8,379
64901312,53,65,69,67,37,18,1,5,315
64901313,60,71,60,59,35,23,3,5,316
64901314,57,65,78,67,43,43,8,8,369
64901315,69,99,100,89,50,29,10,10,456
64901401,40,74,77,58,34,16,6,7,312
64901402,54,73,73,78,34,13,7,9,341
64901403,19,54,47,38,32,14,2,6,212
64901404,37,45,58,48,31,18,3,2,242
64901405,28,74,54,64,36,15,9,6,286
64901406,32,51,52,41,29,17,4,0,226
64901407,47,88,62,43,36,6,0,1,283
64901408,43,48,62,53,31,10,3,3,253
64901409,60,52,50,45,22,20,6,3,258
64901410,52,79,74,75,34,24,11,9,358
64901411,39,66,60,70,44,19,11,10,319
64901412,51,82,76,93,44,46,9,17,418
64901501,24,48,70,57,47,27,8,9,290
64901502,26,57,69,63,48,24,2,7,296
64901503,35,47,45,51,26,26,8,7,245
64901504,33,52,50,59,24,30,10,10,268
64901505,53,59,50,65,25,35,16,9,312
64901506,21,25,29,33,22,20,12,7,169
64901507,33,44,44,50,25,24,10,7,237
64901508,25,36,45,42,36,22,11,12,229
64901509,21,26,33,39,22,20,10,7,178
64901510,34,58,60,55,38,26,9,9,289
64901511,30,59,68,70,52,30,14,12,335
64901601,42,86,99,98,45,32,6,12,420
64901602,21,39,62,43,20,6,6,1,198
64901603,34,68,76,65,44,17,9,14,327
64901604,19,40,38,37,24,11,3,2,174
64901605,52,85,75,75,31,19,8,11,356
64901606,48,56,38,40,38,33,4,0,257
64901607,44,67,58,61,22,13,1,2,268
64901608,47,88,69,49,38,22,2,3,318
64901609,54,91,76,66,40,23,1,4,355
64901701,76,84,76,68,31,40,6,7,388
64901702,43,49,69,72,45,55,12,8,353
64901703,28,43,43,46,37,28,13,16,254
64901704,54,89,64,75,53,32,11,7,385
64901705,50,92,97,64,43,27,11,15,399
64901706,54,85,80,79,44,34,9,13,398
64901707,60,92,103,71,36,18,5,10,395
64901708,54,98,79,92,51,25,14,15,428
64901709,46,59,66,62,28,19,8,9,297
64901801,66,104,78,78,38,22,5,2,393
64901802,54,83,82,62,19,17,4,1,322
64901803,64,111,70,75,26,11,3,5,365
64901804,78,100,94,73,39,10,7,3,404
64901805,34,67,43,44,21,11,1,1,222
64901806,20,42,57,42,34,7,6,3,211
64901807,47,62,72,73,36,20,12,10,332
64901808,56,77,92,75,32,18,2,0,352
64901809,66,83,67,65,42,19,7,5,354
64901810,41,50,77,60,33,26,9,4,300
64901811,61,62,78,72,42,16,7,11,349
64901812,62,92,90,90,43,20,6,10,413
64901813,64,93,100,103,51,19,8,4,442
64901814,65,99,94,77,50,30,7,10,432
64901815,58,93,114,101,54,38,11,10,479
64901816,48,53,64,53,39,27,8,7,299
64901901,54,107,68,72,24,9,2,5,341
64901902,52,91,65,57,19,11,2,1,298
64901903,43,70,58,46,15,7,3,3,245
64901904,37,61,47,49,15,7,0,1,217
64901905,54,82,65,43,22,11,0,1,278
64901906,63,76,73,54,19,7,3,1,296
64901907,79,105,75,78,24,12,7,1,381
64901908,39,69,51,57,26,9,1,1,253
64901909,27,58,34,32,11,3,2,1,168
64901910,54,98,78,66,25,14,2,0,337
64901911,38,63,57,40,25,8,1,3,235
64901912,37,55,45,34,19,7,2,1,200
64902001,47,91,66,72,26,4,0,2,308
64902002,48,72,56,67,24,11,4,1,283
64902003,46,81,78,81,38,10,1,1,336
64902004,38,65,43,46,16,6,1,0,215
64902005,59,88,61,50,22,13,1,0,294
64902006,49,83,54,62,29,11,2,3,293
64902007,84,87,77,79,28,13,4,4,376
64902008,49,77,45,44,23,5,2,2,247
64902009,29,49,58,36,24,12,2,0,210
64902101,86,118,80,74,22,7,1,2,390
64902102,57,115,61,66,29,15,3,0,346
64902103,73,107,75,61,26,9,1,1,353
64902104,41,81,53,40,21,8,1,2,247
64902105,83,90,75,62,21,5,0,1,337
64902106,70,88,65,61,20,6,0,0,310
64902107,90,102,47,53,17,3,1,0,313
64902108,50,46,26,24,9,0,0,0,155
64902109,44,66,45,45,11,2,0,0,213
64902110,90,109,76,44,15,2,0,1,337
64902201,44,83,51,53,25,7,1,1,265
64902202,58,75,41,28,15,7,1,0,225
64902203,94,92,34,27,8,0,1,0,256
64902204,110,62,20,10,1,1,0,0,204
64902205,94,84,27,11,4,2,0,1,223
64902206,121,104,30,13,0,0,0,0,268
64902207,80,58,22,9,4,0,0,0,173
64902208,37,38,16,9,0,1,1,0,102
64902209,85,61,28,17,5,1,0,0,197
64902210,144,144,59,26,3,2,0,0,378
64902211,91,77,45,20,3,1,0,0,237
64902212,16,22,5,1,1,1,0,0,46
64902301,44,84,63,65,17,10,3,0,286
64902302,52,77,47,41,18,4,1,0,240
64902303,64,96,63,48,19,10,3,0,303
64902304,53,75,63,49,16,6,1,3,266
64902305,56,80,56,51,17,4,1,0,265
64902306,62,92,52,57,22,10,1,0,296
64902307,49,83,40,40,14,5,2,1,234
64902308,41,49,15,5,2,0,0,0,112
64902309,81,86,44,34,8,1,0,1,255
64902310,38,47,34,25,17,8,0,0,169
64902311,57,72,37,23,9,0,0,0,198
64902312,88,65,30,18,8,0,0,0,209
64902313,58,56,29,24,7,1,0,0,175
64902401,48,67,61,62,16,7,2,2,265
64902402,87,112,77,45,19,5,0,0,345
64902403,59,55,33,33,11,7,1,0,199
64902404,124,131,74,31,10,6,3,0,379
64902405,78,75,60,44,14,7,1,2,281
64902406,45,85,60,42,20,7,0,0,259
64902407,85,58,27,25,13,3,0,0,211
64902408,72,70,32,7,1,1,0,0,183
64902409,62,70,19,9,0,1,0,0,161
64902410,89,86,46,15,6,1,1,0,244
64902411,88,82,19,7,1,1,0,1,199
64902501,51,88,73,67,26,14,1,3,323
64902502,55,86,67,48,28,5,1,0,290
64902503,58,73,59,56,17,11,3,1,278
64902504,57,81,57,45,19,8,1,1,269
64902505,59,73,50,43,15,9,0,1,250
64902506,50,82,51,73,19,10,2,1,288
64902507,47,97,60,52,20,5,1,1,283
64902508,61,90,79,77,24,7,3,5,346
64902601,68,79,73,58,29,7,2,0,316
64902602,49,80,58,40,27,10,1,0,265
64902603,61,95,70,59,21,14,2,4,326
64902604,29,58,24,29,13,5,1,1,160
64902605,49,75,51,35,20,3,2,1,236
64902606,61,98,67,64,29,5,1,2,327
64902607,51,79,84,90,34,19,2,2,361
64902608,44,65,58,49,15,10,3,0,244
64902609,33,42,34,29,14,2,2,1,157
64902610,60,109,90,71,32,14,2,0,378
64902611,53,79,56,58,17,13,2,0,278
64902612,54,96,52,49,28,8,1,2,290
64902613,55,94,66,62,26,4,2,0,309
64902701,45,95,68,58,20,13,0,2,301
64902702,62,99,113,77,32,19,12,7,421
64902703,57,99,80,61,26,9,0,2,334
64902704,57,73,58,46,22,3,1,2,262
64902705,70,106,78,84,51,21,4,8,422
64902706,46,96,85,58,21,10,2,1,319
64902707,58,83,67,67,18,15,3,0,311
64902708,49,87,68,54,36,6,8,3,311
64902709,47,95,59,76,10,7,0,6,300
64902710,103,135,92,104,29,12,7,10,492
64902711,67,102,117,105,50,29,6,2,478
64902712,68,90,94,87,41,25,8,6,419
64902713,34,36,43,36,17,7,4,5,182
64902801,36,64,78,58,29,22,7,3,297
64902802,40,55,46,40,29,14,1,2,227
64902803,94,102,90,73,28,13,4,3,407
64902804,80,89,100,84,47,21,11,12,444
64902805,55,84,76,61,23,11,1,3,314
64902806,79,101,114,70,28,12,3,6,413
64902807,46,68,38,58,19,7,2,3,241
64902808,45,62,32,42,14,9,2,3,209
64902809,29,42,44,39,22,9,2,2,189
64902810,63,98,86,75,37,29,9,10,407
64902811,65,95,62,62,23,6,0,0,313
64902901,54,60,71,82,49,38,9,9,372
64902902,63,119,93,107,61,25,6,7,481
64902903,37,59,67,45,41,30,8,17,304
64902904,38,83,65,66,54,40,7,6,359
64902905,45,54,66,63,45,35,11,16,335
64902906,38,50,63,71,60,40,18,38,378
64902907,59,83,83,86,57,31,15,10,424
64902908,57,129,123,92,32,35,9,7,484
64902909,58,103,100,85,42,22,11,9,430
64902910,47,67,83,85,52,24,2,1,361
64902911,70,99,110,93,36,25,9,10,452
64903001,38,46,50,71,26,23,10,4,268
64903002,56,96,89,113,82,43,18,26,523
64903003,48,49,56,63,32,16,11,12,287
64903004,37,48,63,61,29,20,9,9,276
64903005,68,104,111,103,55,23,7,7,478
64903006,57,62,64,66,36,25,6,9,325
64903007,39,85,69,58,26,15,6,5,303
64903008,47,91,62,58,23,18,7,10,316
64903009,63,97,79,49,22,18,4,6,338
64903010,59,84,83,73,34,20,2,3,358
64903101,31,41,52,47,38,18,9,10,246
64903102,32,53,60,60,33,19,12,11,280
64903103,51,76,79,85,61,33,18,10,413
64903104,32,54,96,77,64,36,16,17,392
64903105,35,41,74,82,46,39,6,13,336
64903106,84,63,69,77,42,41,10,21,407
64903107,59,58,83,77,56,25,4,15,377
64903108,46,53,71,89,58,62,8,14,401
64903109,41,62,76,67,46,21,5,10,328
64903110,31,65,59,61,38,7,7,7,275
64903201,41,68,85,112,61,57,13,18,455
64903202,27,71,98,96,71,36,11,22,432
64903203,33,54,61,70,57,49,13,21,358
64903204,25,40,67,60,47,37,10,15,301
64903205,18,39,45,53,46,36,7,9,253
64903206,45,103,92,87,86,44,38,10,505
64903207,36,61,73,64,52,27,15,10,338
64903208,47,70,88,85,59,37,16,20,422
64903209,25,43,48,52,33,22,6,9,238
64903210,64,51,63,77,37,26,7,13,338
64903301,29,51,57,38,31,27,2,4,239
64903302,23,43,57,65,47,23,10,15,283
64903303,61,82,93,86,48,38,15,18,441
64903304,27,52,64,55,49,39,6,8,300
64903305,46,106,93,94,65,30,16,24,474
64903306,28,66,86,80,48,25,5,9,347
64903307,18,30,43,46,32,45,3,7,224
64903308,33,53,55,66,49,34,5,9,304
64903309,28,36,74,84,68,33,8,20,351
64903310,40,59,81,86,39,47,8,18,378
64903401,92,149,147,116,77,55,12,17,665
64903402,46,89,87,79,62,43,7,14,427
64903403,35,66,67,68,41,21,12,10,320
64903404,32,71,67,80,42,41,10,21,364
64903405,45,74,107,83,63,48,11,11,442
64903406,29,48,79,61,40,21,9,10,297
64903407,31,51,64,60,39,25,5,12,287
64903408,28,54,49,50,33,26,3,9,252
64903409,21,40,50,63,41,27,17,8,267
64903410,36,60,64,81,56,28,14,14,353
64903411,30,52,72,81,47,42,15,15,354
64903412,42,48,55,69,53,38,12,16,333
64903413,32,56,60,70,63,34,16,28,359
64903414,36,52,77,63,62,46,9,16,361
64903415,27,51,50,58,30,21,9,6,252
64903501,46,43,53,50,26,28,5,8,259
64903502,45,48,57,58,32,16,5,9,270
64903503,64,79,111,89,35,31,14,6,429
64903504,110,88,82,90,52,26,8,6,462
64903505,88,78,73,83,45,26,6,9,408
64903506,111,89,119,89,58,35,9,9,519
64903507,102,71,88,66,43,20,4,9,403
64903508,55,61,92,104,66,44,16,18,456
64903509,35,39,60,53,34,28,9,7,265
64903510,26,38,49,66,43,37,10,19,288
64903511,24,55,51,48,48,29,7,9,271
64903512,17,38,58,60,37,25,7,16,258
64903513,33,64,99,106,57,56,21,25,461
64903514,35,59,101,83,47,39,10,21,395
64903515,20,49,53,54,33,17,8,9,243
64903516,29,54,47,39,34,11,6,4,224
64903517,31,56,80,60,51,26,8,9,321
64903518,47,97,85,74,42,36,7,7,395
64903601,48,75,111,86,51,39,13,23,446
64903602,55,57,79,85,66,43,15,27,427
64903603,27,47,68,55,36,16,13,13,275
64903604,38,43,74,69,40,39,19,15,337
64903605,34,67,69,57,36,26,7,8,304
64903606,39,72,81,76,38,39,7,9,361
64903607,40,47,64,67,50,30,6,11,315
64903608,44,48,75,59,30,28,14,7,305
64903609,57,55,47,61,33,30,5,12,300
64903610,38,89,98,95,52,37,3,14,426
64903611,21,41,60,54,48,34,11,13,282
64903612,32,41,79,70,42,25,10,18,317
64903701,63,66,72,75,41,27,10,13,367
64903702,38,67,71,41,34,25,7,11,294
64903703,42,52,53,44,22,20,6,6,245
64903704,24,62,60,47,20,15,11,13,252
64903705,36,61,63,48,39,16,11,17,291
64903706,57,66,87,63,41,21,11,15,361
64903707,23,38,51,54,36,27,8,14,251
64903708,71,43,39,33,32,23,2,7,250
64903709,63,98,122,99,76,48,25,13,544
64903710,87,77,66,89,56,32,9,8,424
64903711,64,113,118,117,78,38,9,11,548
64903712,46,60,62,63,47,40,9,11,338
64903713,76,98,89,101,48,42,11,17,482
64903714,57,89,119,84,53,31,7,18,458
64903801,24,39,47,48,31,15,6,6,216
64903802,41,61,77,78,57,29,6,14,363
64903803,19,26,30,33,26,23,13,9,179
64903804,20,23,58,46,36,24,6,9,222
64903805,56,64,71,79,51,44,19,21,405
64903806,31,29,60,56,49,44,12,19,300
64903807,36,63,57,73,52,42,11,16,350
64903808,40,82,102,95,69,51,15,28,482
64903809,29,42,63,59,35,34,10,14,286
64903810,37,35,52,63,34,24,15,14,274
64903811,39,67,65,67,57,25,9,25,354
64903812,31,42,53,58,45,20,5,9,263
64903813,28,43,44,43,30,18,5,8,219
64903814,25,32,40,47,30,26,9,12,221
64903815,59,49,30,39,30,12,6,3,228
64903816,82,84,104,80,67,56,21,22,516
64903817,69,74,96,104,82,57,13,25,520
64903901,77,101,63,67,42,29,4,5,388
64903902,16,35,32,33,33,26,4,9,188
64903903,105,136,196,179,129,97,28,28,898
64903904,32,35,63,86,74,63,18,37,408
64903905,55,85,63,98,67,64,21,20,473
64903906,117,62,68,84,58,45,14,24,472
64903907,24,27,49,56,28,22,2,4,212
64903908,36,44,51,55,42,36,6,17,287
64903909,23,33,69,79,47,47,9,21,328
64903910,16,24,45,50,45,36,9,15,240
64903911,54,64,101,93,66,56,16,15,465
64903912,27,41,55,63,40,27,17,17,287
64903913,11,26,38,43,33,31,6,15,203
64903914,46,60,87,84,62,23,14,21,397
64903915,81,84,123,147,90,73,25,17,640
64903916,66,89,85,72,53,19,6,15,405
64904001,13,36,52,54,36,31,10,8,240
64904002,32,35,40,52,37,30,9,15,250
64904003,20,28,66,70,57,44,10,13,308
64904004,37,79,94,94,70,48,16,31,469
64904005,43,41,51,60,43,31,8,14,291
64904006,68,78,121,136,104,63,18,30,618
64904007,23,60,65,73,65,55,13,23,377
64904008,39,59,85,90,63,40,18,29,423
64904009,66,89,120,121,80,53,19,35,583
64904010,43,57,69,82,68,39,18,26,402
64904011,24,55,57,80,43,48,7,8,322
64904012,52,108,97,94,83,56,7,19,516
64904013,34,74,81,85,63,58,21,33,449
64904101,19,5,1,2,0,0,0,0,27
64904102,3,8,6,6,4,3,1,1,32
64904201,46,82,65,54,24,8,2,1,282
64904202,84,89,74,64,28,5,4,3,351
64904203,54,76,64,50,24,7,2,3,280
64904204,58,88,81,59,26,9,4,0,325
64904205,43,73,62,45,19,4,4,4,254
64904206,54,101,76,65,23,7,2,3,331
64904207,51,105,77,63,34,17,5,2,354
64904208,43,94,55,54,25,11,1,2,285
64904301,5,4,2,2,1,1,0,0,15
64904302,65,66,48,41,14,8,1,2,245
64904303,47,77,71,49,26,7,2,1,280
64904304,63,78,70,82,28,11,8,2,342
64904305,1,0,0,1,0,0,0,0,2
64904306,61,59,62,62,33,24,10,4,315
64904307,23,48,49,51,34,27,9,9,250
64904308,17,30,33,36,28,29,10,10,193
64904309,67,97,93,101,47,24,11,5,445
64904310,47,105,81,70,30,15,6,3,357
64904311,47,52,47,42,16,7,1,2,214
64904312,62,74,61,35,31,18,8,5,294
64904313,34,66,64,49,30,24,3,5,275
64904314,39,61,43,42,26,12,1,2,226
64904401,86,63,60,56,21,10,0,4,300
64904402,83,120,82,63,23,9,5,1,386
64904403,37,84,61,43,30,14,7,5,281
64904404,56,92,72,76,38,29,4,11,378
64904405,62,77,84,79,57,36,4,12,411
64904406,61,106,99,71,34,22,8,7,408
64904407,60,107,70,82,28,11,2,1,361
64904408,66,75,76,71,40,17,6,3,354
64904409,49,98,83,85,55,43,14,12,439
64904410,34,55,59,51,34,16,5,2,256
64904411,28,56,41,46,27,18,3,5,224
64904412,31,46,67,44,31,25,9,7,260
64904413,34,48,54,65,42,26,8,9,286
64904501,41,66,56,52,25,12,6,6,264
64904502,79,91,87,68,25,15,3,5,373
64904503,37,66,61,76,49,22,9,5,325
64904504,77,94,86,76,49,17,9,4,412
64904505,57,98,80,75,51,12,7,2,382
64904506,77,85,75,73,29,14,3,8,364
64904507,48,58,37,34,15,4,0,0,196
64904508,47,55,45,54,16,9,4,1,231
64904601,57,90,64,59,21,2,4,0,297
64904602,73,83,44,37,20,4,1,0,262
64904603,47,78,60,54,20,10,3,1,273
64904604,52,87,51,51,28,8,2,2,281
64904605,26,48,28,18,3,2,1,0,126
64904606,35,70,42,27,6,1,1,4,186
64904607,61,79,73,60,17,11,2,1,304
64904608,40,70,56,48,20,9,6,2,251
64904609,57,84,48,61,21,8,6,3,288
64904610,6,7,4,6,2,0,0,0,25
64904611,73,98,68,65,35,8,5,4,356
64904612,46,72,59,47,27,12,1,1,265
64904701,7,16,16,22,4,4,1,1,71
64904702,53,108,59,57,17,14,1,0,309
64904703,37,63,42,44,14,8,1,0,209
64904704,50,74,43,39,20,3,1,0,230
64904705,59,74,75,53,21,7,0,0,289
64904706,63,62,57,45,12,4,2,1,246
64904707,69,93,78,65,29,9,3,0,346
64904708,56,74,58,63,23,13,4,1,292
64904709,46,61,59,45,20,2,4,1,238
64904710,39,58,58,53,28,7,2,2,247
64904711,54,87,65,72,21,6,1,0,306
64904712,57,79,60,40,29,9,3,1,278
64904713,66,75,44,47,17,7,2,1,259
64904801,54,91,46,53,31,10,1,1,287
64904802,35,82,62,57,23,7,3,2,271
64904803,37,80,54,43,25,7,1,1,248
64904804,86,106,71,52,19,8,1,2,345
64904805,35,66,24,28,17,4,1,2,177
64904806,23,40,36,28,9,7,0,0,143
64904807,59,86,59,47,26,7,1,1,286
64904808,72,96,56,59,24,6,1,1,315
64904809,68,58,37,32,12,4,1,0,212
64904810,66,69,57,38,20,7,1,0,258
64904811,44,66,56,51,9,11,5,2,244
64904901,43,76,56,63,21,2,0,2,263
64904902,70,107,71,54,18,11,2,3,336
64904903,57,88,53,50,13,1,2,0,264
64904904,165,166,87,48,11,1,0,3,481
64904905,50,63,57,43,21,7,4,3,248
64904906,55,110,70,86,27,10,2,0,360
64904907,44,72,68,54,22,10,4,1,275
64904908,40,51,45,37,13,5,0,0,191
64904909,37,54,52,41,17,4,1,1,207
64904910,84,92,63,46,32,14,2,0,333
64904911,86,98,61,56,19,6,2,0,328
64905001,68,109,92,59,24,6,0,1,359
64905002,124,91,69,75,36,6,4,3,408
64905003,89,98,46,49,14,3,0,0,299
64905004,12,23,20,22,10,10,1,3,101
64905005,50,56,47,34,17,13,3,1,221
64905006,77,103,86,70,30,10,0,3,379
64905007,64,102,70,62,32,7,3,1,341
64905008,61,107,61,62,21,11,1,1,325
64905009,39,58,53,42,15,5,2,1,215
64905010,71,109,81,94,31,11,7,4,408
64905011,30,77,53,45,25,4,1,3,238
64905101,49,61,52,46,24,12,4,3,251
64905102,37,70,60,60,29,15,6,3,280
64905103,23,49,50,36,21,15,4,5,203
64905104,28,49,49,32,21,8,4,1,192
64905105,60,104,97,85,40,20,6,4,416
64905106,88,91,62,61,28,14,8,6,358
64905107,61,87,77,72,33,19,6,7,362
64905108,67,98,80,74,30,11,3,0,363
64905109,48,81,60,59,20,8,2,1,279
64905110,39,55,49,33,9,4,0,0,189
64905111,31,65,47,30,5,3,0,0,181
65150101,30,32,39,44,26,12,3,7,193
65150102,0,1,0,0,0,0,0,0,1
65150103,35,73,89,102,82,43,17,27,468
65150104,60,76,93,104,54,43,9,23,462
65150105,45,74,92,114,83,41,13,15,477
65150106,27,58,76,62,59,36,12,19,349
65150107,23,49,58,57,35,19,10,7,258
65150108,39,81,109,105,68,51,21,24,498
65150109,29,44,56,60,41,27,9,10,276
65150110,39,51,77,94,71,44,21,26,423
65150111,27,65,79,107,61,35,24,28,426
65150112,62,91,98,101,80,56,19,23,530
65150113,46,87,123,123,95,53,21,31,579
65150201,16,19,21,17,12,5,0,0,90
65150202,46,54,66,70,43,24,7,8,318
65150203,29,27,44,41,22,7,4,2,176
65150204,3,10,5,6,7,1,0,1,33
65150205,14,43,36,36,35,21,3,6,194
65150206,34,53,36,40,20,15,1,1,200
65150207,45,65,75,106,48,40,16,11,406
65150208,33,62,63,117,67,21,7,1,371
65150209,43,66,67,93,43,18,10,15,355
65150210,57,88,103,107,72,53,19,19,518
65150211,30,60,74,84,56,38,4,5,351
65150212,26,28,58,68,52,25,11,15,283
65150213,13,24,40,51,27,27,9,18,209
65150214,31,55,91,93,66,43,15,35,429
65150215,29,44,77,90,42,47,17,17,363
65150216,21,32,64,55,45,30,7,27,281
65150301,38,66,78,81,49,32,9,15,368
65150302,22,61,83,75,40,47,21,19,368
65150303,28,52,74,71,63,71,1,8,368
65150304,46,69,77,70,52,35,9,11,369
65150305,21,31,44,49,28,21,11,12,217
65150306,29,43,67,50,46,27,17,12,291
65150307,35,38,57,71,47,24,9,16,297
65150308,40,65,68,55,28,10,6,5,277
65150309,27,33,43,68,41,22,9,10,253
65150310,40,51,52,66,38,25,12,10,294
65150311,44,61,62,50,28,17,12,6,280
65150312,36,73,60,52,41,22,9,13,306
65150313,27,55,46,48,29,23,0,1,229
65150314,47,62,63,70,27,11,4,5,289
65150401,61,58,64,61,43,31,8,16,342
65150402,56,52,71,55,37,24,17,7,319
65150403,28,53,68,73,35,38,13,21,329
65150404,16,40,37,42,39,13,5,4,196
65150405,39,49,46,67,42,20,8,4,275
65150406,37,66,82,106,61,33,14,17,416
65150407,38,59,67,65,45,25,8,11,318
65150408,34,52,74,76,49,45,13,12,355
65150409,36,54,70,64,43,26,12,13,318
65150410,33,52,63,62,37,30,5,7,289
65150411,15,30,33,35,34,16,7,17,187
65150501,23,37,48,53,43,19,6,12,241
65150502,34,42,51,51,31,24,8,6,247
65150503,52,93,89,101,57,47,13,19,471
65150504,61,91,92,91,50,42,19,12,458
65150505,57,71,58,57,31,19,3,6,302
65150506,74,88,70,65,31,16,4,9,357
65150507,39,71,58,103,47,13,4,2,337
65150508,37,46,35,50,29,9,1,7,214
65150509,39,71,74,67,49,25,9,5,339
65150510,12,17,18,24,14,9,0,2,96
65150511,36,59,70,96,88,35,21,6,411
65150512,86,126,86,82,53,25,7,14,479
65150601,22,30,52,59,46,23,5,14,251
65150602,43,74,88,76,27,21,10,2,341
65150603,31,44,56,47,28,10,10,13,239
65150604,39,53,52,66,44,17,11,5,287
65150605,25,41,33,52,35,4,1,3,194
65150606,60,102,82,87,39,18,2,5,395
65150607,49,85,85,88,46,19,6,8,386
65150608,40,43,66,53,39,24,4,6,275
65150609,57,100,83,92,54,25,7,18,436
65150610,27,46,53,44,37,24,8,11,250
65150611,19,47,41,52,29,9,4,5,206
65150612,30,39,55,50,35,14,2,2,227
65150613,36,49,33,34,21,7,7,7,194
65150614,46,63,74,72,26,21,1,7,310
65150615,34,60,51,48,23,10,4,3,233
65150616,34,63,62,65,25,17,5,8,279
65150701,59,98,115,103,80,34,9,27,525
65150702,35,57,79,59,43,23,8,19,323
65150703,26,46,59,70,30,30,10,13,284
65150704,53,89,120,96,72,50,29,28,537
65150705,31,53,63,51,50,23,7,9,287
65150706,35,63,77,85,46,21,4,9,340
65150707,33,86,102,79,40,28,4,4,376
65150708,39,54,85,99,54,35,13,15,394
65150709,55,87,103,89,72,37,11,10,464
65150710,25,47,54,49,37,25,9,9,255
65150711,24,22,23,41,19,21,9,10,169
65150712,48,116,92,87,56,43,13,11,466
65150713,32,59,56,62,25,20,4,5,263
65150714,23,41,48,50,39,35,5,4,245
65150801,37,68,86,74,33,36,3,6,343
65150802,41,68,71,66,42,14,6,4,312
65150803,31,72,55,55,48,24,7,12,304
65150804,35,52,55,70,26,10,7,8,263
65150805,43,57,47,42,35,16,5,6,251
65150806,20,51,48,60,31,13,11,9,243
65150807,50,87,89,70,26,26,5,9,362
65150808,71,86,71,81,39,18,11,2,379
65150809,67,88,83,65,41,30,10,9,393
65150810,52,63,70,63,52,34,7,7,348
65150811,38,56,75,80,50,32,9,11,351
65150812,45,70,76,75,26,16,7,3,318
65150901,34,58,57,56,29,14,4,3,255
65150902,65,83,86,92,44,23,6,10,409
65150903,28,49,67,57,27,24,5,10,267
65150904,30,67,55,34,30,12,5,9,242
65150905,54,102,82,89,50,30,9,8,424
65150906,48,73,65,75,46,18,6,1,332
65150907,25,55,58,41,11,10,2,7,209
65150908,31,56,59,53,29,15,8,5,256
65150909,63,92,99,71,49,27,9,9,419
65150910,62,80,98,100,70,29,7,5,451
65150911,34,71,62,58,38,23,1,6,293
65150912,56,66,80,72,38,23,4,6,345
65150913,63,83,91,79,47,34,16,21,434
65150914,42,68,61,82,46,28,13,16,356
65151001,28,53,64,55,48,24,10,11,293
65151002,57,101,98,104,54,36,13,18,481
65151003,57,97,105,68,38,34,11,6,416
65151004,45,84,50,59,23,9,1,2,273
65151005,48,93,66,51,28,10,4,2,302
65151006,55,80,68,78,40,20,6,12,359
65151007,8,11,16,18,16,9,1,1,80
65151008,57,88,96,78,54,21,10,9,413
65151009,35,64,69,57,42,25,15,15,322
65151010,48,41,43,49,31,14,3,5,234
65151011,24,45,45,48,38,17,7,8,232
65151012,23,21,35,33,29,10,4,7,162
65151013,44,62,70,65,34,23,9,5,312
65151014,34,80,67,72,43,22,12,7,337
65151015,33,84,71,53,30,10,4,5,290
65151101,49,89,87,68,34,18,5,4,354
65151102,75,99,98,75,40,31,4,5,427
65151103,63,83,84,77,43,31,5,7,393
65151104,35,45,54,31,37,16,7,5,230
65151105,27,60,58,50,17,8,5,4,229
65151106,36,65,49,34,23,18,8,8,241
65151107,42,47,63,46,26,16,7,1,248
65151108,30,56,43,62,35,15,9,11,261
65151109,48,91,82,77,32,27,11,9,377
65151110,65,70,102,69,44,23,8,18,399
65151111,27,50,52,43,32,18,12,9,243
65151112,36,39,50,49,35,19,8,13,249
65151113,29,54,68,69,44,21,8,8,301
65151201,26,51,51,67,23,14,5,0,237
65151202,26,58,74,50,24,11,6,3,252
65151203,25,42,50,63,37,37,10,22,286
65151204,21,46,44,41,31,28,12,10,233
65151205,31,45,60,61,41,35,8,15,296
65151206,35,67,58,57,40,18,5,7,287
65151207,58,103,111,110,57,27,10,9,485
65151208,23,50,61,52,27,26,4,8,251
65151209,45,77,87,94,55,34,13,15,420
65151210,34,51,67,52,42,33,4,8,291
65151211,46,66,73,74,51,20,9,14,353
65151212,39,76,82,75,39,25,1,7,344
65151213,25,58,59,55,28,28,8,19,280
65151214,30,54,72,62,35,23,7,8,291
65151215,35,55,58,51,48,18,5,8,278
65151216,37,55,60,68,49,20,8,3,300
65151217,23,46,54,53,24,15,7,9,231
65151301,37,59,69,60,48,24,11,9,317
65151302,44,45,79,67,59,24,5,10,333
65151303,27,44,52,58,35,22,5,12,255
65151304,30,67,59,63,44,27,8,7,305
65151305,108,127,100,70,45,29,5,3,487
65151306,58,105,117,87,40,38,9,8,462
65151307,43,61,63,51,20,12,4,4,258
65151308,44,76,81,47,35,18,1,3,305
65151309,62,98,106,86,53,24,7,8,444
65151310,60,99,76,81,51,13,9,9,398
65151311,71,113,97,83,42,25,8,8,447
65151312,38,56,79,77,54,38,9,12,363
65151313,49,68,79,65,40,12,4,4,321
65151314,28,43,54,63,42,20,8,5,263
65151401,18,48,53,51,38,27,23,26,284
65151402,63,67,49,53,44,24,4,11,315
65151403,29,66,60,57,55,38,16,24,345
65151404,51,94,101,111,57,59,16,26,515
65151405,13,25,31,23,30,29,8,5,164
65151406,41,57,55,56,51,32,5,7,304
65151407,27,57,31,37,30,31,10,12,235
65151408,42,98,102,105,74,40,12,15,488
65151409,27,51,41,48,30,31,7,6,241
65151410,42,79,91,74,53,24,6,15,384
65151411,43,60,67,56,45,20,8,11,310
65151501,49,125,98,76,44,23,6,3,424
65151502,46,59,56,69,35,10,9,9,293
65151503,33,56,78,87,43,36,14,15,362
65151504,37,49,68,99,56,28,8,11,356
65151505,38,59,99,73,57,30,13,21,390
65151506,29,48,67,73,58,35,13,27,350
65151507,36,83,90,86,51,43,9,11,409
65151508,43,71,86,83,56,44,5,12,400
65151509,31,53,84,71,43,28,13,10,333
65151510,22,78,85,84,40,35,15,21,380
65151511,29,72,71,92,50,45,12,13,384
65151512,45,56,77,71,40,22,9,8,328
65151513,47,69,113,72,45,25,14,10,395
65151601,39,79,73,68,25,8,2,0,294
65151602,32,55,61,63,50,29,2,2,294
65151603,25,46,41,58,31,17,10,7,235
65151604,20,50,46,39,26,22,4,3,210
65151605,40,50,54,59,24,8,2,2,239
65151606,33,70,54,56,37,20,7,16,293
65151607,63,78,75,93,53,20,4,7,393
65151608,31,60,63,81,54,32,24,14,359
65151609,43,51,61,59,36,9,4,5,268
65151701,34,81,81,84,41,28,8,6,363
65151702,44,78,73,85,44,26,8,7,365
65151703,33,47,51,35,12,11,2,3,194
65151704,17,45,30,43,27,3,3,5,173
65151705,20,51,56,43,21,9,3,1,204
65151706,34,50,75,88,67,35,18,21,388
65151707,31,74,62,82,45,16,3,7,320
65151708,13,33,23,36,13,9,7,5,139
65151709,33,31,19,19,12,3,0,0,117
65151710,40,59,62,72,46,37,9,9,334
65151801,52,97,103,96,54,49,13,24,488
65151802,48,70,57,76,42,29,6,5,333
65151803,31,53,76,85,71,38,14,20,388
65151804,35,48,68,77,67,41,16,26,378
65151805,23,35,50,58,47,44,12,30,299
65151806,43,28,55,82,53,42,20,28,351
65151807,24,62,65,73,43,46,19,17,349
65151808,37,53,59,64,36,39,11,10,309
65151809,26,42,51,56,28,23,5,4,235
65151810,38,49,69,73,37,29,14,10,319
65151811,24,48,81,71,41,24,12,7,308
65151812,59,46,92,76,45,50,9,25,402
65151813,33,49,86,97,48,19,5,13,350
65151901,45,69,107,94,69,43,10,14,451
65151902,32,45,60,63,41,28,12,14,295
65151903,31,77,77,80,63,49,21,15,413
65151904,41,58,74,90,72,42,14,25,416
65151905,26,40,58,65,44,42,10,15,300
65151906,24,50,34,47,36,28,8,13,240
65151907,64,82,114,94,69,47,15,26,511
65151908,43,65,79,70,70,41,9,19,396
65151909,34,65,75,73,36,26,11,20,340
65151910,41,84,89,106,56,36,22,14,448
65151911,62,91,113,84,72,49,12,19,502
65151912,25,50,62,48,41,17,4,10,257
65151913,17,25,33,30,22,14,4,6,151
65151914,35,44,71,44,31,23,5,7,260
65152001,63,107,107,105,69,29,12,14,506
65152002,39,54,64,47,24,23,13,9,273
65152003,36,47,73,67,47,28,12,13,323
65152004,20,52,57,51,23,36,5,13,257
65152005,40,59,59,68,40,27,4,7,304
65152006,27,50,52,50,28,19,3,4,233
65152007,24,61,50,50,29,17,9,9,249
65152008,28,46,65,74,51,31,9,11,315
65152009,25,50,72,80,49,23,12,19,330
65152010,50,94,90,105,62,46,9,10,466
65152011,29,55,52,38,33,17,5,3,232
65152012,42,46,47,45,26,22,8,6,242
65152013,51,91,86,80,53,28,14,16,419
65152014,57,81,88,116,65,37,13,28,485
65152015,56,90,92,99,44,21,7,18,427
65152101,5,15,21,19,18,14,3,6,101
65152102,23,25,37,22,23,13,0,3,146
65152103,16,43,44,58,26,7,3,0,197
65152104,20,42,46,49,44,12,9,5,227
65152105,35,47,51,49,31,21,10,11,255
65152106,52,63,79,54,28,11,3,4,294
65152107,31,35,51,56,20,17,4,2,216
65152108,30,47,56,56,39,30,6,10,274
65152109,41,73,73,85,47,26,7,11,363
65152110,41,75,74,71,43,16,5,3,328
65152111,41,63,60,78,34,15,3,5,299
65152112,33,47,50,60,34,14,5,9,252
65152113,35,69,76,75,24,12,4,3,298
65152114,23,35,62,52,28,15,7,2,224
65152115,26,27,40,55,26,22,3,4,203
65390101,34,68,72,89,44,49,14,16,386
65390102,42,78,88,75,49,18,6,5,361
65390103,35,62,55,60,40,22,5,8,287
65390104,37,53,45,57,50,24,10,11,287
65390105,55,90,87,77,49,23,10,10,401
65390106,47,68,79,99,69,32,16,18,428
65390107,18,34,56,68,53,45,14,20,308
65390108,31,54,74,76,44,30,13,13,335
65390109,32,43,67,45,41,16,9,8,261
65390110,33,44,47,44,32,28,10,10,248
65390111,42,90,77,77,44,20,6,13,369
65390112,47,66,52,59,35,15,6,7,287
65390113,33,57,52,61,38,13,6,7,267
65390114,69,97,89,63,33,14,6,10,381
65390201,38,61,45,49,23,12,8,2,238
65390202,26,57,49,50,25,18,4,4,233
65390203,30,59,57,55,34,28,3,11,277
65390204,62,100,108,100,39,16,3,9,437
65390205,39,56,64,63,22,14,5,5,268
65390206,92,109,89,67,50,20,3,4,434
65390207,61,94,91,70,42,22,6,5,391
65390208,93,110,84,79,41,23,2,1,433
65390209,33,68,52,27,16,12,0,3,211
65390210,32,61,59,48,20,16,3,1,240
65390211,34,58,64,47,39,14,11,5,272
65390212,48,66,48,51,23,16,3,1,256
65390213,50,62,61,55,25,6,3,2,264
65390214,35,70,39,50,16,13,2,2,227
65390301,42,79,69,62,37,16,5,3,313
65390302,47,81,72,49,36,14,9,3,311
65390303,44,65,60,55,27,25,3,4,283
65390304,33,47,64,74,55,31,7,24,335
65390305,71,117,84,72,15,5,1,1,366
65390306,60,89,67,40,16,6,2,0,280
65390307,75,99,75,57,22,9,2,3,342
65390308,39,47,44,38,18,3,2,0,191
65390309,45,83,64,49,20,12,2,3,278
65390310,75,112,101,84,33,22,5,7,439
65390311,73,105,110,75,32,11,3,2,411
65390401,59,113,101,91,38,44,3,3,452
65390402,108,119,108,78,34,25,5,1,478
65390403,70,111,100,64,29,23,6,1,404
65390404,47,108,82,112,48,38,6,8,449
65390405,44,74,58,70,32,20,5,5,308
65390406,83,140,105,87,27,33,7,1,483
65390407,61,54,40,17,6,4,1,2,185
65390408,68,120,92,67,31,4,2,1,385
65390409,73,115,103,88,39,13,3,3,437
65390410,61,79,53,50,18,3,3,0,267
65390411,69,108,70,64,31,5,1,0,348
65390412,49,69,62,54,26,10,1,2,273
65390413,54,78,58,36,9,11,1,2,249
65390414,21,63,42,32,14,2,0,2,176
65390501,33,93,62,56,20,10,2,3,279
65390502,57,124,84,82,40,19,5,2,413
65390503,73,121,92,95,43,14,2,3,443
65390504,48,86,83,55,34,25,7,5,343
65390505,33,70,72,56,21,11,2,3,268
65390506,40,61,72,53,24,12,3,5,270
65390507,63,99,86,94,30,28,2,2,404
65390508,61,94,85,74,21,12,0,3,350
65390509,76,101,95,83,45,13,3,2,418
65390601,78,100,116,80,40,16,6,6,442
65390602,26,53,66,57,24,20,3,1,250
65390603,45,65,49,63,31,10,3,2,268
65390604,52,49,57,60,28,17,7,11,281
65390605,50,56,64,43,26,15,1,1,256
65390606,62,94,99,82,42,29,8,12,428
65390607,68,96,111,107,51,27,12,12,484
65390608,47,74,74,67,38,22,14,16,352
65390609,44,60,65,54,32,18,6,5,284
65390701,69,112,86,86,33,14,4,6,410
65390702,49,93,69,75,32,13,7,6,344
65390703,66,117,77,106,47,12,8,5,438
65390704,68,119,120,118,66,29,11,12,543
65390705,59,70,74,54,42,34,9,15,357
65390706,39,63,84,81,42,27,7,10,353
65390707,29,44,46,39,19,17,6,7,207
65390708,61,61,71,72,36,16,1,5,323
65390709,78,117,112,80,31,24,5,4,451
65390801,33,53,47,44,30,11,4,2,224
65390802,39,75,71,57,29,18,4,1,294
65390803,63,62,84,76,49,28,7,8,377
65390804,33,59,59,47,24,20,10,10,262
65390805,47,66,89,83,59,40,17,16,417
65390806,25,55,56,49,35,30,10,14,274
65390807,21,51,56,45,44,27,14,15,273
65390808,54,81,122,126,75,53,13,20,544
65390809,46,73,86,77,38,35,16,13,384
65390810,42,52,71,64,40,24,8,9,310
65390811,35,43,55,46,46,19,10,12,266
65390812,89,140,172,189,104,68,26,31,819
65390813,41,54,58,66,49,33,14,16,331
65390814,57,66,55,52,39,22,13,7,311
65390815,25,60,73,64,44,29,8,7,310
65390901,2,3,6,2,6,1,1,2,23
65390902,15,21,40,29,22,11,10,6,154
65390903,33,57,56,60,44,45,10,11,316
65390904,45,76,67,79,49,37,14,15,382
65390905,52,60,79,79,52,36,12,19,389
65390906,50,68,100,110,47,50,18,19,462
65390907,64,101,108,113,95,50,15,25,571
65390908,46,53,104,109,58,38,19,20,447
65390909,11,10,22,24,11,6,4,4,92
65390910,31,39,89,106,54,38,17,14,388
65390911,13,14,23,20,11,102,6,2,191
65390912,30,50,80,97,52,35,14,13,371
65391001,40,54,73,81,63,28,19,12,370
65391002,39,49,71,84,61,43,17,17,381
65391003,25,42,72,69,63,42,23,18,354
65391004,38,52,70,63,45,31,7,8,314
65391005,62,32,46,42,22,12,13,2,231
65391006,41,53,57,43,40,13,12,8,267
65391007,69,101,132,149,114,73,49,30,717
65391008,43,73,107,125,75,54,29,33,539
65391009,48,53,91,82,71,47,22,25,439
65391010,53,75,104,119,63,50,12,18,494
65391011,38,71,104,86,76,45,6,19,445
65391012,47,74,126,118,76,41,9,17,508
65391013,36,55,93,102,71,44,12,12,425
65391014,26,54,77,88,54,40,18,13,370
65391015,3,32,70,79,47,31,12,9,283
65391016,39,55,96,112,79,45,19,13,458
65391017,2,14,25,34,20,11,4,2,112
65391101,54,73,70,52,34,20,6,6,315
65391102,65,86,79,83,63,20,10,13,419
65391103,44,58,50,68,44,23,8,6,301
65391104,27,62,77,75,44,21,9,16,331
65391105,30,45,65,48,40,27,13,14,282
65391106,26,38,55,44,39,22,9,9,242
65391107,58,111,107,97,71,29,15,24,512
65391108,60,82,123,124,74,37,19,9,528
65391109,34,68,74,75,57,24,17,10,359
65391110,29,67,74,83,62,33,11,15,374
65391111,52,59,91,78,46,26,14,12,378
65391112,35,51,42,64,29,18,4,7,250
65391113,40,66,79,67,39,19,14,12,336
65391114,52,68,80,93,80,41,12,14,440
65391115,53,72,77,81,63,32,14,12,404
65391116,41,83,84,92,60,27,9,13,409
65391201,33,56,69,64,64,29,16,15,346
65391202,29,66,90,41,38,22,6,8,300
65391203,44,59,73,87,49,21,9,14,356
65391204,51,92,97,101,63,51,15,27,497
65391205,40,42,69,69,36,39,11,8,314
65391206,55,57,80,64,47,15,10,6,334
65391207,39,59,62,85,40,16,10,7,318
65391208,41,57,77,83,61,27,13,19,378
65391209,21,57,62,59,43,46,18,34,340
65391210,39,51,79,58,50,31,11,18,337
65391211,37,46,90,48,34,26,8,11,300
65391212,43,81,85,90,47,36,13,7,402
65391213,31,56,60,64,45,37,13,14,320
65391214,51,51,76,73,45,28,8,13,345
65391215,37,42,67,72,35,26,8,4,291
65391301,57,93,110,85,62,36,14,15,472
65391302,42,46,42,63,41,22,9,11,276
65391303,29,54,57,59,42,19,9,12,281
65391304,34,54,90,74,63,30,18,15,378
65391305,29,66,72,52,40,19,10,10,298
65391306,27,45,58,78,50,38,9,12,317
65391307,41,78,61,59,50,18,4,8,319
65391308,69,86,85,68,26,14,7,5,360
65391309,26,28,34,49,37,19,8,11,212
65391401,63,117,68,65,27,9,1,1,351
65391402,22,54,51,46,16,11,1,2,203
65391403,78,81,65,44,17,14,4,2,305
65391404,40,42,46,63,23,6,4,3,227
65391405,32,66,51,44,22,14,5,0,234
65391406,77,91,83,79,59,29,8,5,431
65391407,54,112,109,101,58,35,15,15,499
65391408,46,59,72,77,41,31,8,13,347
65391409,63,93,86,110,61,38,7,12,470
65391410,43,61,70,48,25,13,2,4,266
65391411,59,53,46,63,26,11,4,7,269
65391412,22,48,61,57,43,19,8,13,271
65391413,31,40,50,64,43,19,14,11,272
65391414,37,50,60,53,33,22,8,8,271
65391415,23,60,65,52,34,27,8,2,271
65391416,32,51,61,63,29,14,7,8,265
65391501,58,70,44,40,12,6,3,0,233
65391502,84,71,50,49,15,3,1,1,274
65391503,46,57,37,40,8,4,1,2,195
65391504,58,91,82,67,44,24,10,9,385
65391505,40,49,32,22,4,5,0,0,152
65391506,60,83,44,43,11,3,1,0,245
65391507,79,94,62,53,17,6,2,1,314
65391508,45,72,51,52,23,3,0,0,246
65391509,56,75,49,44,21,8,3,1,257
65391510,59,42,46,42,16,3,1,3,212
65391511,40,70,73,46,32,16,5,7,289
65391601,41,48,51,56,17,13,7,4,237
65391602,59,108,101,94,32,26,5,4,429
65391603,38,61,52,33,13,6,1,0,204
65391604,46,47,50,24,16,6,1,1,191
65391605,67,63,40,29,10,3,0,1,213
65391606,90,106,51,35,10,5,0,0,297
65391607,83,117,85,77,32,11,2,2,409
65391608,25,60,59,46,19,6,1,4,220
65391609,32,45,53,46,19,14,4,2,215
65391610,63,88,72,69,19,7,1,0,319
65391611,84,125,60,49,21,8,3,1,351
65391701,30,52,61,66,46,31,11,17,314
65391702,50,67,70,58,38,30,6,13,332
65391703,38,68,58,65,45,14,10,12,310
65391704,31,60,59,78,44,18,9,8,307
65391705,51,72,68,79,49,19,11,6,355
65391706,39,53,68,55,19,20,13,15,282
65391707,30,33,47,51,35,19,8,11,234
65391708,41,59,29,62,29,12,11,4,247
65391709,31,54,42,32,15,6,0,1,181
65391710,47,69,60,50,30,23,5,6,290
65391711,34,60,61,46,22,12,6,2,243
65391712,61,63,54,40,16,14,4,3,255
65391713,41,76,61,47,27,13,1,2,268
65391714,32,64,54,46,25,10,2,5,238
65391715,41,66,45,37,21,9,3,2,224
65391716,51,62,37,24,11,4,0,2,191
65391717,45,71,52,43,15,7,1,3,237
65391801,29,63,72,65,38,72,12,9,360
65391802,44,60,83,68,35,46,8,3,347
65391803,56,73,78,83,49,64,4,9,416
65391804,49,73,69,65,29,12,6,5,308
65391805,50,80,85,89,46,31,5,7,393
65391806,64,79,74,63,55,37,11,19,402
65391807,43,73,90,76,57,42,14,19,414
65391808,54,71,77,82,50,39,12,17,402
65391809,43,89,79,85,43,36,5,15,395
65391901,50,64,73,75,38,20,4,5,329
65391902,49,71,70,79,33,26,12,10,350
65391903,43,52,70,63,40,26,5,9,308
65391904,44,61,54,59,37,23,8,6,292
65391905,39,65,77,75,41,33,6,7,343
65391906,20,44,60,58,30,20,11,16,259
65391907,41,65,69,75,31,16,6,12,315
65391908,35,69,52,44,34,35,8,5,282
65391909,40,50,60,63,36,23,13,5,290
65392001,37,49,54,50,33,15,1,5,244
65392002,5,3,1,1,1,1,0,0,12
65392003,34,67,69,46,35,18,7,6,282
65392004,38,52,58,57,38,31,4,9,287
65392005,33,53,56,66,41,17,10,15,291
65392006,31,71,92,72,51,26,12,11,366
65392007,34,50,60,33,27,7,1,4,216
65392008,61,91,104,85,67,28,18,10,464
65392009,49,73,88,97,67,36,16,15,441
65392010,38,70,84,101,63,47,18,25,446
65392011,35,65,83,77,54,32,16,17,379
65392012,64,64,94,83,66,36,16,16,439
65392013,31,50,55,40,36,25,11,12,260
65392014,29,34,45,58,37,23,11,17,254
65392101,48,72,46,55,34,9,6,7,277
65392102,41,57,46,43,28,7,3,10,235
65392103,68,118,94,76,42,18,2,8,426
65392104,63,110,125,83,42,21,6,9,459
65392105,38,50,45,57,24,17,7,10,248
65392106,50,68,50,48,30,18,0,3,267
65392107,39,73,62,71,21,10,2,3,281
65392108,35,57,60,43,26,9,9,2,241
65392201,77,93,98,101,55,31,14,9,478
65392202,65,124,113,102,65,35,11,10,525
65392203,52,100,104,92,48,35,10,7,448
65392204,59,87,92,76,38,14,3,4,373
65392205,59,91,90,90,48,17,14,9,418
65392206,74,85,102,89,47,27,6,6,436
65392207,65,91,108,116,53,27,10,7,477
65392208,69,101,96,81,76,27,20,11,481
65392301,19,64,71,52,41,14,8,10,279
65392302,41,60,83,74,42,28,13,19,360
65392303,35,59,52,78,27,28,19,12,310
65392304,31,36,69,56,38,29,9,14,282
65392305,49,75,94,86,59,34,19,12,428
65392306,35,61,84,103,54,28,9,8,382
65392307,25,49,60,66,43,26,4,16,289
65392308,36,61,57,62,59,25,16,19,335
65392309,21,59,93,70,56,37,11,12,359
65392310,43,50,79,73,36,30,8,19,338
65392311,33,71,73,54,58,34,13,17,353
65392312,39,54,79,104,66,42,14,28,426
65392313,33,42,72,66,66,41,14,23,357
65392314,33,54,65,72,50,31,8,19,332
65392401,67,87,101,97,66,28,17,13,476
65392402,36,58,56,60,34,22,7,10,283
65392403,37,44,48,51,43,18,4,6,251
65392404,38,78,101,88,54,35,15,15,424
65392405,35,52,66,62,41,16,12,16,300
65392406,33,64,72,58,24,17,5,12,285
65392407,27,63,60,43,41,28,5,9,276
65392408,28,55,44,50,30,20,5,11,243
65392409,20,43,40,48,36,27,7,13,234
65392410,43,42,47,51,21,28,7,12,251
65392411,28,60,66,54,42,27,7,11,295
65392412,19,43,59,58,36,20,9,14,258
65392413,24,39,45,45,37,46,7,17,260
65392414,52,60,75,94,54,38,17,32,422
65392415,48,61,89,100,76,48,23,21,466
65392501,49,97,89,99,60,34,17,12,457
65392502,34,46,70,71,48,29,13,20,331
65392503,57,79,98,104,76,37,12,18,481
65392504,40,56,41,45,37,17,7,7,250
65392505,34,52,62,63,37,25,9,5,287
65392506,34,60,47,66,38,15,10,10,280
65392507,36,60,67,74,42,29,11,10,329
65392508,40,69,65,88,53,50,8,9,382
65392509,41,47,71,69,53,79,17,30,407
65392510,28,47,79,76,45,48,14,12,349
65392511,27,59,43,59,39,22,7,7,263
65392512,15,33,39,59,29,31,6,8,220
65392601,73,80,87,98,67,26,11,10,452
65392602,46,80,78,96,67,48,13,22,450
65392603,19,37,56,60,55,30,9,13,279
65392604,15,38,45,64,38,39,11,18,268
65392605,45,75,71,68,47,38,16,11,371
65392606,37,62,68,69,46,31,14,17,344
65392607,49,75,91,110,69,36,22,27,479
65392608,45,66,71,85,62,34,15,17,395
65392609,39,63,76,58,53,33,12,24,358
65392610,30,70,69,77,42,28,16,13,345
65392611,53,54,57,65,39,25,7,7,307
65392612,43,54,94,88,50,30,13,22,394
65392613,19,34,38,47,31,17,3,15,204
65392614,18,35,56,66,38,27,8,11,259
65392701,64,69,105,80,68,52,18,15,471
65392702,34,37,70,71,56,34,24,26,352
65392703,39,53,74,90,68,38,15,19,396
65392704,42,72,75,74,39,25,6,15,348
65392705,36,66,59,51,50,33,8,14,317
65392706,53,52,72,91,70,32,15,22,407
65392707,35,69,70,84,44,26,17,16,361
65392708,44,64,83,80,52,36,14,18,391
65392709,42,49,71,89,52,38,11,17,369
65392710,37,48,63,66,49,30,13,10,316
65392711,49,59,69,80,69,38,14,14,392
65392712,44,82,85,80,47,58,13,21,430
65392801,25,40,55,44,52,30,7,15,268
65392802,36,58,71,73,46,23,9,12,328
65392803,31,49,55,71,44,23,15,15,303
65392804,25,59,83,95,45,48,20,21,396
65392805,38,56,66,79,55,39,9,20,362
65392806,48,69,87,93,68,45,27,19,456
65392807,34,56,81,64,57,37,12,19,360
65392808,52,72,103,82,63,32,16,17,437
65392809,38,64,67,70,40,22,8,9,318
65392810,41,79,97,90,66,38,14,9,434
65392811,40,66,80,82,69,42,9,11,399
65392812,39,42,64,69,40,31,6,3,294
65392901,6,6,3,5,5,6,5,1,37
65392902,5,5,10,9,19,5,1,1,55
65392903,8,13,11,13,7,21,0,4,77
65392904,10,8,11,23,9,7,1,3,72
65392905,10,12,20,13,14,11,4,8,92
65392906,21,24,26,27,23,9,5,8,143
65392907,22,23,23,28,21,22,2,1,142
65392908,17,20,23,22,9,13,2,5,111
65392909,19,29,15,17,24,15,5,8,132
65392910,9,3,4,6,4,6,1,6,39
65392911,15,26,33,43,35,22,7,10,191
65392912,7,6,9,15,14,13,5,4,73
65392913,6,14,8,9,9,4,3,3,56
65392914,22,33,48,47,39,33,10,9,241
65392915,16,24,31,21,26,18,7,7,150
65392916,36,65,68,76,61,45,21,13,385
65392917,2,5,6,3,3,2,0,0,21
65392918,25,32,55,59,47,18,11,18,265
65392919,18,39,39,41,32,27,8,9,213
65392920,36,81,77,97,71,46,15,21,444
65392921,28,49,71,73,43,43,17,20,344
65392922,49,68,78,74,39,35,6,13,362
65392923,44,75,73,63,30,21,6,3,315
65392924,82,84,92,88,59,46,11,16,478
65392925,41,46,50,67,56,33,8,8,309
65393001,58,73,94,91,68,28,17,22,451
65393002,39,67,94,93,60,40,12,22,427
65393003,31,43,70,71,45,20,11,9,300
65393004,47,76,81,77,50,44,12,17,404
65393005,41,48,47,47,50,33,21,20,307
65393006,23,29,61,63,35,29,7,14,261
65393007,17,31,43,39,33,22,2,10,197
65393008,20,27,60,57,26,21,7,14,232
65393009,49,73,69,91,38,28,5,17,370
65393010,46,60,67,80,40,20,4,7,324
65393011,43,65,90,56,43,18,7,13,335
65393012,29,43,57,83,47,26,8,6,299
65393013,46,58,74,74,48,29,15,20,364
65393014,36,74,113,121,85,41,21,11,502
65393015,51,71,81,70,26,10,8,6,323
65393016,46,68,72,69,45,27,7,8,342
65393101,39,67,82,73,57,36,9,12,375
65393102,35,48,81,89,69,39,18,16,395
65393103,35,44,64,89,53,48,15,17,365
65393104,41,87,87,104,79,40,21,20,479
65393105,53,54,59,62,49,24,8,12,321
65393106,45,63,101,102,47,35,12,24,429
65393107,49,58,91,105,61,52,20,26,462
65393108,33,39,57,50,37,33,14,19,282
65393109,32,37,75,65,58,32,15,21,335
65393110,47,48,79,75,57,41,13,20,380
65393111,51,58,94,65,52,40,12,13,385
65393112,71,76,87,66,28,18,10,10,366
65393113,45,58,63,65,45,33,13,17,339
65393114,27,41,49,37,31,31,14,11,241
65393115,33,43,53,62,47,29,10,19,296
65393116,38,59,92,78,50,34,17,19,387
65393117,58,70,74,80,45,28,15,9,379
65393201,38,46,79,89,55,46,9,29,391
65393202,44,52,71,70,69,56,18,14,394
65393203,30,43,76,69,76,79,13,29,415
65393204,32,49,42,53,46,66,7,14,309
65393205,32,46,64,78,53,68,15,30,386
65393206,45,45,67,84,65,43,22,24,395
65393207,29,68,68,83,51,45,10,31,385
65393208,23,53,68,73,66,44,17,19,363
65393209,21,40,54,48,33,25,8,6,235
65393210,36,48,60,62,29,22,7,10,274
65393211,42,67,76,86,59,34,21,26,411
65393212,8,9,5,8,8,4,1,1,44
65393213,15,32,50,33,37,30,12,16,225
65393214,39,57,46,40,42,33,7,11,275
65393215,52,82,106,92,60,37,13,24,466
65393301,45,62,74,75,41,18,11,6,332
65393302,38,48,45,66,31,25,10,15,278
65393303,19,46,60,78,46,28,11,7,295
65393304,17,42,40,50,33,26,8,11,227
65393305,22,32,48,38,30,17,7,9,203
65393306,29,48,49,60,50,38,8,13,295
65393307,64,47,100,94,56,40,6,18,425
65393308,40,56,92,81,56,43,17,22,407
65393309,45,65,74,93,58,51,16,36,438
65393310,27,44,62,62,49,31,9,17,301
65393311,19,16,21,33,23,23,7,8,150
65393312,39,89,70,72,34,18,5,11,338
65393313,48,91,78,94,46,22,9,8,396
65393314,19,38,46,33,24,18,8,6,192
65393315,16,34,24,38,19,20,7,2,160
65393316,2,4,3,2,1,2,0,0,14
65393401,38,51,69,69,46,28,10,11,322
65393402,32,53,46,70,44,30,23,36,334
65393403,28,57,62,56,64,32,9,26,334
65393404,43,39,67,64,50,36,10,20,329
65393405,33,37,84,83,61,36,17,10,361
65393406,31,47,71,66,55,32,22,13,337
65393407,34,67,87,77,67,40,11,11,394
65393408,35,57,77,93,57,30,10,23,382
65393409,33,56,70,83,56,38,16,31,383
65393410,32,57,69,67,35,44,8,10,322
65393411,32,37,65,69,48,32,9,10,302
65393412,21,57,68,63,42,33,5,15,304
65393413,64,80,84,72,52,16,6,5,379
65393414,53,71,109,86,60,35,8,16,438
65393415,26,38,59,59,34,31,6,12,265
65393416,6,8,14,5,4,5,2,1,45
65393417,27,47,72,69,41,31,8,4,299
65393418,32,28,37,56,31,16,4,10,214
65600101,38,57,94,78,49,36,16,26,394
65600102,34,54,88,79,53,34,12,27,381
65600103,37,54,91,89,57,35,11,19,393
65600104,23,46,61,62,51,40,13,26,322
65600105,33,70,104,106,65,63,17,30,488
65600106,24,39,54,45,36,28,12,22,260
65600107,20,37,59,47,37,29,12,18,259
65600108,29,62,84,81,53,37,15,19,380
65600109,30,63,71,77,63,40,9,17,370
65600110,52,74,67,70,39,32,14,8,356
65600111,15,46,75,70,43,33,15,19,316
65600112,40,49,54,77,45,26,15,6,312
65600113,36,41,59,60,44,27,16,16,299
65600114,11,27,50,110,88,68,26,47,427
65600115,37,46,54,57,33,29,10,9,275
65600201,39,64,78,89,55,35,12,25,397
65600202,34,75,94,98,58,34,28,8,429
65600203,50,67,86,89,59,38,6,19,414
65600204,35,60,94,96,58,59,15,33,450
65600205,29,51,87,74,72,37,6,12,368
65600206,36,57,94,79,73,47,24,23,433
65600207,31,55,88,68,54,36,20,20,372
65600208,60,69,83,85,53,46,12,12,420
65600209,63,87,98,92,51,42,17,15,465
65600210,31,64,91,90,65,42,14,15,412
65600211,105,169,213,176,109,89,38,30,929
65600212,20,50,82,68,49,39,8,8,324
65600213,37,36,71,81,46,28,8,26,333
65600214,30,59,72,80,56,46,19,10,372
65600215,50,68,83,60,57,39,17,34,408
65600216,112,127,169,123,76,51,19,14,691
65600301,93,152,215,237,157,104,49,73,1080
65600302,47,91,106,108,58,50,19,22,501
65600303,31,65,62,68,35,27,10,16,314
65600304,20,49,55,70,41,32,3,10,280
65600305,26,37,54,53,40,33,11,15,269
65600306,32,51,58,71,40,26,10,9,297
65600307,44,61,102,119,66,59,16,29,496
65600308,52,78,93,83,51,27,12,16,412
65600309,23,62,88,109,66,32,19,22,421
65600310,48,55,73,84,64,29,12,17,382
65600311,46,79,72,77,50,31,16,12,383
65600312,51,53,75,76,51,24,8,7,345
65600313,48,58,38,30,26,14,7,4,225
65600314,26,39,43,56,26,25,4,16,235
65600315,37,52,69,77,50,40,13,20,358
65600316,12,19,12,14,6,9,3,6,81
65600401,32,38,66,75,45,32,6,8,302
65600402,38,39,67,65,45,24,3,3,284
65600403,57,83,111,116,70,47,17,15,516
65600404,42,68,94,96,73,38,16,28,455
65600405,17,41,45,84,50,66,3,16,322
65600406,19,19,53,39,32,22,14,15,213
65600407,7,11,52,50,39,24,18,15,216
65600408,60,83,53,61,13,14,0,0,284
65600409,27,24,89,86,45,27,10,20,328
65600410,27,41,99,80,55,44,6,11,363
65600411,37,50,53,72,43,23,10,17,305
65600412,27,61,73,55,44,24,6,11,301
65600413,36,63,78,60,31,19,2,3,292
65600414,33,62,73,59,26,19,3,3,278
65600415,32,53,63,46,27,20,5,7,253
65600416,44,63,69,64,30,22,4,5,301
65600417,44,75,83,92,60,17,20,4,395
65600418,22,59,104,47,24,24,0,2,282
65600419,41,60,94,79,51,50,14,14,403
65600420,44,63,61,101,35,31,13,22,370
65600501,32,44,46,42,15,23,8,6,216
65600502,43,70,99,80,50,19,8,17,386
65600503,16,30,35,46,34,15,6,5,187
65600504,42,49,76,72,58,43,8,9,357
65600505,7,13,22,19,15,6,1,4,87
65600506,4,14,19,6,6,4,4,2,59
65600507,33,82,65,87,42,24,14,9,356
65600508,11,15,22,18,10,5,5,3,89
65600509,7,14,12,17,16,12,1,0,79
65600510,39,68,82,93,46,26,10,17,381
65600511,25,59,75,50,45,26,13,12,305
65600512,30,46,66,62,36,23,11,11,285
65600513,29,66,71,101,63,32,17,18,397
65600514,39,49,71,79,54,28,19,10,349
65600515,29,35,75,68,38,22,7,8,282
65600601,42,74,79,88,51,26,8,7,375
65600602,45,57,102,108,39,41,17,22,431
65600603,62,94,80,97,56,24,16,17,446
65600604,26,63,53,49,38,29,7,6,271
65600605,92,83,142,178,94,72,13,20,694
65600606,48,78,102,91,65,33,12,16,445
65600607,101,200,267,298,176,117,25,41,1225
65600608,48,61,86,84,54,24,9,21,387
65600609,53,83,106,92,55,31,14,11,445
65600610,60,88,71,86,34,29,8,6,382
65600611,61,70,133,62,41,20,11,24,422
65600612,31,54,98,90,48,18,44,2,385
65600613,17,45,50,53,30,25,4,10,234
65600614,27,36,41,50,30,16,6,8,214
65600615,32,57,57,52,31,25,6,6,266
65600616,39,57,61,76,48,29,16,17,343
65600617,26,58,74,86,44,32,11,20,351
65600618,30,47,57,66,44,26,8,10,288
65600701,42,35,67,39,30,13,8,10,244
65600702,37,70,89,56,42,26,7,10,337
65600703,64,79,69,84,33,19,9,7,364
65600704,38,68,74,67,33,13,9,2,304
65600705,51,73,70,80,44,25,6,19,368
65600706,48,70,88,98,77,43,15,15,454
65600707,22,53,48,53,41,16,3,9,245
65600708,4,16,22,23,9,11,9,3,97
65600709,36,55,44,53,22,15,7,14,246
65600710,26,26,44,47,33,20,8,5,209
65600711,19,35,38,44,39,12,3,8,198
65600712,40,36,38,37,25,23,6,7,212
65600713,31,46,83,67,54,27,18,30,356
65600714,42,70,102,93,57,53,18,10,445
65600715,44,74,79,76,62,40,16,15,406
65600716,70,93,107,136,61,43,14,14,538
65600717,43,70,100,78,65,29,15,16,416
65600718,45,66,71,65,35,25,12,7,326
65600801,47,77,73,86,28,23,6,7,347
65600802,43,65,64,71,35,27,10,6,321
65600803,48,54,70,63,34,18,11,7,305
65600804,42,70,63,52,40,17,6,4,294
65600805,37,57,50,70,26,21,9,12,282
65600806,38,71,83,56,39,21,6,7,321
65600807,47,73,65,86,49,30,13,15,378
65600808,54,68,77,83,51,32,15,13,393
65600809,61,72,66,47,24,16,5,6,297
65600810,57,76,78,53,29,16,5,4,318
65600811,26,67,62,50,40,19,3,7,274
65600812,31,42,58,43,28,17,5,8,232
65600901,25,27,73,54,13,24,12,0,228
65600902,11,8,24,19,11,11,5,4,93
65600903,4,7,9,7,9,8,1,4,49
65600904,10,15,30,28,23,19,3,5,133
65600905,9,9,24,21,13,16,5,6,103
65600906,9,11,29,26,11,12,4,2,104
65600907,2,2,22,26,27,18,2,9,108
65600908,5,6,21,16,13,11,4,2,78
65600909,10,14,28,30,9,10,4,1,106
65600910,7,10,9,19,5,3,2,0,55
65600911,11,7,14,12,6,4,2,1,57
65600912,11,20,28,21,6,9,4,0,99
65601001,24,30,39,42,17,7,2,2,163
65601002,25,60,65,74,34,11,0,4,273
65601003,46,77,56,61,38,22,10,4,314
65601004,35,69,82,79,60,41,3,9,378
65601005,45,77,79,86,60,23,10,15,395
65601006,43,57,96,81,55,28,12,15,387
65601007,46,73,97,105,56,31,17,23,448
65601008,37,76,85,80,46,25,7,7,363
65601009,38,59,73,77,42,31,9,18,347
65601010,44,65,84,108,51,35,5,11,403
65601011,53,60,76,100,48,26,7,7,377
65601012,28,64,69,82,46,25,16,6,336
65601013,44,77,83,72,41,19,3,6,345
65601101,45,49,53,67,31,36,7,5,293
65601102,41,78,89,86,53,24,8,5,384
65601103,24,47,63,46,27,20,5,6,238
65601104,31,31,50,57,32,21,13,9,244
65601105,16,36,46,62,35,24,4,13,236
65601106,21,40,59,52,43,22,8,12,257
65601107,38,50,84,88,71,42,9,11,393
65601108,48,69,72,97,47,42,13,8,396
65601109,34,62,85,76,64,37,7,17,382
65601110,63,84,88,96,56,41,11,14,453
65601111,40,74,92,92,59,36,20,14,427
65601112,38,69,80,74,66,24,11,12,374
65601113,54,78,96,85,56,33,5,14,421
65601114,52,66,71,76,36,21,9,11,342
65601115,39,62,60,81,45,18,5,9,319
65601116,39,56,44,51,23,12,9,4,238
65601117,25,60,64,68,21,15,2,2,257
65601201,38,70,78,76,44,29,10,15,360
65601202,21,45,65,71,50,35,10,10,307
65601203,46,69,79,97,63,48,18,15,435
65601204,28,54,46,50,20,21,7,6,232
65601205,55,52,80,61,48,21,11,10,338
65601206,54,59,68,54,24,17,5,5,286
65601207,42,56,73,46,34,17,8,11,287
65601208,40,57,48,64,29,14,2,13,267
65601209,77,104,97,94,63,30,11,15,491
65601210,35,46,57,49,36,22,3,17,265
65601211,28,45,56,39,35,16,4,3,226
65601212,13,45,60,67,41,22,6,8,262
65601213,43,68,77,55,32,5,16,8,304
65601214,58,107,97,87,40,21,13,8,431
65601215,46,57,55,56,24,17,4,3,262
65601216,34,54,57,56,20,16,3,1,241
65601301,40,63,64,77,45,24,13,20,346
65601302,42,58,77,76,57,44,16,16,386
65601303,46,65,93,96,76,53,21,24,474
65601304,45,55,60,81,38,25,8,9,321
65601305,40,52,71,84,56,37,17,18,375
65601306,41,57,67,60,30,14,7,15,291
65601307,51,84,94,94,65,35,18,15,456
65601308,40,59,75,71,46,27,10,11,339
65601309,37,61,68,74,31,20,12,10,313
65601310,55,70,94,90,59,56,16,18,458
65601311,62,85,106,92,65,39,16,18,483
65601401,39,58,91,82,87,66,15,38,476
65601402,35,69,88,84,60,37,20,20,413
65601403,43,70,70,66,36,38,2,16,341
65601404,26,34,76,59,49,36,21,25,326
65601405,33,62,72,88,60,39,16,29,399
65601406,32,50,74,80,53,54,16,32,391
65601407,36,38,46,48,45,21,13,22,269
65601408,60,95,127,110,76,50,17,22,557
65601409,15,41,45,41,43,23,13,15,236
65601410,17,25,37,55,50,30,11,11,236
65601411,24,38,53,56,36,35,17,20,279
65601412,31,65,68,86,50,24,11,28,363
65601413,34,30,82,52,67,22,5,26,318
65601414,35,50,58,83,57,35,12,13,343
65601501,36,45,70,53,31,31,15,12,293
65601502,32,25,40,31,34,32,4,7,205
65601503,25,32,57,79,42,36,12,10,293
65601504,19,38,58,72,44,29,11,14,285
65601505,22,41,48,70,30,24,13,18,266
65601506,36,39,63,56,43,29,8,13,287
65601507,17,41,44,54,30,21,10,9,226
65601508,40,60,126,156,136,104,47,60,729
65601509,54,79,105,96,64,40,24,37,499
65601510,54,68,57,65,37,26,11,10,328
65601511,36,77,82,72,55,39,15,19,395
65601512,60,45,61,86,56,41,19,34,402
65601513,36,59,83,79,46,43,14,23,383
65601514,35,58,62,82,62,42,22,21,384
65601515,49,46,79,80,60,53,14,27,408
65601516,82,81,86,73,48,23,9,7,409
65601601,44,53,74,74,49,25,3,12,334
65601602,30,43,50,51,44,27,12,9,266
65601603,46,68,84,68,35,20,12,7,340
65601604,34,64,77,60,41,29,12,12,329
65601605,38,54,73,64,47,30,10,15,331
65601606,65,81,90,78,65,33,13,9,434
65601607,32,58,60,64,52,35,11,18,330
65601608,37,53,81,92,57,35,24,17,396
65601609,40,82,60,87,60,32,14,12,387
65601610,25,74,81,81,45,24,10,13,353
65601611,56,69,87,80,55,34,11,17,409
65601612,44,94,95,89,73,48,5,15,463
65601613,40,64,79,81,57,32,17,15,385
65601614,46,81,84,86,55,30,12,23,417
65601615,37,50,40,59,41,21,3,7,258
65601616,31,60,57,57,19,14,1,1,240
65601701,45,51,80,68,51,46,12,24,377
65601702,37,46,81,54,43,32,15,19,327
65601703,34,64,68,61,46,44,5,12,334
65601704,17,17,49,44,27,21,8,5,188
65601705,27,41,45,79,39,6,0,1,238
65601706,23,57,41,52,32,14,1,2,222
65601707,30,18,25,38,26,7,7,5,156
65601708,3,17,9,20,21,6,1,0,77
65601709,3,10,14,7,13,6,0,0,53
65601710,14,34,21,29,14,4,0,1,117
65601711,20,36,39,52,21,8,0,0,176
65601712,14,38,32,33,10,1,2,2,132
65601713,29,22,38,49,39,30,15,18,240
65601714,20,31,32,44,28,17,11,11,194
65601715,22,32,45,37,21,17,5,1,180
65601716,34,31,50,58,33,18,11,13,248
65601717,24,32,44,44,39,31,11,12,237
65601718,16,28,48,36,33,10,8,5,184
65601719,37,53,73,84,67,28,15,23,380
65601720,31,44,43,54,28,17,6,8,231
65601721,23,39,49,48,30,17,6,5,217
65601722,17,42,60,67,27,9,2,1,225
65601723,19,54,44,65,30,9,2,1,224
65601724,27,65,47,72,30,4,0,0,245
65601801,19,40,45,49,28,17,8,9,215
65601802,44,55,86,84,43,23,9,14,358
65601803,22,44,46,45,29,19,6,11,222
65601804,35,39,44,49,38,10,2,8,225
65601805,18,45,38,38,21,11,6,7,184
65601806,42,97,91,164,93,23,5,1,516
65601807,25,55,51,61,21,5,1,0,219
65601808,30,47,32,43,21,8,3,1,185
65601809,33,70,80,90,60,35,17,20,405
65601810,56,83,92,98,78,36,13,18,474
65601811,50,76,102,73,48,37,12,13,411
65601812,45,68,52,67,26,8,2,2,270
65601813,34,56,49,59,46,18,3,10,275
65601814,70,96,83,65,66,35,14,19,448
65601815,35,70,71,79,43,41,11,14,364
65601901,31,47,52,48,33,18,11,16,256
65601902,44,49,55,71,30,18,9,15,291
65601903,39,70,72,70,45,41,19,20,376
65601904,30,48,65,73,42,32,9,9,308
65601905,30,37,39,39,22,27,3,3,200
65601906,32,33,48,39,20,17,9,5,203
65601907,39,70,74,58,33,17,4,7,302
65601908,53,76,55,52,28,12,2,8,286
65601909,30,81,60,44,33,25,7,9,289
65601910,56,56,78,72,49,26,17,25,379
65601911,30,72,64,48,23,13,6,6,262
65601912,36,61,50,38,28,16,4,1,234
65601913,30,43,42,30,28,11,5,6,195
65601914,31,45,49,58,22,22,7,9,243
65601915,33,35,43,71,47,29,24,30,312
65601916,16,44,40,45,22,11,10,13,201
65601917,31,29,34,22,15,15,12,7,165
65601918,27,27,23,19,14,7,5,5,127
65601919,16,33,29,45,28,18,6,7,182
65601920,42,37,32,37,21,13,9,11,202
65602001,13,33,60,95,65,77,48,77,468
65602002,33,53,76,73,51,35,18,24,363
65602003,43,72,63,60,61,50,16,18,383
65602004,52,61,78,81,62,32,15,12,393
65602005,24,33,42,63,47,29,17,19,274
65602006,22,29,47,62,40,41,22,40,303
65602007,32,46,61,69,49,32,18,32,339
65602008,16,36,59,57,42,38,17,28,293
65602009,35,40,65,83,49,28,18,17,335
65602010,23,43,51,75,51,37,17,28,325
65602011,30,48,46,71,37,24,9,11,276
65602012,35,63,71,52,41,17,13,5,297
65602013,26,50,78,113,86,41,16,13,423
65602014,49,57,70,66,51,22,17,12,344
65602101,50,71,75,85,50,31,7,8,377
65602102,30,48,41,55,19,13,4,1,211
65602103,30,37,50,41,35,30,7,15,245
65602104,31,30,40,38,20,17,11,12,199
65602105,35,47,58,47,35,19,9,7,257
65602106,33,41,53,61,40,17,9,10,264
65602107,28,71,85,99,68,45,18,17,431
65602108,59,64,82,72,57,44,12,14,404
65602109,49,80,80,91,50,23,9,13,395
65602110,18,49,55,47,32,13,11,6,231
65602111,52,87,89,88,56,40,15,14,441
65602112,27,31,46,48,27,24,8,18,229
65602113,43,59,95,56,36,27,13,6,335
65602201,32,49,62,73,37,22,6,10,291
65602202,48,82,68,67,44,17,5,4,335
65602203,47,74,84,79,41,19,12,1,357
65602204,37,76,78,68,52,24,14,10,359
65602205,54,81,80,83,60,28,9,9,404
65602206,43,52,50,55,37,15,1,4,257
65602207,40,49,61,46,34,13,0,6,249
65602208,54,122,95,77,29,16,3,3,399
65602209,47,88,84,69,26,11,9,8,342
65602210,47,68,76,85,30,16,12,10,344
65602301,44,66,72,61,37,33,4,9,326
65602302,38,54,48,72,34,30,8,11,295
65602303,33,72,65,44,33,15,3,2,267
65602304,44,109,87,103,45,20,4,6,418
65602305,45,75,86,83,35,13,4,4,345
65602306,54,80,71,56,43,19,9,3,335
65602307,74,96,71,64,30,9,1,2,347
65602308,54,43,56,30,16,6,1,1,207
65602309,51,58,38,27,13,2,0,0,189
65602310,61,67,48,33,18,6,0,0,233
65602311,83,44,19,21,5,2,0,0,174
65602312,38,68,38,21,14,7,3,0,189
65602313,81,97,79,37,23,8,2,2,329
65602314,40,68,48,44,15,3,1,0,219
65602315,59,80,52,41,18,5,1,2,258
65602316,50,86,70,60,20,12,0,0,298
65602317,102,107,97,44,29,5,2,0,386
65602401,63,77,42,30,14,2,0,1,229
65602402,55,45,35,27,15,7,2,0,186
65602403,48,68,67,43,22,4,2,0,254
65602404,63,81,64,41,30,4,3,1,287
65602405,50,68,61,50,23,21,4,4,281
65602406,39,60,58,53,46,21,4,1,282
65602407,40,67,61,66,45,17,8,4,308
65602408,44,84,66,54,33,11,2,3,297
65602409,39,61,49,46,20,6,1,1,223
65602410,37,65,46,29,16,10,2,0,205
65602411,90,84,58,39,14,7,1,0,293
65602412,55,56,38,22,16,3,0,1,191
65602413,42,62,57,35,12,3,1,0,212
65602414,35,77,35,48,21,3,2,1,222
65602415,57,63,31,26,16,4,1,0,198
65602416,45,64,71,64,22,9,3,1,279
65602417,37,71,77,94,59,23,17,14,392
65602501,48,80,46,38,19,13,2,1,247
65602502,50,65,68,53,18,9,0,2,265
65602503,77,106,89,60,28,7,5,2,374
65602504,65,119,89,101,41,24,4,9,452
65602505,32,43,53,48,26,8,3,4,217
65602506,31,49,59,60,31,11,6,2,249
65602507,58,67,58,51,33,9,2,2,280
65602508,28,64,78,79,47,43,16,8,363
65602509,71,119,107,98,34,24,8,8,469
65602510,91,120,115,103,57,17,3,1,507
65602511,28,65,71,49,25,15,8,3,264
65602512,30,49,55,62,44,15,2,4,261
65602513,51,58,87,114,53,39,15,13,430
65602514,46,73,72,70,43,24,8,10,346
65680101,22,31,28,29,14,4,1,5,134
65680102,9,55,68,77,44,11,1,3,268
65680103,56,87,76,87,28,12,3,0,349
65680201,71,86,55,49,27,7,3,1,299
65680202,41,63,49,28,17,6,0,0,204
65680203,47,98,75,61,28,11,4,0,324
65680204,41,54,63,57,27,6,4,0,252
65680205,60,92,55,54,19,12,5,0,297
65680206,64,104,84,64,24,4,4,0,348
65680207,63,90,66,79,28,10,0,2,338
65680208,42,96,86,61,36,24,5,1,351
65680209,77,120,92,94,40,23,4,1,451
65680210,36,64,47,53,24,5,1,0,230
65680211,60,105,80,60,29,11,5,6,356
65680212,38,79,64,50,27,7,3,3,271
65680301,62,92,71,71,26,12,3,2,339
65680302,70,87,85,74,30,15,3,4,368
65680303,65,88,84,77,25,8,4,2,353
65680304,32,50,69,62,34,8,2,2,259
65680305,25,67,59,54,21,13,3,2,244
65680306,42,71,49,55,20,14,2,1,254
65680307,41,52,50,50,27,4,2,2,228
65680308,57,82,75,43,32,17,5,3,314
65680309,43,88,81,66,28,14,2,2,324
65680310,17,31,46,53,27,26,13,14,227
65680311,68,93,82,92,33,18,4,5,395
65680312,43,105,85,59,32,10,2,1,337
65680313,69,115,86,85,41,15,3,9,423
65680314,52,104,120,119,82,51,32,42,602
65680315,63,102,122,105,73,46,21,26,558
65680316,23,37,58,78,55,33,15,31,330
65680401,53,66,52,43,20,7,3,0,244
65680402,46,71,53,40,14,4,3,2,233
65680403,49,78,39,35,19,9,0,2,231
65680404,48,88,72,56,18,5,1,0,288
65680405,63,103,72,57,35,10,1,0,341
65680406,26,56,48,31,11,11,2,1,186
65680407,63,78,70,36,19,15,3,1,285
65680408,61,109,68,67,24,7,3,1,340
65680409,62,118,80,78,31,7,5,0,381
65680410,50,88,66,58,25,6,2,0,295
65680411,79,120,85,48,25,13,1,0,371
65680501,57,91,71,49,26,5,1,0,300
65680502,65,135,90,88,43,10,4,0,435
65680503,38,81,51,48,18,4,4,1,245
65680504,35,71,57,40,21,2,2,1,229
65680505,79,104,86,68,25,3,3,1,369
65680506,67,109,66,55,11,9,2,2,321
65680507,70,102,80,62,15,7,1,1,338
65680508,53,115,85,74,22,9,0,1,359
65680509,44,59,46,37,25,8,1,2,222
65680510,29,47,57,55,16,5,1,0,210
65680601,52,157,83,80,17,10,0,1,400
65680602,65,102,62,57,19,9,2,0,316
65680603,56,88,63,58,22,5,1,1,294
65680604,72,108,75,56,16,5,2,0,334
65680605,44,120,67,57,19,7,2,0,316
65680606,130,119,71,32,13,6,2,0,373
65680607,85,128,81,67,19,10,1,0,391
65680608,61,89,67,51,15,8,1,0,292
65680609,76,113,87,68,26,6,2,1,379
65680610,88,75,32,24,5,2,0,1,227
65680611,48,59,29,22,3,0,0,1,162
65680701,72,76,61,60,33,6,1,1,310
65680702,62,68,70,68,24,8,2,0,302
65680703,29,70,41,40,26,7,0,2,215
65680704,29,76,58,45,31,4,0,1,244
65680705,59,89,64,54,21,5,1,3,296
65680706,41,108,82,93,32,11,0,0,367
65680707,61,88,76,45,19,13,0,0,302
65680708,62,69,55,58,20,15,0,2,281
65680801,50,100,71,72,28,10,1,5,337
65680802,58,85,84,61,25,11,0,3,327
65680803,19,46,63,53,39,8,4,9,241
65680804,56,100,76,75,40,13,2,0,362
65680805,55,99,90,82,41,10,1,0,378
65680806,64,108,68,64,24,22,4,1,355
65680807,60,109,76,68,30,8,2,0,353
65680808,58,85,81,71,30,15,4,1,345
65680901,31,57,41,40,14,7,3,1,194
65680902,41,64,66,45,28,6,1,0,251
65680903,76,106,86,83,40,14,2,1,408
65680904,38,70,53,36,19,10,4,3,233
65680905,36,47,56,36,21,6,5,1,208
65680906,45,86,70,49,17,7,1,2,277
65680907,66,122,96,74,25,6,3,1,393
65680908,41,48,39,36,11,3,2,0,180
65680909,53,71,58,58,15,5,2,1,263
65680910,73,112,90,70,32,6,1,1,385
65680911,53,54,38,58,18,3,0,0,224
65680912,39,47,53,39,16,5,3,2,204
65681001,54,104,56,53,35,15,10,8,335
65681002,35,27,34,32,19,10,1,3,161
65681003,23,38,37,29,17,13,2,1,160
65681004,56,91,47,60,27,12,3,2,298
65681005,46,90,79,49,15,11,6,3,299
65681006,28,67,52,36,19,8,3,3,216
65681007,43,44,40,45,18,13,1,0,204
65681008,51,84,71,76,35,15,6,1,339
65681009,49,87,71,66,21,8,1,6,309
65681010,42,55,53,46,18,5,3,3,225
65681011,44,59,57,36,19,8,0,1,224
65681012,51,114,84,58,22,6,2,2,339
65681013,59,117,86,61,36,3,1,0,363
65681014,54,110,63,39,9,0,1,1,277
65681015,58,78,58,46,14,9,2,0,265
65681016,62,92,64,56,14,8,0,1,297
65681017,46,67,48,50,29,12,7,7,266
65681101,59,100,62,45,18,6,1,0,291
65681102,69,100,74,82,30,8,3,2,368
65681103,36,90,45,48,17,2,3,0,241
65681104,48,61,38,32,7,2,2,2,192
65681105,97,93,51,28,11,1,1,0,282
65681106,42,84,65,57,19,7,1,1,276
65681107,37,85,54,67,25,6,1,2,277
65681108,58,92,74,78,30,9,2,0,343
65681109,72,69,59,32,6,3,0,2,243
65681110,59,70,45,26,18,6,1,1,226
65681111,50,91,51,44,17,2,0,4,259
65681112,62,103,66,55,29,4,2,1,322
65681201,52,83,55,48,19,2,4,2,265
65681202,67,106,69,60,21,11,0,0,334
65681203,63,87,70,70,27,9,1,0,327
65681204,38,64,69,50,16,5,2,1,245
65681205,91,114,82,63,28,7,2,0,387
65681206,75,108,100,69,32,13,1,0,398
65681207,77,124,83,72,34,8,0,3,401
65681208,47,68,53,41,16,6,0,1,232
65681209,46,66,55,47,13,10,1,0,238
65681210,55,76,60,54,22,8,4,1,280
65681301,48,62,51,35,19,2,2,2,221
65681302,45,55,48,41,7,7,2,1,206
65681303,51,85,56,47,21,11,1,0,272
65681304,75,92,86,48,23,4,0,2,330
65681305,63,102,79,45,29,11,0,1,330
65681306,71,97,74,78,40,11,4,5,380
65681307,75,126,98,82,42,8,3,1,435
65681308,58,101,82,78,30,13,1,5,368
65681309,51,98,91,75,38,13,3,3,372
65681310,34,72,71,73,34,35,13,15,347
65681401,29,20,43,34,25,32,0,8,191
65681402,68,79,67,53,25,8,1,3,304
65681403,98,132,87,72,33,12,7,6,447
65681404,99,73,51,29,8,1,0,1,262
65681405,45,50,20,43,12,10,4,0,184
65681406,59,60,33,29,7,10,8,1,207
65681407,104,97,44,42,5,19,17,0,328
65681408,47,66,63,42,14,5,2,3,242
65681409,88,106,74,53,21,6,0,0,348
65681410,88,109,95,43,20,6,0,2,363
65681501,45,81,64,43,31,6,0,2,272
65681502,73,89,76,71,27,15,3,2,356
65681503,97,82,72,49,20,9,3,2,334
65681504,65,113,75,84,29,27,5,12,410
65681505,47,94,78,57,19,12,3,2,312
65681506,93,82,67,48,23,10,5,4,332
65681507,78,94,71,56,36,11,5,2,353
65681508,87,119,87,60,42,18,1,2,416
65681509,45,69,47,36,17,3,1,2,220
65681510,52,89,66,55,29,13,1,0,305
65681601,64,100,79,63,32,19,8,7,372
65681602,47,75,75,75,31,20,8,6,337
65681603,52,60,51,48,38,13,4,1,267
65681604,68,122,107,77,30,24,4,6,438
65681605,54,107,66,58,31,8,1,3,328
65681606,58,90,88,62,30,17,2,3,350
65681607,45,70,62,52,16,6,1,2,254
65681608,49,61,49,41,24,4,0,0,228
65681609,77,103,94,88,39,18,3,1,423
65681610,60,103,88,78,33,6,4,2,374
65681611,57,85,80,50,27,14,1,1,315
65681612,95,111,78,65,33,6,0,0,388
65681701,60,84,64,90,31,13,2,2,346
65681702,35,82,80,73,29,15,5,2,321
65681703,44,58,44,62,21,14,4,4,251
65681704,36,74,55,42,20,5,2,0,234
65681705,50,93,95,99,35,12,2,2,388
65681706,65,89,93,72,49,18,9,4,399
65681707,47,118,86,74,36,9,1,0,371
65681708,63,102,83,72,36,10,3,0,369
65681709,45,94,55,46,21,5,2,0,268
65681710,52,100,53,53,28,4,1,1,292
65681711,53,102,65,60,22,8,1,0,311
65681712,49,79,64,65,20,7,0,0,284
65681801,74,74,42,24,8,6,1,0,229
65681802,72,63,17,9,2,3,0,0,166
65681803,56,53,28,29,12,0,0,0,178
65681804,97,89,34,15,3,0,0,0,238
65681805,78,83,41,36,15,3,2,0,258
65681806,59,60,24,25,9,2,0,0,179
65681807,65,91,73,74,25,4,1,0,333
65681808,47,76,60,46,21,4,1,1,256
65681809,72,104,75,73,26,9,1,1,361
65681810,65,84,62,64,31,10,1,1,318
65681811,47,84,85,65,17,5,1,0,304
65681812,64,102,71,57,18,9,1,0,322
65681813,35,76,50,65,22,7,0,0,255
65681814,35,67,51,48,18,3,1,0,223
65681901,53,76,46,51,21,3,2,3,255
65681902,57,110,79,61,34,13,2,0,356
65681903,72,129,103,75,30,14,4,0,427
65681904,41,71,54,45,15,10,3,2,241
65681905,47,71,59,60,20,8,1,1,267
65681906,68,111,98,77,44,15,4,2,419
65681907,62,88,78,66,33,16,3,1,347
65681908,52,94,96,92,26,10,2,1,373
65681909,74,111,73,82,33,13,3,3,392
65681910,44,59,43,39,21,13,3,0,222
65681911,41,84,76,92,43,30,8,7,381
65682001,63,101,79,62,23,12,3,1,344
65682002,80,61,49,30,12,3,0,4,239
65682003,118,112,48,27,5,3,1,0,314
65682004,80,79,67,42,22,7,1,0,298
65682005,87,102,49,25,8,3,0,0,274
65682006,62,80,44,25,8,3,1,0,223
65682007,43,66,38,48,17,5,1,1,219
65682008,73,111,63,81,26,3,1,3,361
65682009,71,133,89,73,29,9,4,1,409
65682010,62,88,63,56,26,6,0,4,305
65682011,85,114,95,68,34,21,2,3,422
65682012,61,95,66,69,35,5,2,0,333
65682013,40,82,58,51,20,7,2,1,261
65682014,37,67,53,51,25,7,3,1,244
65682101,69,64,21,12,5,3,0,1,175
65682102,60,45,18,14,6,2,1,1,147
65682103,66,52,16,9,3,2,0,2,150
65682104,112,81,44,20,9,0,0,0,266
65682105,59,44,27,8,2,2,0,0,142
65682106,54,51,9,2,3,1,1,0,121
65682107,25,10,2,4,0,0,0,0,41
65682108,52,51,18,9,3,1,0,0,134
65682109,68,67,16,9,4,2,0,1,167
65682110,69,57,27,15,4,2,0,0,174
65682111,34,43,20,18,2,2,0,0,119
65682112,109,84,27,18,5,2,1,0,246
65682113,114,124,54,48,20,9,1,1,371
65682201,26,55,45,37,17,4,0,0,184
65682202,23,46,28,33,7,1,0,0,138
65682203,24,37,35,33,7,5,0,0,141
65682204,21,53,54,33,16,7,0,0,184
65682205,19,26,28,26,12,5,0,1,117
65682206,36,79,51,57,12,5,0,0,240
65682207,22,38,34,31,13,5,0,0,143
65682208,26,69,40,43,15,4,0,0,197
65682209,17,55,36,36,18,7,0,0,169
65682210,27,68,38,42,12,1,0,0,188
65682211,22,52,28,34,8,0,0,0,144
65682212,28,46,39,40,15,4,0,0,172
65682213,45,86,65,62,15,7,0,0,280
65682214,44,94,89,73,40,11,0,0,351
65682215,21,53,36,33,13,4,0,0,160
65682216,26,59,54,42,22,8,0,0,211
65682217,31,47,53,43,23,2,0,0,199
65682218,27,32,29,30,7,4,0,0,129
65682301,38,49,48,39,21,6,0,0,201
65682302,49,60,50,49,15,7,1,0,231
65682303,66,80,69,44,16,9,2,0,286
65682304,56,76,45,29,18,8,0,4,236
65682305,69,66,40,35,7,4,1,2,224
65682306,75,99,104,48,28,6,5,5,370
65682307,75,117,75,75,20,9,2,3,376
65682308,81,105,89,79,32,17,5,4,412
65682309,77,91,79,51,25,10,0,3,336
65682310,42,75,45,65,18,3,3,3,254
65682311,44,67,57,44,21,12,3,2,250
65682401,56,96,84,76,33,14,4,2,365
65682402,43,86,69,73,24,9,5,1,310
65682403,55,59,46,24,13,2,2,1,202
65682404,60,114,97,61,33,9,3,7,384
65682405,66,99,88,57,33,10,3,3,359
65682406,42,65,54,55,18,8,5,2,249
65682407,46,77,66,36,27,11,3,3,269
65682408,55,88,94,82,46,20,7,7,399
65682409,34,51,65,46,25,8,3,4,236
65682410,34,60,48,44,21,11,3,7,228
65682501,35,51,40,29,12,6,2,2,177
65682502,51,97,71,56,24,14,1,0,314
65682503,73,100,67,71,30,9,5,3,358
65682504,60,115,78,87,35,22,5,1,403
65682505,30,61,47,41,19,9,3,6,216
65682506,75,104,98,91,48,25,16,6,463
65682507,48,92,99,86,51,34,7,17,434
65682508,39,73,93,93,41,18,11,10,378
65682509,44,54,61,68,40,29,11,9,316
65682510,41,68,71,55,40,30,7,14,326
65682511,47,93,101,82,52,27,11,7,420
65682512,54,93,95,84,40,20,12,5,403
65682601,45,85,51,31,12,7,2,0,233
65682602,77,85,82,73,31,6,1,4,359
65682603,74,97,68,56,30,15,8,8,356
65682604,35,56,45,51,14,9,1,1,212
65682605,30,47,42,33,16,6,1,0,175
65682606,45,48,53,33,26,7,3,3,218
65682607,63,102,86,80,46,22,5,8,412
65682608,29,59,60,51,19,5,3,1,227
65682609,39,67,48,40,24,6,4,1,229
65682610,57,92,87,79,36,19,7,2,379
65682611,57,90,73,70,40,19,11,5,365
65682612,63,99,77,73,29,16,5,5,367
65682701,2,1,4,5,1,2,0,0,15
65682702,36,68,52,60,39,45,7,31,338
65682703,33,58,63,74,35,22,9,11,305
65682704,41,54,66,65,44,22,3,12,307
65682705,35,47,52,49,34,24,5,1,247
65682706,31,69,67,58,36,22,5,4,292
65682707,46,77,85,81,36,25,4,5,359
65682708,43,54,59,65,37,10,4,1,273
65682709,46,87,74,66,33,13,3,5,327
65682710,52,69,59,44,33,12,5,4,278
65682711,46,84,70,60,39,19,2,3,323
65682801,85,86,85,89,56,26,8,10,445
65682802,53,78,86,83,36,19,6,6,367
65682803,67,107,91,107,64,38,11,15,500
65682804,30,59,52,59,30,12,8,7,257
65682805,57,97,88,95,49,32,16,11,445
65682806,29,76,64,78,60,25,8,13,353
65682807,37,47,52,54,30,16,1,6,243
65682808,35,60,53,53,48,23,7,10,289
65682809,49,73,77,86,41,29,5,13,373
65682810,42,68,95,83,45,46,9,10,398
65682901,44,74,69,81,37,19,5,9,338
65682902,56,88,58,65,33,11,11,6,328
65682903,26,53,65,48,41,15,4,7,259
65682904,35,43,62,73,42,18,10,4,287
65682905,38,47,50,63,31,23,4,7,263
65682906,36,63,55,61,27,18,8,5,273
65682907,41,74,71,67,41,20,10,10,334
65682908,33,51,41,62,38,35,7,13,280
65682909,38,62,77,74,34,22,10,9,326
65682910,22,39,65,71,26,31,11,16,281
65682911,41,97,104,113,79,44,27,31,536
65682912,45,55,78,70,52,24,17,11,352
65682913,24,44,63,61,41,28,10,9,280
65682914,17,41,53,72,33,21,10,15,262
65683001,56,80,76,77,34,32,10,11,376
65683002,70,100,87,101,44,19,12,7,440
65683003,62,103,87,93,51,29,8,8,441
65683004,65,91,99,104,67,16,7,8,457
65683005,40,43,66,52,36,16,3,9,265
65683006,35,63,64,72,31,10,7,7,289
65683007,52,95,95,90,60,21,13,9,435
65683008,51,79,91,80,44,21,6,8,380
65683009,44,69,61,60,45,25,4,6,314
65683010,62,90,88,93,43,32,8,13,429
65683011,66,98,80,94,46,32,6,5,427
65683101,74,95,88,76,50,16,6,11,416
65683102,60,85,96,88,40,20,4,5,398
65683103,46,50,83,73,39,26,7,10,334
65683104,72,90,90,107,52,42,6,13,472
65683105,30,56,78,80,52,32,8,8,344
65683106,51,63,54,74,32,28,10,10,322
65683107,64,100,87,85,38,19,5,4,402
65683108,37,52,49,51,19,10,6,1,225
65683109,43,68,64,69,39,30,5,10,328
65683110,35,51,66,73,33,22,10,6,296
65683111,28,41,53,36,19,11,9,7,204
65683112,53,82,76,80,32,37,13,11,384
66580101,0,1,1,0,0,0,0,0,2
66580102,61,112,84,59,40,16,4,2,378
66580103,65,109,70,74,25,5,1,1,350
66580104,49,77,56,36,25,4,1,1,249
66580105,53,105,64,61,16,7,0,1,307
66580106,53,92,76,52,32,9,2,3,319
66580107,51,70,47,36,26,10,2,1,243
66580108,40,92,46,52,14,6,2,0,252
66580109,66,82,71,50,20,12,7,7,315
66580110,64,112,99,112,56,33,12,20,508
66580111,2,0,0,0,0,0,1,0,3
66580112,20,15,4,6,2,2,0,1,50
66580113,7,7,4,5,4,1,0,0,28
66580201,24,20,9,15,16,7,5,7,103
66580202,45,54,44,44,26,31,6,5,255
66580203,29,38,49,43,37,25,15,13,249
66580204,41,30,56,52,41,38,16,16,290
66580205,33,45,51,42,35,12,7,6,231
66580206,63,102,87,77,52,26,10,11,428
66580207,45,42,45,55,41,41,8,21,298
66580208,44,61,66,62,38,24,18,13,326
66580209,45,63,68,51,35,14,3,8,287
66580210,48,52,65,53,35,18,5,4,280
66580211,43,55,70,71,45,41,24,36,385
66580212,51,62,63,52,31,14,7,7,287
66580301,37,55,60,67,43,22,9,20,313
66580302,35,42,62,56,53,40,16,25,329
66580303,47,79,86,78,46,17,6,3,362
66580304,40,70,71,72,26,13,5,2,299
66580305,58,95,76,79,36,18,12,12,386
66580306,51,79,60,64,27,17,4,5,307
66580307,61,115,61,80,41,7,9,4,378
66580308,76,120,103,85,50,21,8,7,470
66580309,85,107,127,89,22,17,5,0,452
66580310,55,96,67,62,21,6,1,3,311
66580311,50,68,51,56,27,4,1,2,259
66580401,47,55,26,36,8,5,4,6,187
66580402,36,79,70,94,25,17,8,7,336
66580403,37,71,65,79,53,25,4,4,338
66580404,40,46,66,45,31,20,10,13,271
66580405,37,63,54,77,27,19,4,3,284
66580406,43,64,62,66,21,13,7,7,283
66580407,29,54,71,52,59,14,7,6,292
66580408,77,81,103,74,35,18,5,8,401
66580409,82,94,80,53,28,5,0,3,345
66580410,64,92,80,66,15,6,2,1,326
66580411,45,80,80,74,37,16,7,0,339
66580412,65,98,89,89,30,18,7,2,398
66580413,39,71,64,38,19,5,2,1,239
66580414,23,44,44,48,29,7,1,2,198
66580415,49,77,57,58,21,17,7,2,288
66580501,38,58,48,48,23,5,2,2,224
66580502,24,54,38,34,13,7,0,1,171
66580503,51,81,72,50,27,8,4,6,299
66580504,34,45,44,47,21,8,0,4,203
66580505,38,48,40,58,26,12,4,3,229
66580506,37,82,62,71,34,13,4,4,307
66580507,56,112,105,92,30,11,4,3,413
66580508,49,83,62,61,30,17,5,5,312
66580509,63,103,69,70,27,22,4,5,363
66580510,31,54,43,31,16,2,2,1,180
66580511,52,94,73,69,46,15,3,4,356
66580512,40,73,54,51,28,14,2,4,266
66580513,50,62,62,58,31,10,5,3,281
66580514,47,65,68,59,30,15,1,1,286
66580601,58,79,38,40,13,9,0,0,237
66580602,69,75,54,55,18,4,0,0,275
66580603,69,99,62,57,16,10,1,0,314
66580604,50,97,46,64,17,9,0,1,284
66580605,74,95,65,52,19,4,2,3,314
66580606,40,52,53,34,13,1,1,2,196
66580607,52,79,61,51,16,9,1,0,269
66580608,26,49,52,32,9,3,3,0,174
66580609,68,107,91,78,34,18,4,3,403
66580610,51,105,75,77,32,11,5,2,358
66580611,58,102,76,62,26,13,3,6,346
66580612,47,83,76,52,11,11,2,0,282
66580701,49,79,62,50,15,6,2,0,263
66580702,39,98,45,53,18,5,0,1,259
66580703,50,73,63,67,18,4,0,0,275
66580704,52,102,61,60,17,8,1,1,302
66580705,54,83,63,56,11,2,0,0,269
66580706,44,76,54,53,22,13,6,2,270
66580707,43,63,59,44,28,18,5,12,272
66580708,42,67,73,85,62,32,5,10,376
66580709,39,55,48,58,44,22,10,29,305
66580710,44,71,74,103,66,52,21,33,464
66580711,40,43,60,65,32,10,3,7,260
66580801,46,46,36,23,10,2,0,0,163
66580802,96,64,29,12,3,1,0,0,205
66580803,60,63,30,11,2,2,1,0,169
66580804,88,106,66,54,12,2,0,0,328
66580805,129,103,47,31,7,3,1,1,322
66580806,81,77,27,15,3,1,1,0,205
66580807,66,47,47,31,10,4,3,0,208
66580808,99,69,35,11,2,0,0,0,216
66580809,137,77,47,25,6,0,0,0,292
66580810,99,67,18,13,1,0,0,0,198
66580811,126,94,38,26,5,3,0,0,292
66580812,110,62,36,4,4,2,0,0,218
66580813,57,49,20,9,3,0,0,0,138
66580814,94,54,35,11,5,0,0,0,199
66580815,62,58,21,13,2,0,0,1,157
66580901,47,92,70,69,39,14,1,2,334
66580902,45,93,76,66,32,6,3,2,323
66580903,64,96,40,59,12,6,0,1,278
66580904,21,14,9,6,2,1,0,0,53
66580905,104,69,18,13,3,0,0,1,208
66580906,79,98,48,27,11,0,0,0,263
66580907,67,82,25,15,6,0,0,0,195
66580908,48,66,27,18,4,1,0,2,166
66580909,55,67,38,13,6,3,1,0,183
66580910,101,92,64,40,2,3,0,0,302
66580911,65,62,27,28,4,2,0,0,188
66580912,80,79,31,24,7,1,0,0,222
66580913,75,70,46,28,15,4,1,0,239
66581001,60,30,51,40,50,39,15,22,307
66581002,43,55,62,78,42,38,19,26,363
66581003,37,70,56,51,29,15,2,4,264
66581004,54,66,62,51,18,1,1,2,255
66581005,112,137,77,66,22,3,0,0,417
66581006,43,75,46,39,16,8,0,2,229
66581007,80,117,75,76,18,10,2,1,379
66581008,77,103,54,43,19,7,1,0,304
66581009,62,73,57,49,15,4,1,0,261
66581010,63,83,50,64,15,7,3,3,288
66581011,73,95,72,55,34,12,3,9,353
66581012,65,60,72,66,65,46,19,34,427
66581013,30,36,55,35,27,30,8,12,233
66581101,64,87,79,47,27,8,2,1,315
66581102,69,63,65,40,15,6,0,2,260
66581103,45,77,54,39,12,4,1,0,232
66581104,46,58,46,41,8,4,3,0,206
66581105,39,48,35,25,11,3,1,0,162
66581106,56,68,69,49,22,5,1,2,272
66581107,67,81,56,52,19,12,2,0,289
66581108,43,80,55,71,22,3,2,0,276
66581109,71,87,58,58,21,5,1,0,301
66581110,67,98,63,50,24,3,1,0,306
66581111,47,71,37,49,23,2,4,1,234
66581112,61,91,58,48,18,7,3,0,286
66581113,43,63,42,44,18,4,0,1,215
66581201,90,89,107,92,39,12,4,7,440
66581202,64,94,75,71,34,10,2,3,353
66581203,76,108,78,79,35,16,9,10,411
66581204,96,134,80,57,24,5,1,1,398
66581205,58,102,65,65,26,7,2,0,325
66581206,87,102,57,32,26,1,1,1,307
66581207,99,109,41,29,6,0,1,1,286
66581208,94,109,55,40,7,3,0,0,308
66581209,47,82,76,53,25,3,0,1,287
66581210,60,105,49,50,10,6,1,0,281
66581211,73,99,76,67,17,9,2,1,344
66581212,71,83,80,67,24,9,3,0,337
66581213,74,73,48,50,11,7,1,0,264
66581301,20,29,31,34,26,13,8,9,170
66581302,10,28,26,31,17,9,11,5,137
66581303,14,21,16,29,14,7,5,3,109
66581304,33,57,47,44,23,17,14,6,241
66581305,11,26,39,31,13,8,6,2,136
66581306,14,50,39,44,29,18,9,11,214
66581307,36,57,58,53,32,21,8,8,273
66581308,38,32,46,53,38,10,8,10,235
66581309,35,51,78,52,28,11,5,8,268
66581310,21,49,54,37,30,18,10,7,226
66581401,18,21,30,31,15,15,9,13,152
66581402,10,14,4,11,10,6,3,7,65
66581403,10,14,13,13,9,13,2,7,81
66581404,27,24,39,29,28,20,9,12,188
66581405,16,19,25,18,19,20,2,12,131
66581406,20,14,35,19,18,13,6,10,135
66581407,27,31,53,56,43,28,7,16,261
66581408,25,33,37,45,27,24,8,18,217
66581409,81,61,74,65,48,54,14,37,434
66581410,16,40,48,33,25,23,3,15,203
66581501,43,72,58,40,24,13,2,2,254
66581502,66,66,63,49,34,19,2,3,302
66581503,34,64,69,74,41,21,7,15,325
66581504,25,37,40,31,21,13,3,1,171
66581505,68,79,86,55,46,25,7,5,371
66581506,36,46,39,33,14,12,1,2,183
66581507,43,76,56,55,19,9,3,1,262
66581508,67,74,52,48,22,7,5,2,277
66581509,54,98,75,70,37,10,1,3,348
66581510,41,66,54,40,21,9,0,2,233
66581511,32,67,47,40,15,6,0,0,207
66581512,48,73,50,35,23,3,1,1,234
66581513,44,67,66,43,16,3,1,1,241
66581601,63,78,50,50,13,4,3,0,261
66581602,74,80,52,28,23,2,0,1,260
66581603,57,67,44,53,13,6,1,0,241
66581604,40,58,43,31,9,3,2,0,186
66581605,40,65,45,39,16,4,0,0,209
66581606,45,85,62,45,22,4,1,1,265
66581607,29,86,54,43,9,7,2,1,231
66581608,59,70,55,47,11,7,1,1,251
66581609,54,93,63,58,16,7,1,0,292
66581610,44,75,44,38,14,4,1,1,221
66581611,36,66,51,54,15,3,1,1,227
66581612,51,69,58,48,20,5,1,1,253
66581701,65,84,59,62,22,5,2,1,300
66581702,51,90,49,56,12,9,1,0,268
66581703,59,79,52,34,23,6,1,0,254
66581704,60,94,56,46,22,9,1,3,291
66581705,78,101,66,56,10,9,2,0,322
66581706,41,94,94,77,22,14,2,1,345
66581707,54,88,62,62,23,7,1,1,298
66581708,87,106,76,69,26,15,1,0,380
66581709,74,112,72,70,27,7,2,0,364
66581710,55,81,70,45,19,6,0,2,278
66581711,71,90,77,72,35,11,3,2,361
66581712,79,91,80,42,18,5,2,0,317
66581801,25,49,18,32,7,0,0,1,132
66581802,36,47,28,23,14,2,0,0,150
66581803,29,75,32,39,14,0,3,0,192
66581804,67,80,69,38,17,6,2,0,279
66581805,50,89,56,50,15,9,1,1,271
66581806,70,82,66,47,11,5,3,2,286
66581807,52,70,48,30,14,9,0,2,225
66581808,74,82,52,41,14,5,1,0,269
66581809,72,79,79,51,19,9,1,0,310
66581810,54,57,45,32,15,5,2,1,211
66581811,71,77,40,34,16,6,1,2,247
66581812,43,41,32,21,8,1,0,2,148
66581901,67,82,48,26,2,3,0,0,228
66581902,56,88,51,49,18,2,0,1,265
66581903,54,46,41,40,11,8,1,0,201
66581904,54,53,42,35,7,1,1,0,193
66581905,37,58,47,41,16,4,3,1,207
66581906,34,63,43,32,12,5,0,1,190
66581907,35,56,42,33,19,1,0,1,187
66581908,58,73,68,47,12,12,1,5,276
66581909,56,60,59,41,18,4,2,1,241
66581910,48,60,62,62,27,13,1,4,277
66581911,31,55,67,95,35,14,3,5,305
66582001,44,75,61,69,29,13,6,4,301
66582002,94,110,59,39,10,6,1,0,319
66582003,55,84,83,102,48,28,8,13,421
66582004,39,64,79,72,45,26,11,13,349
66582005,37,58,80,75,53,36,15,7,361
66582006,16,39,43,56,43,32,9,16,254
66582007,29,48,56,60,35,24,3,4,259
66582008,33,61,72,73,68,42,18,19,386
66582009,83,117,114,108,73,42,12,17,566
66582010,65,108,120,101,63,31,15,7,510
66582011,51,92,94,90,52,49,6,7,441
66582101,46,120,135,98,51,24,7,11,492
66582102,53,86,99,102,69,44,9,16,478
66582103,52,104,120,122,46,28,14,9,495
66582104,32,58,76,73,53,37,8,16,353
66582105,35,70,87,93,53,23,19,12,392
66582106,41,95,84,119,59,41,18,12,469
66582107,51,72,135,164,96,49,15,14,596
66582108,70,85,113,117,86,66,21,24,582
66582109,50,55,68,71,47,50,8,18,367
66582110,41,59,63,57,43,28,10,6,307
66582111,45,71,119,110,69,24,5,8,451
66582112,53,94,132,105,74,52,23,20,553
66582113,84,73,96,104,70,34,20,24,505
66582114,49,70,82,64,45,37,13,6,366
66582115,24,39,53,77,41,34,14,14,296
66582116,20,32,50,66,52,31,19,13,283
66582201,59,88,75,68,29,7,2,0,328
66582202,66,112,60,53,26,10,2,0,329
66582203,55,88,74,57,30,9,1,0,314
66582204,60,76,61,40,18,4,4,3,266
66582205,42,59,50,51,24,4,2,0,232
66582206,43,66,54,46,25,6,1,1,242
66582207,59,83,77,50,19,10,0,0,298
66582208,37,56,47,54,19,4,2,4,223
66582209,66,90,96,87,56,36,10,15,456
66582210,59,78,104,72,43,13,5,5,379
66582211,60,111,80,69,30,13,4,1,368
66582301,43,71,55,50,26,12,5,0,262
66582302,60,99,67,77,38,29,3,6,379
66582303,70,114,121,88,33,16,6,2,450
66582304,37,74,80,54,31,28,9,11,324
66582305,59,73,85,66,21,21,1,3,329
66582306,31,53,49,46,19,9,3,3,213
66582307,44,58,42,32,13,7,1,1,198
66582308,47,54,47,47,15,4,1,1,216
66582309,41,66,81,73,49,33,16,12,371
66582310,50,65,79,80,49,23,10,22,378
66582311,46,75,74,68,33,19,5,5,325
66582312,49,86,56,59,19,5,4,0,278
66582401,53,86,77,63,24,12,1,0,316
66582402,66,101,76,58,31,11,0,2,345
66582403,65,120,89,107,38,14,3,3,439
66582404,52,96,50,59,18,6,0,3,284
66582405,59,85,68,54,22,13,5,3,309
66582406,66,93,74,68,34,16,4,3,358
66582407,62,74,70,72,27,14,1,3,323
66582408,54,71,58,50,28,7,2,1,271
66582409,48,85,60,56,14,6,0,1,270
66582410,42,65,52,45,22,7,2,1,236
66582411,57,71,57,36,17,5,0,2,245
66582412,41,57,71,52,12,4,0,0,237
66582501,40,69,47,50,12,5,1,0,224
66582502,53,66,55,38,15,5,5,1,238
66582503,56,78,73,63,23,9,1,1,304
66582504,45,79,47,47,8,7,1,0,234
66582505,58,74,61,56,24,6,1,1,281
66582506,67,90,63,55,20,7,1,1,304
66582507,45,80,51,65,15,7,1,1,265
66582508,53,104,81,52,23,11,3,4,331
66582509,43,82,42,35,20,4,2,3,231
66582510,66,108,66,69,26,14,4,1,354
66582511,79,61,98,56,37,41,4,15,391
66582512,53,56,60,55,34,30,19,22,329
66582513,57,100,81,72,41,20,1,3,375
66582514,21,44,27,28,14,3,2,2,141
66582601,74,126,112,115,42,25,15,8,517
66582602,65,88,114,99,46,34,7,10,463
66582603,56,90,74,67,34,15,4,1,341
66582604,69,97,70,58,32,15,5,3,349
66582605,56,79,54,45,26,10,0,3,273
66582606,74,100,70,59,18,15,3,2,341
66582607,53,80,64,50,23,6,0,2,278
66582608,43,88,56,48,22,6,0,3,266
66582609,40,72,54,47,19,6,0,3,241
66582610,71,107,78,81,18,12,0,1,368
66582701,51,75,70,84,46,34,13,16,389
66582702,44,56,81,54,39,38,5,10,327
66582703,14,16,40,42,36,16,5,12,181
66582704,13,27,26,21,17,11,2,8,125
66582705,6,18,26,32,18,11,7,2,120
66582706,50,78,83,82,50,33,9,17,402
66582707,34,62,52,56,28,24,13,19,288
66582708,24,24,44,51,33,23,6,9,214
66582709,60,78,85,100,66,34,20,14,457
66582710,32,48,63,64,37,24,13,7,288
66582711,51,80,86,87,50,39,13,16,422
66582712,52,63,70,70,42,42,15,16,370
66582713,37,57,72,60,41,14,14,12,307
66582714,15,41,44,61,32,20,6,14,233
66582715,33,41,65,63,41,14,9,25,291
66582716,28,48,37,47,28,13,5,11,217
66582801,38,56,47,46,23,4,2,2,218
66582802,61,86,70,78,42,18,0,4,359
66582803,54,93,51,62,24,5,2,2,293
66582804,59,102,81,84,22,11,4,5,368
66582805,47,68,50,50,29,16,3,5,268
66582806,45,61,62,82,52,38,13,15,368
66582807,31,66,52,60,55,32,14,22,332
66582808,61,95,79,97,48,27,12,12,431
66582809,60,84,76,67,46,22,3,12,370
66582810,71,101,80,83,34,13,4,2,388
66582901,83,103,85,98,34,20,5,4,432
66582902,51,70,69,54,18,8,1,2,273
66582903,39,63,53,33,25,4,0,2,219
66582904,28,79,57,57,21,11,1,4,258
66582905,62,80,86,58,34,15,5,5,345
66582906,48,91,67,78,42,21,12,11,370
66582907,37,72,91,74,48,37,8,7,374
66582908,44,37,76,91,66,49,11,17,391
66582909,34,28,54,54,53,30,15,27,295
66582910,45,59,76,70,61,37,13,17,378
66582911,50,86,76,72,44,21,7,4,360
66582912,67,90,81,91,60,29,13,21,452
66583001,65,115,81,71,33,19,3,2,389
66583002,68,87,88,67,34,15,7,8,374
66583003,49,69,72,54,49,13,1,4,311
66583004,46,78,58,52,17,9,1,1,262
66583005,76,82,73,75,42,13,5,7,373
66583006,50,78,71,73,33,15,9,7,336
66583007,36,84,93,93,46,32,11,11,406
66583008,36,53,73,102,77,23,13,12,389
66583009,45,80,111,94,65,43,8,11,457
66583010,43,64,75,73,42,30,8,16,351
66583011,62,80,71,79,46,24,15,20,397
66583012,34,56,55,59,37,16,8,10,275
66583101,53,112,69,54,13,6,2,1,310
66583102,68,110,78,92,25,5,5,4,387
66583103,95,175,141,138,68,29,10,2,658
66583104,93,115,95,87,39,21,3,3,456
66583105,41,76,59,101,32,6,4,4,323
66583106,178,241,234,226,102,47,15,10,1053
66583107,58,109,64,47,20,8,6,2,314
66583108,46,53,65,42,15,5,3,1,230
66583109,49,71,67,52,18,7,3,3,270
66583110,70,105,80,91,47,15,8,4,420
66583111,46,78,105,91,38,19,6,9,392
66583112,44,55,56,52,13,9,2,4,235
66583113,35,51,54,27,20,10,0,2,199
66583201,31,56,71,47,19,10,6,1,241
66583202,52,98,92,83,39,13,3,4,384
66583203,57,94,80,82,35,11,3,3,365
66583204,16,44,57,45,18,7,4,2,193
66583205,37,64,62,66,21,12,7,5,274
66583206,14,19,25,25,12,8,2,2,107
66583207,86,134,124,104,49,16,8,2,523
66583208,85,128,138,120,48,14,6,9,548
66583209,25,32,35,30,12,6,2,6,148
66583210,68,107,83,66,52,41,17,11,445
66583211,25,38,47,30,22,15,9,9,195
66583212,80,101,127,107,50,26,15,10,516
66583213,37,51,74,65,50,28,4,6,315
66583301,61,100,123,112,73,38,21,25,553
66583302,24,36,69,74,63,47,16,31,360
66583303,26,43,61,76,57,49,15,16,343
66583304,35,49,67,60,50,39,13,39,352
66583305,62,88,130,131,93,69,28,36,637
66583306,38,72,101,91,68,36,16,25,447
66583307,48,79,92,87,58,24,10,10,408
66583308,22,34,46,56,28,11,4,3,204
66583309,76,95,96,74,51,25,4,9,430
66583310,47,79,56,55,25,11,1,2,276
66583311,60,92,84,77,42,13,3,3,374
66583312,45,67,75,80,35,8,1,1,312
66583313,20,44,67,77,39,18,7,4,276
66583401,70,98,91,76,34,18,10,6,403
66583402,30,50,84,79,44,20,6,6,319
66583403,45,66,71,70,42,23,3,6,326
66583404,53,73,72,66,31,20,12,6,333
66583405,37,66,64,83,45,12,2,5,314
66583406,54,118,82,77,39,24,2,4,400
66583407,45,88,90,52,19,11,3,1,309
66583408,56,97,65,62,35,17,4,4,340
66583409,33,68,62,77,26,15,3,4,288
66583410,44,65,55,45,17,11,3,5,245
66583411,67,79,78,97,45,18,5,2,391
66583412,51,80,84,96,41,14,5,5,376
66583413,54,106,96,79,49,17,5,3,409
66583501,53,80,72,51,33,22,6,7,324
66583502,49,95,78,91,42,16,13,10,394
66583503,39,77,58,50,35,13,3,6,281
66583504,44,83,85,80,37,29,8,12,378
66583505,52,64,55,54,29,12,3,2,271
66583506,61,99,89,91,49,16,5,6,416
66583507,61,73,69,66,39,14,11,2,335
66583508,53,84,97,80,41,30,9,12,406
66583509,40,80,72,62,47,17,5,9,332
66583510,57,85,79,102,54,47,22,22,468
66583601,43,83,111,104,79,69,8,27,524
66583602,57,90,104,105,80,47,26,26,535
66583603,64,94,77,69,37,17,3,6,367
66583604,41,65,52,41,29,14,3,4,249
66583605,48,80,71,78,33,24,5,6,345
66583606,44,51,53,49,26,13,2,5,243
66583607,70,122,115,104,55,25,16,15,522
66583608,36,64,64,56,38,21,6,8,293
66583609,45,79,80,55,46,23,13,11,352
66583610,42,68,65,80,33,12,7,2,309
66583611,60,100,90,84,65,40,11,16,466
66583612,41,74,72,89,56,36,15,15,398
66583613,43,58,53,79,50,26,10,17,336
66583614,36,54,61,63,41,28,15,12,310
66583701,46,69,113,88,78,54,19,24,491
66583702,80,126,140,127,73,40,21,26,633
66583703,30,43,58,46,39,39,10,10,275
66583704,40,27,44,38,30,30,6,18,233
66583705,25,43,40,40,19,20,9,10,206
66583706,17,47,55,70,49,29,19,21,307
66583707,46,64,94,103,66,42,13,19,447
66583708,34,59,84,83,53,46,10,29,398
66583709,31,61,70,68,34,36,7,3,310
66583710,28,48,51,68,34,24,13,6,272
66583711,65,101,118,120,66,43,10,16,539
66583712,48,84,97,116,90,47,11,19,512
66583713,53,77,110,120,81,48,16,19,524
66583801,53,60,115,110,73,64,24,26,525
66583802,33,75,103,115,72,46,17,29,490
66583803,28,33,64,53,28,22,14,9,251
66583804,46,45,66,79,68,39,10,14,367
66583805,50,76,99,91,59,33,12,27,447
66583806,41,52,88,102,65,44,18,28,438
66583807,10,20,24,18,11,11,6,8,108
66583808,23,40,53,47,37,24,6,25,255
66583809,27,38,42,41,31,17,10,15,221
66583810,27,47,36,50,26,15,12,9,222
66583811,74,103,113,92,62,41,17,20,522
66583812,54,67,89,75,41,20,4,5,355
66583813,42,75,78,64,39,22,7,2,329
66583814,52,76,86,74,65,39,13,16,421
66583815,56,86,89,119,52,29,6,14,451
66583816,82,119,105,120,78,67,16,17,604
66583901,64,83,91,81,61,44,15,10,449
66583902,39,90,93,89,50,33,13,11,418
66583903,42,75,78,86,55,47,14,6,403
66583904,40,46,42,61,26,13,7,7,242
66583905,52,73,97,86,50,27,8,18,411
66583906,24,54,72,71,46,27,13,11,318
66583907,37,77,69,85,47,35,12,8,370
66583908,36,63,55,53,45,25,8,7,292
66583909,32,42,51,50,30,26,5,4,240
66583910,57,91,104,101,76,44,22,26,521
66584001,43,62,91,82,65,48,19,28,438
66584002,31,36,60,48,70,34,10,40,329
66584003,42,34,42,56,46,39,18,24,301
66584004,44,38,78,101,81,59,19,36,456
66584005,19,40,70,93,44,43,17,22,348
66584006,15,31,30,18,22,15,5,7,143
66584007,47,85,89,98,47,29,17,17,429
66584008,26,55,62,51,45,31,7,7,284
66584009,12,31,44,39,24,23,9,13,195
66584010,9,17,35,43,27,18,11,12,172
66584011,16,34,48,44,32,18,11,9,212
66584012,31,64,90,94,48,30,13,19,389
66584013,40,56,69,72,42,22,15,17,333
66584014,20,52,73,66,47,23,9,6,296
66584015,43,92,129,118,80,53,11,25,551
66584016,39,69,76,59,42,32,12,10,339
66584017,60,99,85,103,67,34,19,20,487
66584101,61,47,68,64,46,27,9,8,330
66584102,49,89,124,143,95,67,25,39,631
66584103,61,78,96,82,59,18,14,13,421
66584104,55,104,88,87,67,29,17,19,466
66584105,47,91,84,95,49,36,11,13,426
66584106,54,110,100,100,59,36,10,6,475
66584107,43,99,112,117,59,38,10,19,497
66584108,45,76,88,96,56,38,9,17,425
66584109,54,85,101,98,64,33,13,20,468
66584110,53,75,102,104,66,50,14,18,482
66584111,27,40,48,57,34,27,7,13,253
66584112,47,50,46,76,40,26,12,16,313
66584113,46,79,112,99,83,50,12,14,495
66584114,45,55,67,65,47,20,6,15,320
66584115,36,56,48,61,56,27,10,16,310
66584201,35,53,49,41,26,29,9,8,250
66584202,33,69,64,51,36,20,2,8,283
66584203,56,76,80,90,54,24,10,11,401
66584204,52,80,70,70,27,23,8,8,338
66584205,33,47,55,62,35,31,8,17,288
66584206,34,55,60,55,28,26,9,6,273
66584207,21,51,54,43,24,28,1,4,226
66584208,52,63,74,73,36,22,14,7,341
66584209,70,90,103,101,64,20,11,8,467
66584210,66,84,78,83,36,25,6,8,386
66584211,53,68,58,46,30,8,5,8,276
66584212,58,104,89,69,49,22,8,5,404
66584213,49,90,92,111,57,29,9,13,450
66584301,31,53,72,77,36,13,4,4,290
66584302,43,96,107,77,52,22,9,14,420
66584303,52,97,129,102,57,28,12,21,498
66584304,53,60,92,96,65,54,21,39,480
66584305,36,46,47,76,39,37,8,26,315
66584306,29,56,87,73,52,42,15,16,370
66584307,12,33,53,52,42,31,10,14,247
66584308,60,77,104,96,63,36,19,15,470
66584309,33,58,43,48,30,11,10,4,237
66584310,31,50,47,45,26,16,5,12,232
66584311,52,71,54,89,48,26,10,13,363
66584312,64,99,87,69,41,17,7,2,386
66584401,34,61,59,78,43,30,9,15,329
66584402,40,64,76,75,42,22,12,21,352
66584403,35,69,93,83,52,33,16,23,404
66584404,69,98,111,98,82,46,28,26,558
66584405,33,63,73,88,55,33,7,9,361
66584406,41,66,80,69,60,19,7,7,349
66584407,41,46,51,43,24,11,5,8,229
66584408,62,89,99,93,40,32,8,9,432
66584409,58,81,124,110,66,47,16,28,530
66584410,47,58,84,87,59,40,14,13,402
66584411,56,79,102,100,69,42,25,30,503
66584412,38,64,94,80,48,33,11,25,393
66584413,10,26,32,32,18,9,7,11,145
66584414,18,25,32,43,29,20,10,10,187
67490101,6,1,4,2,8,1,2,1,25
67490102,47,70,61,63,48,44,18,27,378
67490103,70,88,77,53,27,13,3,4,335
67490104,22,20,24,23,21,13,6,3,132
67490105,16,31,41,30,10,12,2,5,147
67490201,51,48,27,39,18,5,8,2,198
67490202,55,81,73,86,41,22,3,1,362
67490203,77,89,62,64,33,10,2,4,341
67490204,73,103,70,67,21,18,1,1,354
67490205,38,92,65,65,48,13,4,3,328
67490206,19,41,26,20,9,5,0,1,121
67490207,43,49,43,59,28,19,2,3,246
67490208,40,65,50,60,41,32,7,2,297
67490209,40,114,75,66,33,13,2,0,343
67490210,52,107,63,66,37,18,0,4,347
67490211,27,81,56,58,31,7,2,1,263
67490212,35,63,53,46,23,13,3,1,237
67490213,48,84,59,47,17,5,1,1,262
67490301,77,98,58,50,24,10,0,2,319
67490302,35,52,20,21,12,2,0,1,143
67490303,70,75,35,33,11,4,0,0,228
67490304,85,106,63,55,21,9,3,2,344
67490305,67,74,66,54,24,3,3,1,292
67490306,28,44,37,26,17,10,2,3,167
67490307,32,63,46,43,23,7,2,0,216
67490308,48,79,56,44,19,7,0,2,255
67490309,71,73,37,40,11,6,0,1,239
67490310,76,71,54,39,10,4,1,2,257
67490311,106,129,42,29,8,2,0,0,316
67490312,96,125,62,50,19,10,1,1,364
67490401,12,14,23,24,9,5,2,2,91
67490402,13,20,15,20,12,11,2,5,98
67490403,71,52,53,32,14,5,0,1,228
67490404,109,113,56,29,7,3,0,0,317
67490405,16,13,13,19,18,12,5,4,100
67490406,52,74,46,59,20,8,2,4,265
67490501,30,48,34,29,13,2,0,1,157
67490502,56,58,56,55,19,3,2,0,249
67490503,92,85,52,40,16,5,0,1,291
67490504,98,100,50,40,14,4,3,0,309
67490505,75,100,38,23,15,1,0,1,253
67490506,132,111,42,12,3,2,0,1,303
67490507,69,78,24,15,5,4,0,0,195
67490508,56,55,31,13,11,4,0,0,170
67490509,65,79,47,27,12,9,0,1,240
67490510,52,82,52,36,11,3,0,0,236
67490511,44,51,24,16,9,1,0,0,145
67490512,86,67,28,7,7,4,0,1,200
67490513,38,45,21,14,5,2,0,0,125
67490601,50,57,39,34,17,6,1,0,204
67490602,126,104,54,36,9,1,1,0,331
67490603,78,123,62,53,20,8,0,4,348
67490604,49,68,29,40,15,9,5,1,216
67490605,84,78,48,56,30,7,2,1,306
67490701,64,89,80,67,42,24,4,12,382
67490702,58,78,49,55,26,11,2,5,284
67490703,50,90,55,55,25,10,4,3,292
67490704,63,83,88,64,45,22,2,2,369
67490705,80,103,110,80,43,20,7,8,451
67490706,57,83,70,47,32,10,1,4,304
67490707,84,101,77,74,24,10,2,3,375
67490708,73,96,95,87,51,20,10,6,438
67490709,24,43,40,49,30,22,16,14,238
67490801,48,77,56,48,25,9,4,5,272
67490802,24,50,50,21,20,6,2,5,178
67490803,41,54,50,48,22,9,6,6,236
67490804,41,61,69,73,46,35,10,11,346
67490805,54,88,79,83,48,32,9,11,404
67490806,59,68,67,41,32,25,9,9,310
67490807,72,118,99,76,49,22,10,7,453
67490808,67,75,90,65,34,36,8,3,378
67490809,60,78,71,52,35,23,8,4,331
67490901,82,80,52,54,31,12,4,7,322
67490902,59,97,65,59,49,26,10,7,372
67490903,44,87,112,86,53,27,13,25,447
67490904,67,104,92,82,57,16,7,4,429
67490905,45,68,115,90,50,27,12,9,416
67490906,39,71,59,62,41,26,6,20,324
67490907,53,73,44,46,22,7,2,1,248
67490908,44,82,61,58,42,19,7,7,320
67490909,60,84,79,61,25,15,1,4,329
67490910,51,68,62,37,29,9,1,4,261
67490911,62,95,93,83,38,30,3,5,409
67490912,83,83,106,79,46,24,5,8,434
67490913,5,23,30,23,15,9,7,16,128
67491001,81,112,111,89,52,19,11,7,482
67491002,53,67,86,82,39,25,7,7,366
67491003,66,104,99,70,40,17,11,4,411
67491004,60,88,92,70,43,18,3,6,380
67491005,72,108,87,86,37,17,5,6,418
67491006,63,123,70,80,43,17,3,1,400
67491007,42,86,50,57,32,13,6,5,291
67491008,13,28,28,42,40,18,3,2,174
67491009,34,62,62,61,34,23,8,5,289
67491010,26,49,66,40,29,9,4,4,227
67491011,51,88,97,76,44,17,4,7,384
67491012,26,39,53,69,66,37,0,10,300
67491013,35,42,48,32,16,11,3,4,191
67491101,22,55,70,72,35,20,5,16,295
67491102,50,54,71,49,61,43,13,34,375
67491103,29,43,60,58,29,25,11,21,276
67491104,31,42,52,40,19,12,6,4,206
67491105,28,66,77,47,38,18,12,3,289
67491106,37,48,42,41,27,14,2,5,216
67491107,32,68,76,75,47,23,4,5,330
67491108,19,32,24,41,27,15,13,11,182
67491109,31,30,37,16,20,13,4,3,154
67491110,35,66,68,76,45,24,8,7,329
67491111,32,75,67,51,36,25,3,6,295
67491112,34,61,53,42,19,15,2,3,229
67491113,70,83,103,70,40,24,12,6,408
67491114,58,78,96,69,35,31,7,19,393
67491201,44,62,67,72,43,29,3,7,327
67491202,62,70,67,60,41,35,3,4,342
67491203,58,74,73,91,60,42,17,31,446
67491204,59,89,89,89,48,28,8,13,423
67491205,52,109,111,81,35,22,4,3,417
67491206,35,38,52,57,36,25,15,15,273
67491207,42,52,60,48,33,27,4,20,286
67491208,49,77,74,79,35,18,2,6,340
67491209,32,58,46,38,34,17,14,7,246
67491210,46,63,96,70,53,22,14,13,377
67491211,57,58,88,88,39,28,15,21,394
67491301,38,38,48,64,41,44,23,37,333
67491302,25,45,78,65,76,67,25,56,437
67491303,15,26,41,71,64,25,6,17,265
67491304,44,59,103,73,61,41,21,32,434
67491305,47,77,71,77,57,40,22,27,418
67491306,43,68,78,81,84,45,16,27,442
67491307,0,0,1,1,2,2,2,1,9
67491308,36,38,51,43,40,17,7,10,242
67491309,32,47,67,55,40,11,5,9,266
67491310,41,58,62,48,34,23,4,2,272
67491311,31,61,53,43,28,21,5,4,246
67491312,39,52,69,51,33,16,12,6,278
67491313,33,66,55,65,33,17,4,7,280
67491314,35,51,72,71,33,25,1,7,295
67491315,31,42,56,45,30,13,8,5,230
67491316,74,93,103,98,61,30,19,26,504
67491317,28,42,58,58,35,26,10,7,264
67491318,47,57,62,64,41,22,8,10,311
67491319,54,50,68,71,37,28,14,15,337
67491320,23,37,45,47,44,34,9,16,255
67491321,30,38,43,42,21,16,5,9,204
67491401,36,48,44,23,17,13,7,11,199
67491402,36,89,74,55,30,11,3,5,303
67491403,26,56,65,66,30,27,8,7,285
67491404,33,50,65,63,41,23,4,10,289
67491405,39,63,67,65,36,27,9,11,317
67491406,38,60,59,71,36,38,12,13,327
67491407,41,66,76,80,49,33,5,15,365
67491408,34,55,60,65,48,35,16,12,325
67491409,40,45,75,66,52,33,12,15,338
67491410,39,41,55,54,33,27,9,19,277
67491411,16,13,17,21,8,11,5,6,97
67491412,62,89,83,89,44,14,6,10,397
67491413,63,99,101,69,47,21,2,8,410
67491414,53,89,111,77,48,25,5,6,414
67491415,51,81,83,70,35,16,7,12,355
67491416,32,51,61,69,42,35,6,24,320
67491417,36,63,86,79,72,66,22,43,467
67491418,39,35,19,23,24,10,4,2,156
67491419,27,58,73,74,49,40,28,38,387
67491420,15,22,42,43,35,20,16,17,210
67491501,11,4,8,4,0,0,1,1,29
67491502,11,14,15,16,11,4,3,1,75
67491503,7,7,10,4,3,1,1,1,34
67491504,15,23,12,18,4,10,0,4,86
67491505,23,18,12,13,6,6,1,1,80
67491506,6,5,2,3,5,1,1,1,24
67491507,15,3,3,2,3,1,0,2,29
67491508,15,17,6,7,6,5,1,1,58
67491509,17,34,17,17,9,6,4,3,107
67491510,29,31,18,12,18,4,4,4,120
67491511,34,32,20,21,12,5,5,2,131
67491512,29,17,19,12,14,7,1,3,102
67491513,20,12,10,15,10,4,1,3,75
67560101,44,49,54,61,21,15,1,0,245
67560102,38,32,25,24,27,22,2,2,172
67560103,13,33,29,40,55,14,12,5,201
67560104,43,78,63,53,44,14,7,5,307
67560105,33,66,50,58,39,21,7,1,275
67560106,41,74,34,45,41,17,3,2,257
67560107,109,150,70,54,37,19,3,1,443
67560108,58,58,38,25,12,2,2,2,197
67560109,69,64,37,37,8,4,0,0,219
67560110,56,117,101,76,35,12,4,3,404
67560111,51,58,40,34,12,3,0,0,198
67560112,65,98,53,50,35,22,5,2,330
67560113,55,83,55,57,41,12,2,3,308
67560114,70,102,86,66,37,20,5,4,390
67560115,44,77,49,24,12,4,3,1,214
67560116,78,103,73,62,28,10,1,1,356
67560117,61,88,68,68,30,19,5,5,344
67560201,40,65,52,52,38,17,7,4,275
67560202,31,61,41,41,36,15,3,9,237
67560203,82,74,76,80,43,22,11,6,394
67560204,40,57,55,58,29,20,9,10,278
67560205,52,44,66,61,37,19,8,9,296
67560206,54,74,55,47,22,12,8,6,278
67560207,53,84,69,53,39,25,6,2,331
67560208,52,49,30,37,35,15,5,2,225
67560209,155,89,40,15,3,0,0,0,302
67560301,55,72,25,22,9,2,0,0,185
67560302,50,46,19,14,3,0,1,0,133
67560303,68,63,32,24,10,2,1,0,200
67560304,107,83,36,15,5,3,1,0,250
67560305,58,59,15,7,0,1,0,0,140
67560306,46,46,27,18,7,4,0,0,148
67560307,161,158,47,23,7,4,0,0,400
67560308,101,96,38,25,5,3,0,0,268
67560309,86,81,43,20,8,0,0,0,238
67560310,122,125,46,27,7,0,1,0,328
67560401,56,69,46,50,30,8,4,2,265
67560402,69,68,42,54,34,15,7,1,290
67560403,51,79,81,52,31,24,6,4,328
67560404,59,73,47,50,43,11,3,2,288
67560405,35,74,59,57,44,24,8,7,308
67560406,29,62,42,45,27,14,3,1,223
67560407,51,69,58,63,39,18,1,2,301
67560408,43,59,36,36,18,0,2,1,195
67560501,41,62,53,42,39,16,5,5,263
67560502,44,77,43,49,40,20,2,6,281
67560503,56,66,50,36,25,9,1,0,243
67560504,29,68,67,79,36,18,2,2,301
67560505,30,56,56,49,26,11,3,1,232
67560506,29,62,55,58,25,9,0,0,238
67560507,50,76,48,40,23,5,4,2,248
67560508,84,83,44,41,17,8,1,1,279
67560509,69,74,41,35,17,6,2,1,245
67560510,33,73,55,53,31,9,5,2,261
67560601,115,103,66,54,25,12,0,0,375
67560602,99,96,34,20,4,3,0,1,257
67560603,59,69,25,26,7,1,0,1,188
67560604,53,54,18,7,0,2,0,0,134
67560605,86,108,26,15,2,1,2,0,240
67560606,98,91,35,17,4,3,0,0,248
67560607,144,131,44,17,5,0,0,0,341
67560608,42,71,42,43,24,11,2,0,235
67560609,106,91,36,26,8,1,2,0,270
67560610,134,127,50,24,8,3,0,0,346
67560611,56,72,37,33,14,6,1,1,220
67560612,40,61,37,44,24,11,2,0,219
67560701,65,88,57,44,21,5,0,0,280
67560702,64,77,42,22,10,7,0,1,223
67560703,39,60,26,20,5,0,0,0,150
67560704,65,104,58,58,18,6,3,1,313
67560705,108,92,53,24,9,6,1,0,293
67560706,122,97,51,28,13,4,2,0,317
67560707,87,104,50,39,16,8,0,0,304
67560708,37,79,63,55,13,5,0,0,252
67560709,57,74,63,55,20,11,2,3,285
67560710,57,106,59,58,29,11,4,2,326
67560801,57,84,65,64,31,12,3,0,316
67560802,56,82,62,73,26,9,1,0,309
67560803,73,95,61,55,36,5,3,0,328
67560804,65,96,93,65,31,12,3,2,367
67560805,55,132,75,67,32,9,0,0,370
67560806,61,113,92,98,38,15,1,0,418
67560807,52,82,63,69,31,5,2,1,305
67560808,60,119,81,67,25,7,2,1,362
67560809,55,88,66,56,37,5,2,4,313
67560901,40,50,32,57,15,7,1,2,204
67560902,46,64,32,30,9,3,0,0,184
67560903,57,95,59,76,32,15,2,0,336
67560904,76,116,72,67,25,9,1,1,367
67560905,71,100,74,92,33,9,0,1,380
67560906,67,137,87,64,36,13,0,1,405
67560907,53,117,91,96,35,12,5,6,415
67560908,71,104,96,66,40,11,1,0,389
67560909,49,97,77,68,35,10,1,0,337
67560910,42,98,73,87,23,10,2,2,337
67560911,42,84,56,52,25,8,2,4,273
67560912,50,111,56,62,31,8,2,2,322
67560913,40,71,73,60,40,8,0,0,292
67560914,51,92,83,75,36,14,2,3,356
67560915,42,96,71,75,39,11,5,0,339
67560916,40,76,67,64,31,8,0,1,287
67561001,49,92,37,30,8,4,1,0,221
67561002,87,54,26,15,7,0,2,1,192
67561003,147,111,38,19,12,2,1,0,330
67561004,155,112,39,21,3,1,0,0,331
67561005,57,82,35,12,10,0,1,0,197
67561006,165,125,51,26,5,1,1,0,374
67561007,69,82,42,40,10,3,0,0,246
67561008,106,80,40,15,4,0,0,0,245
67561009,59,53,22,5,0,0,0,0,139
67561010,60,87,67,64,26,13,1,4,322
67561011,42,95,62,75,31,7,3,2,317
67561012,55,87,79,64,37,12,3,0,337
67561101,46,69,38,32,13,3,3,0,204
67561102,62,67,40,24,13,5,0,0,211
67561103,103,95,43,33,17,3,0,0,294
67561104,82,84,53,37,13,7,0,0,276
67561105,123,150,44,27,6,7,0,0,357
67561106,114,117,73,25,7,4,0,1,341
67561107,124,150,59,31,8,0,0,1,373
67561108,86,79,37,26,4,2,0,0,234
67561109,64,63,27,14,6,1,0,0,175
67561110,122,75,27,13,4,1,0,0,242
67561111,132,84,54,26,9,4,0,0,309
67561112,95,103,66,37,20,7,3,4,335
67561113,41,82,39,53,25,10,3,1,254
67561201,99,108,76,72,35,14,2,3,409
67561202,58,68,47,36,13,12,0,0,234
67561203,43,71,61,40,19,17,1,0,252
67561204,89,126,95,106,64,25,4,4,513
67561205,63,82,62,65,25,7,2,4,310
67561206,59,68,31,22,4,4,0,0,188
67561207,68,68,19,9,2,1,0,0,167
67561208,105,120,59,49,15,4,2,1,355
67561209,62,100,61,74,28,10,2,0,337
67561210,37,65,74,63,25,14,2,1,281
67561211,45,98,68,73,28,13,4,3,332
67561301,102,89,53,31,8,1,1,0,285
67561302,43,53,49,34,11,2,0,1,193
67561303,55,86,86,65,57,30,18,12,409
67561304,67,104,51,57,28,13,2,6,328
67561305,77,81,68,66,33,12,6,5,348
67561306,56,92,63,56,22,6,1,2,298
67561307,71,86,56,51,43,10,2,3,322
67561308,103,92,67,63,34,11,1,6,377
67561309,62,66,72,68,44,36,3,12,363
67561310,66,47,45,47,28,34,2,3,272
67561311,63,97,86,79,54,33,5,9,426
67561312,66,88,78,75,43,14,2,7,373
67561313,87,108,101,63,17,21,0,3,400
67561314,47,76,79,103,81,61,24,41,512
67561401,73,106,120,129,86,57,14,32,617
67561402,73,106,158,131,109,72,27,28,704
67561403,45,65,48,30,20,11,2,0,221
67561404,40,61,60,44,15,12,2,4,238
67561405,43,67,40,41,27,14,3,1,236
67561406,47,66,64,47,14,10,3,1,252
67561407,80,105,78,93,32,10,3,1,402
67561408,52,100,70,57,39,17,6,7,348
67561409,55,53,86,75,58,29,15,34,405
67561410,53,85,125,104,69,57,26,37,556
67561411,28,43,55,62,57,40,17,17,319
67561412,23,39,68,54,35,26,11,14,270
67561413,27,24,30,36,34,25,19,12,207
67561414,37,43,45,57,32,42,11,14,281
67561415,43,47,51,52,42,27,9,7,278
67561501,38,87,88,108,43,25,7,5,401
67561502,35,66,93,76,62,23,5,5,365
67561503,28,54,68,88,42,28,4,3,315
67561504,64,100,84,91,67,32,4,7,449
67561505,44,93,98,79,59,16,6,4,399
67561506,46,65,61,56,38,16,4,7,293
67561507,35,73,38,43,22,12,4,2,229
67561508,47,62,35,29,18,9,1,1,202
67561509,21,50,40,49,34,12,3,4,213
67561510,36,71,54,70,50,17,4,1,303
67561511,25,59,72,84,37,27,15,12,331
67561512,21,58,38,44,31,11,3,3,209
67561601,72,87,69,57,28,20,5,7,345
67561602,64,82,41,31,24,10,1,4,257
67561603,60,110,58,66,32,12,1,1,340
67561604,52,80,67,63,26,17,3,1,309
67561605,20,56,40,33,39,14,4,3,209
67561606,35,50,54,29,11,8,2,2,191
67561607,104,94,57,21,2,1,0,0,279
67561608,66,95,54,39,18,9,4,1,286
67561609,61,74,45,71,33,17,1,2,304
67561610,20,37,36,46,35,20,3,3,200
67561611,35,83,59,65,49,29,10,4,334
67561612,20,67,40,57,43,28,5,2,262
67561613,59,63,49,55,34,21,6,3,290
67561701,89,103,49,44,14,9,0,1,309
67561702,90,104,85,65,38,14,3,7,406
67561703,66,81,67,70,36,13,2,3,338
67561704,65,91,64,56,28,6,1,3,314
67561705,46,58,40,41,11,7,2,0,205
67561706,46,95,68,65,25,5,7,2,313
67561707,69,102,63,75,33,13,2,0,357
67561708,69,112,89,85,28,17,5,2,407
67561709,68,111,85,80,39,9,4,2,398
67561710,110,117,52,33,15,2,0,0,329
67561801,61,65,59,44,24,10,3,3,269
67561802,66,118,83,73,38,9,7,0,394
67561803,58,81,83,44,22,4,2,1,295
67561804,45,100,90,72,41,8,0,1,357
67561805,43,48,57,46,21,5,3,1,224
67561806,46,55,52,67,19,3,2,0,244
67561807,34,52,57,39,14,6,3,1,206
67561808,9,27,12,7,4,3,0,0,62
67561809,60,75,43,33,14,4,0,0,229
67561810,84,87,70,39,19,2,0,0,301
67561811,64,126,101,99,21,9,3,2,425
67561901,47,98,97,82,36,13,9,3,385
67561902,58,124,95,97,31,15,0,1,421
67561903,38,76,49,56,33,6,1,2,261
67561904,36,65,57,38,20,5,1,2,224
67561905,53,113,94,108,45,13,1,4,431
67561906,71,120,99,86,36,16,3,1,432
67561907,97,69,89,68,26,23,4,0,376
67561908,84,101,97,92,38,22,5,0,439
67561909,61,107,90,77,42,14,1,1,393
67561910,44,81,64,61,23,11,3,1,288
67562001,36,74,68,60,32,10,2,3,285
67562002,65,96,64,60,23,11,1,2,322
67562003,62,88,92,80,48,12,3,5,390
67562004,36,36,41,35,22,10,3,4,187
67562005,38,66,43,31,34,6,6,2,226
67562006,25,54,45,42,18,6,2,2,194
67562007,69,130,100,89,48,18,6,8,468
67562008,50,95,78,72,41,18,2,6,362
67562009,32,83,68,77,30,6,5,5,306
67562101,36,97,81,97,59,36,6,3,415
67562102,33,70,87,74,46,36,6,13,365
67562103,24,41,46,54,43,25,8,4,245
67562104,25,69,86,119,68,48,10,11,436
67562105,15,40,68,63,43,17,4,2,252
67562106,30,60,53,62,60,36,8,4,313
67562107,16,35,26,33,33,14,6,8,171
67562108,33,62,62,66,59,27,11,12,332
67562109,26,78,57,66,48,18,2,3,298
67562110,13,17,14,16,11,4,2,0,77
67562111,33,82,70,57,28,10,8,2,290
67562201,101,145,125,97,69,44,15,12,608
67562202,52,86,61,66,44,26,5,8,348
67562203,70,108,79,88,61,35,9,21,471
67562204,59,92,97,85,64,48,7,13,465
67562205,57,82,76,74,34,13,5,4,345
67562206,25,73,77,80,50,42,14,30,391
67562207,44,54,60,57,39,22,2,5,283
67562208,24,51,47,57,24,18,4,5,230
67562209,36,72,62,63,27,12,3,4,279
67562210,52,72,66,56,24,14,4,5,293
67562211,48,95,70,84,26,21,2,5,351
67562212,29,61,38,43,21,9,2,0,203
67562213,33,51,44,38,20,2,2,0,190
67562301,54,105,110,114,92,51,23,51,600
67562302,47,44,52,50,38,20,9,14,274
67562303,19,65,49,61,30,15,4,7,250
67562304,68,99,80,86,40,28,7,4,412
67562305,50,81,70,71,35,28,5,4,344
67562306,29,92,65,49,28,12,1,3,279
67562307,77,106,70,78,31,11,6,6,385
67562308,63,85,82,75,24,12,3,8,352
67562309,61,89,59,72,50,29,9,16,385
67562310,38,52,59,76,37,24,6,15,307
67562401,56,83,84,69,24,18,1,5,340
67562402,37,53,50,33,11,6,4,1,195
67562403,27,41,63,47,21,10,3,2,214
67562404,42,59,40,41,29,9,4,3,227
67562405,54,61,42,42,23,10,6,2,240
67562406,50,93,58,62,34,19,5,4,325
67562407,35,56,45,39,13,6,0,0,194
67562408,36,62,51,36,20,4,1,0,210
67562409,43,61,49,52,22,6,1,1,235
67562410,38,75,53,52,29,6,2,2,257
67562411,69,122,83,69,35,10,2,2,392
67562412,74,120,73,98,38,12,3,5,423
67562413,87,113,70,55,17,9,1,0,352
67562501,25,35,49,75,50,26,11,26,297
67562502,64,77,71,65,23,9,5,3,317
67562503,49,58,50,35,10,3,2,1,208
67562504,36,47,34,36,9,6,1,2,171
67562505,55,62,57,42,19,2,0,1,238
67562506,38,63,55,29,20,9,3,4,221
67562507,41,57,42,34,18,7,2,2,203
67562508,42,54,47,25,16,2,1,3,190
67562509,54,78,78,76,44,14,4,2,350
67562510,72,80,62,65,36,18,10,9,352
67562511,25,44,53,56,32,41,8,21,280
67562512,48,92,76,84,53,21,5,8,387
67562513,64,82,69,62,19,7,0,2,305
67562514,71,75,55,64,22,5,3,0,295
67562515,60,102,81,65,24,8,0,0,340
67562516,62,87,85,79,26,15,2,3,359
67562517,53,76,51,48,23,8,2,0,261
67562518,73,108,73,87,36,12,3,4,396
67562519,78,90,74,67,41,15,2,2,369
67562601,74,96,69,96,19,24,2,8,388
67562602,58,60,39,68,11,16,1,2,255
67562603,42,47,37,41,10,9,0,3,189
67562604,51,66,50,54,9,15,0,4,249
67562605,56,65,45,54,8,14,0,2,244
67562606,68,94,72,82,16,22,1,8,363
67562607,90,94,65,98,19,22,1,4,393
67562608,68,82,75,96,24,24,2,11,382
67562609,46,54,41,58,11,14,1,4,229
67562610,30,37,30,59,17,11,3,7,194
67562611,77,92,65,108,22,25,3,8,400
67562701,48,61,82,105,72,51,17,20,456
67562702,58,100,91,77,60,42,8,23,459
67562703,31,58,66,57,59,37,9,25,342
67562704,37,53,50,69,47,41,5,18,320
67562705,50,83,88,85,53,36,13,12,420
67562706,74,91,117,97,61,36,13,9,498
67562707,43,65,48,38,17,9,2,2,224
67562708,36,60,54,50,30,12,2,5,249
67562709,32,57,42,50,25,11,1,2,220
67562710,40,44,54,53,27,26,2,9,255
67562711,58,125,104,95,52,13,3,3,453
67562712,63,87,91,77,45,21,5,17,406
67600101,75,57,68,58,37,27,10,6,338
67600102,30,68,76,75,34,25,6,10,324
67600103,51,113,80,84,34,16,6,1,385
67600104,39,67,71,81,26,16,3,1,304
67600105,77,136,95,99,46,16,7,9,485
67600106,44,86,67,52,21,14,2,1,287
67600107,73,95,110,95,48,36,10,5,472
67600108,56,117,101,81,48,28,10,15,456
67600109,45,121,104,100,69,36,10,10,495
67600110,55,89,82,73,59,20,7,15,400
67600111,36,49,49,50,20,14,3,1,222
67600112,31,50,45,54,29,9,2,5,225
67600113,43,73,83,66,29,8,2,7,311
67600114,61,108,100,87,53,22,14,8,453
67600115,75,69,55,53,29,12,1,2,296
67600116,45,47,53,46,21,8,3,1,224
67600117,39,50,51,50,21,4,3,2,220
67600201,74,121,84,92,32,16,3,4,426
67600202,78,118,96,78,26,10,3,1,410
67600203,50,66,47,29,27,3,2,3,227
67600204,66,99,57,34,14,9,0,0,279
67600205,98,93,45,22,14,3,1,2,278
67600206,118,87,36,19,5,1,0,1,267
67600207,109,105,62,27,11,4,2,1,321
67600208,32,46,29,17,9,1,0,1,135
67600209,39,51,40,20,8,7,1,0,166
67600210,71,100,90,90,44,13,6,0,414
67600211,65,74,49,50,18,7,1,3,267
67600212,41,77,79,54,17,11,0,4,283
67600213,93,122,69,48,25,12,1,3,373
67600214,86,85,31,19,5,3,0,2,231
67600215,82,70,31,20,4,1,0,0,208
67600216,73,58,35,15,3,1,0,0,185
67600217,99,82,21,10,4,2,1,0,219
67600301,41,60,57,35,14,5,0,2,214
67600302,101,132,101,102,35,20,6,4,501
67600303,68,75,71,58,24,13,7,2,318
67600304,71,77,69,45,18,9,2,3,294
67600305,48,100,77,75,42,13,7,6,368
67600306,33,61,49,43,21,17,4,0,228
67600307,22,30,18,16,6,4,1,0,97
67600308,57,64,60,57,18,9,1,0,266
67600309,41,38,52,44,18,6,3,1,203
67600310,11,17,15,18,7,4,0,2,74
67600311,80,100,79,71,14,3,2,2,351
67600312,13,21,16,12,8,5,1,0,76
67600313,129,163,67,45,23,8,1,4,440
67600314,119,121,42,27,4,3,1,0,317
67600315,105,80,41,28,18,5,0,1,278
67600316,33,42,29,18,6,3,1,0,132
67600317,102,95,57,41,18,8,5,2,328
67600401,18,49,39,29,57,11,13,7,223
67600501,81,116,132,104,48,40,14,7,542
67600502,58,92,70,69,25,8,4,3,329
67600503,60,131,112,107,46,17,4,3,480
67600504,25,57,56,51,32,15,4,2,242
67600505,57,102,87,84,41,16,3,7,397
67600506,59,78,57,53,29,17,2,3,298
67600507,80,115,77,54,30,16,10,5,387
67600508,89,126,115,89,57,32,12,12,532
67600509,79,130,94,82,45,21,3,6,460
67600510,94,139,141,129,50,25,10,9,597
67600511,127,194,167,180,70,30,7,7,782
67600512,67,88,83,67,30,16,6,7,364
67600601,50,94,89,57,30,19,2,5,346
67600602,61,111,80,68,34,17,5,7,383
67600603,53,58,56,67,36,8,3,4,285
67600604,44,72,60,57,34,16,5,3,291
67600605,49,79,75,58,25,10,2,2,300
67600606,46,75,57,61,31,9,3,1,283
67600607,56,62,69,78,39,26,5,6,341
67600608,51,79,82,74,52,27,9,6,380
67600609,44,72,85,85,63,38,20,18,425
67600610,55,66,80,78,58,35,15,28,415
67600701,69,127,112,123,68,42,12,18,571
67600702,75,135,124,99,64,34,9,19,559
67600703,89,120,106,93,45,15,1,3,472
67600704,67,114,67,77,48,16,5,3,397
67600705,40,87,106,89,57,36,14,7,436
67600706,49,52,41,46,38,15,6,7,254
67600707,30,63,54,52,25,12,4,2,242
67600708,48,77,77,61,32,16,3,5,319
67600709,32,89,83,81,46,22,4,10,367
67600710,58,109,113,107,61,23,10,8,489
67600801,77,106,72,39,23,14,3,4,338
67600802,71,119,113,85,36,21,11,9,465
67600803,80,120,87,65,25,4,3,2,386
67600804,48,106,84,65,45,15,2,2,367
67600805,46,70,51,34,14,7,2,2,226
67600806,62,94,83,71,29,16,4,4,363
67600807,53,97,98,116,71,34,12,14,495
67600808,28,47,43,46,29,16,3,2,214
67600809,63,96,77,68,36,21,4,3,368
67600810,49,82,68,75,41,17,1,6,339
67600811,35,63,68,57,25,7,7,4,266
67600812,55,104,89,86,32,8,4,4,382
67600901,38,54,53,51,23,10,6,2,237
67600902,28,40,42,51,27,14,5,5,212
67600903,57,91,65,76,31,19,4,7,350
67600904,40,74,69,49,24,4,3,2,265
67600905,53,88,57,41,16,8,1,0,264
67600906,54,67,44,30,17,5,2,0,219
67600907,93,117,83,70,34,16,3,5,421
67600908,48,52,51,38,18,13,0,2,222
67600909,35,61,51,56,19,5,1,1,229
67600910,63,111,92,99,40,18,3,1,427
67600911,51,110,109,104,51,26,3,5,459
67600912,46,107,119,98,49,21,3,4,447
67600913,29,68,86,94,56,38,11,8,390
67600914,37,63,80,83,51,24,4,8,350
67600915,28,36,39,41,23,10,6,1,184
67600916,30,70,56,52,32,9,4,10,263
67601001,34,42,38,53,23,18,12,8,228
67601002,28,49,56,55,33,29,6,6,262
67601003,26,33,42,41,18,14,8,3,185
67601004,34,54,50,47,32,18,7,8,250
67601005,25,40,41,41,28,21,8,11,215
67601006,28,8,5,9,7,4,0,0,61
67601007,13,15,19,34,8,5,1,1,96
67601008,11,16,15,17,17,18,3,6,103
67601009,25,40,55,64,34,12,8,11,249
67601010,4,12,20,19,12,10,2,3,82
67601011,15,23,19,30,15,9,4,5,120
67601012,41,61,86,78,67,27,20,35,415
67601013,42,51,72,99,47,38,15,14,378
67601014,40,71,89,78,40,28,24,19,389
67601015,42,60,75,76,52,48,14,19,386
67601101,35,64,43,52,28,13,1,1,237
67601102,39,64,61,55,39,18,9,13,298
67601103,94,130,128,132,64,32,2,5,587
67601104,53,92,105,85,48,33,7,8,431
67601105,22,49,47,53,17,6,3,0,197
67601106,94,119,152,162,80,53,9,12,681
67601107,39,61,95,90,63,38,4,6,396
67601108,49,98,95,163,97,54,16,23,595
67601109,38,51,43,59,25,16,5,6,243
67601110,41,83,91,80,60,34,14,19,422
67601111,56,114,111,103,72,53,17,18,544
67601112,24,53,52,44,24,17,7,5,226
67601113,29,54,56,52,28,9,7,3,238
67601114,22,60,38,14,19,14,2,2,171
67601115,17,32,41,48,25,9,6,2,180
67601116,17,38,25,28,29,8,2,3,150
67601117,20,50,48,46,34,17,5,6,226
67601201,21,52,48,42,26,17,2,8,216
67601202,29,40,48,53,35,19,5,3,232
67601203,14,20,11,21,17,12,3,4,102
67601204,37,54,42,49,30,15,2,0,229
67601205,24,48,45,66,51,20,6,6,266
67601206,53,44,36,36,25,9,2,2,207
67601207,4,13,17,19,21,18,9,10,111
67601208,19,32,37,45,47,21,13,20,234
67601209,34,27,32,46,29,29,10,9,216
67601210,26,36,47,49,29,32,5,10,234
67601211,23,41,57,81,50,24,11,8,295
67601212,31,53,44,68,52,28,18,17,311
67601213,3,1,1,1,1,0,0,0,7
67601214,29,45,80,68,55,39,7,15,338
67601215,29,42,44,58,64,40,19,16,312
67601216,54,59,71,66,51,36,16,15,368
67601217,48,49,71,82,48,56,18,29,401
67601218,25,30,46,44,37,26,10,19,237
67601219,33,38,57,60,40,33,9,31,301
67601301,30,48,39,33,22,17,5,2,196
67601302,33,62,64,84,50,24,6,7,330
67601303,18,37,40,32,19,8,3,7,164
67601304,22,39,65,46,39,16,1,2,230
67601305,58,76,60,55,24,25,3,5,306
67601306,50,43,75,106,65,41,16,33,429
67601307,40,40,55,50,41,16,3,14,259
67601308,31,46,45,65,46,25,8,6,272
67601309,57,73,84,84,63,46,14,10,431
67601310,40,85,94,86,57,40,19,22,443
67601311,48,75,81,71,50,26,18,9,378
67601312,38,58,69,87,46,17,7,9,331
67601313,23,33,45,68,42,26,9,13,259
67601314,55,68,102,96,76,31,8,10,446
67601315,37,61,68,90,73,51,16,15,411
67601316,24,43,48,45,19,14,7,7,207
67601401,23,33,56,58,30,17,6,11,234
67601402,29,43,48,52,54,24,7,9,266
67601403,54,41,58,61,46,24,8,10,302
67601404,38,73,93,110,57,46,13,14,444
67601405,21,43,53,58,44,33,16,27,295
67601406,54,91,111,127,70,69,20,30,572
67601407,60,94,117,134,89,52,10,16,572
67601408,28,56,69,71,40,15,7,11,297
67601409,43,80,95,80,39,24,10,12,383
67601410,24,66,74,74,52,30,17,10,347
67601411,27,57,63,71,34,29,12,15,308
67601412,43,53,77,71,64,54,18,32,412
67601413,39,55,79,87,68,42,23,22,415
67601414,19,52,52,43,37,25,8,12,248
67601415,19,20,18,28,17,4,8,4,118
67601501,41,66,72,68,54,17,4,3,325
67601502,36,51,45,46,35,17,6,1,237
67601503,23,36,45,38,24,14,3,4,187
67601504,40,32,51,50,33,26,8,10,250
67601505,61,67,86,79,81,25,18,30,447
67601506,22,31,33,45,38,28,14,12,223
67601507,43,55,57,57,44,30,14,14,314
67601508,35,64,84,90,40,25,13,13,364
67601509,52,55,86,83,64,48,15,24,427
67601510,22,35,37,27,30,23,9,19,202
67601511,33,39,37,45,32,38,14,22,260
67601512,46,79,70,79,42,22,12,8,358
67601513,53,54,62,53,47,12,12,10,303
67601514,31,53,58,45,27,20,6,10,250
67601515,12,48,55,40,26,15,1,4,201
67601516,14,37,47,42,36,16,7,6,205
67601601,32,54,62,68,46,15,7,6,290
67601602,46,54,57,57,29,23,11,6,283
67601603,37,69,71,82,40,34,12,14,359
67601604,32,55,77,69,43,30,8,10,324
67601605,44,50,84,70,54,30,18,14,364
67601606,35,57,74,67,65,53,12,20,383
67601607,26,54,75,70,39,24,10,12,310
67601608,41,63,76,81,49,34,11,13,368
67601609,27,54,54,54,33,23,8,9,262
67601610,24,51,60,57,39,23,11,12,277
67601611,22,55,52,53,28,12,7,5,234
67601612,34,47,35,34,17,11,4,1,183
67601613,35,61,80,72,45,24,13,8,338
67601614,31,57,57,65,33,36,8,18,305
67601701,52,79,72,100,61,46,13,15,438
67601702,44,42,62,83,55,28,19,20,353
67601703,58,42,61,62,33,23,4,12,295
67601704,28,66,66,61,40,24,5,15,305
67601705,38,50,51,73,51,41,15,26,345
67601706,39,77,83,77,47,28,20,20,391
67601707,23,64,60,59,37,32,7,13,295
67601708,33,69,75,78,74,39,16,16,400
67601709,34,58,60,61,40,22,9,8,292
67601710,35,66,52,85,32,21,6,10,307
67601711,36,52,63,44,29,27,13,10,274
67601712,32,47,59,61,46,18,12,22,297
67601713,40,66,69,52,47,24,9,9,316
67601714,39,55,54,59,33,19,7,12,278
67601715,33,58,77,75,44,35,13,7,342
67601716,30,43,44,60,30,21,8,4,240
67601801,23,43,61,51,46,29,15,24,292
67601802,55,42,55,61,39,39,7,10,308
67601803,42,53,80,78,52,34,10,21,370
67601804,57,56,89,77,71,61,10,18,439
67601805,30,33,53,46,31,31,8,11,243
67601806,19,58,50,54,32,16,14,10,253
67601807,33,51,70,55,40,32,12,11,304
67601808,27,66,86,85,62,36,13,23,398
67601809,44,37,60,56,48,24,16,19,304
67601810,29,47,63,60,50,21,11,10,291
67601811,32,44,54,71,44,41,15,11,312
67601812,41,57,111,93,49,34,9,17,411
67601813,29,49,48,62,35,23,11,17,274
67601814,42,57,60,55,47,35,12,9,317
67601815,26,50,57,65,35,24,16,11,284
67601816,20,41,42,57,45,34,8,9,256
68050101,26,56,55,42,14,14,0,7,214
68050102,36,42,45,38,21,16,5,4,207
68050103,25,32,41,52,39,15,11,6,221
68050104,62,74,63,58,30,22,4,5,318
68050105,8,17,18,41,16,8,1,1,110
68050106,13,22,34,57,21,7,2,2,158
68050107,17,35,56,68,52,14,2,3,247
68050108,10,29,26,63,27,8,0,0,163
68050201,17,23,29,18,12,6,5,2,112
68050202,12,31,54,70,30,5,2,0,204
68050203,42,65,75,77,55,33,9,12,368
68050204,64,56,96,69,49,41,7,13,395
68050205,52,83,97,108,64,40,14,11,469
68050301,18,28,15,13,11,3,0,0,88
68050302,21,33,36,31,14,10,2,2,149
68050303,63,47,55,53,59,41,5,6,329
68050304,42,125,75,152,115,72,14,12,607
68050305,66,107,70,86,61,44,9,10,453
68050306,123,120,81,44,27,6,1,0,402
68050307,16,51,88,157,69,25,4,1,411
68050308,7,22,27,67,60,28,7,2,220
68050309,10,16,22,37,47,16,2,1,151
68050310,16,32,9,33,28,16,5,1,140
68050311,14,52,69,135,82,23,4,2,381
68050401,25,31,47,72,37,8,5,0,225
68050402,28,43,62,64,21,19,6,3,246
68050403,64,88,104,113,78,44,18,26,535
68050404,62,87,100,87,51,50,7,20,464
68050405,60,78,93,103,72,50,23,22,501
68050406,50,71,82,74,40,21,6,3,347
68050407,85,137,132,149,81,84,30,21,719
68050408,49,72,64,52,34,14,3,9,297
68050409,77,102,109,100,50,33,6,13,490
68050410,78,112,111,111,55,28,10,14,519
68050411,40,68,72,137,78,24,5,5,429
68050412,39,98,110,226,140,55,13,6,687
68050501,50,111,72,67,20,17,6,4,347
68050502,56,92,77,81,29,5,4,2,346
68050503,85,118,92,67,31,14,2,3,412
68050504,50,76,50,45,22,7,0,1,251
68050505,46,53,51,56,24,23,5,8,266
68050506,46,67,69,46,33,18,7,7,293
68050507,83,123,125,105,56,20,8,1,521
68050508,75,94,80,73,44,12,2,1,381
68050509,51,71,52,61,21,7,5,3,271
68050510,39,62,68,59,27,11,2,1,269
68050511,79,110,93,125,49,36,8,10,510
68050512,68,90,91,94,52,42,10,15,462
68050513,28,72,76,87,55,52,11,6,387
68050601,127,120,125,124,73,97,2,4,672
68050602,79,70,66,59,19,5,2,0,300
68050603,100,96,91,63,25,14,2,8,399
68050604,80,106,104,66,32,10,2,1,401
68050605,41,58,52,32,12,12,1,0,208
68050606,64,60,41,38,17,4,1,2,227
68050607,39,41,18,15,5,3,1,0,122
68050608,116,104,59,46,11,4,0,0,340
68050609,135,127,61,50,23,8,2,1,407
68050610,95,119,67,50,19,13,2,0,365
68050611,39,90,82,57,22,8,3,2,303
68050612,84,113,65,50,26,9,1,3,351
68050701,26,42,36,39,10,2,3,3,161
68050702,56,86,54,60,17,9,3,0,285
68050703,55,91,75,68,28,20,6,6,349
68050704,49,63,61,54,22,14,4,8,275
68050705,40,63,67,58,29,24,4,10,295
68050706,26,41,31,25,17,8,4,4,156
68050707,27,39,31,25,18,4,2,2,148
68050708,4,6,6,2,6,0,2,0,26
68050709,15,16,13,18,7,4,1,3,77
68050710,3,6,5,6,2,3,2,1,28
68050711,9,7,8,9,1,1,0,0,35
68050801,26,36,36,20,8,8,2,1,137
68050802,27,27,15,12,8,1,1,0,91
68050803,56,70,38,31,24,8,0,10,237
68050804,85,81,47,25,10,1,0,0,249
68050805,32,53,45,30,20,5,1,0,186
68050806,46,71,62,49,36,18,6,3,291
68050807,48,94,123,104,62,23,5,10,469
68050808,106,122,103,115,69,37,12,11,575
68050809,60,66,97,102,59,44,16,30,474
68050810,24,39,48,38,29,16,8,12,214
68050811,67,67,97,108,58,43,16,21,477
68050812,31,34,49,46,32,32,5,10,239
68050813,69,96,103,118,82,57,17,20,562
68050814,67,96,90,91,57,37,13,16,467
68050901,0,0,1,0,0,0,0,0,1
68050902,51,58,58,51,38,18,9,12,295
68050903,48,52,65,64,36,18,10,8,301
68050904,74,130,139,138,76,25,11,18,611
68050905,63,89,70,154,134,73,18,10,611
68050906,33,70,83,135,154,77,22,11,585
68051001,69,117,111,87,60,36,13,8,501
68051002,35,56,74,60,43,14,7,4,293
68051003,37,67,66,63,34,20,10,5,302
68051004,69,125,96,94,71,36,9,23,523
68051005,48,59,63,57,30,13,4,3,277
68051006,56,94,104,86,53,22,5,9,429
68051007,51,56,69,95,56,52,15,24,418
68051008,43,82,117,120,77,62,19,26,546
68051009,39,62,122,98,68,45,19,32,485
68051010,21,56,68,92,62,41,14,25,379
68051011,43,50,85,86,37,44,6,9,360
68051012,17,30,31,68,78,48,17,5,294
68051013,13,27,27,44,58,39,14,6,228
68051101,39,74,75,77,51,29,11,11,367
68051102,35,53,45,72,31,7,5,5,253
68051103,49,73,68,99,106,81,21,15,512
68051104,59,114,108,117,68,28,8,8,510
68051105,43,78,92,85,53,31,14,9,405
68051106,35,64,85,67,45,35,7,9,347
68051107,30,59,71,84,59,43,18,22,386
68051108,47,79,115,110,89,61,25,39,565
68051109,34,61,88,85,78,51,12,21,430
68051110,45,74,104,110,55,52,15,32,487
68051201,40,67,51,51,23,12,4,4,252
68051202,50,83,65,67,32,16,5,3,321
68051203,67,125,85,58,17,5,1,3,361
68051204,37,75,63,49,28,8,2,4,266
68051205,63,75,68,59,21,8,4,3,301
68051206,47,63,50,44,19,8,1,0,232
68051207,31,53,64,62,36,12,1,4,263
68051208,47,49,66,51,23,15,2,2,255
68051209,50,52,52,34,14,7,1,3,213
68051210,81,164,120,125,71,30,1,3,595
68051211,53,81,77,92,39,5,2,0,349
68051212,80,128,78,90,40,9,3,1,429
68051213,42,73,53,79,27,6,1,0,281
68051214,25,54,60,76,36,16,4,1,272
68051301,22,49,47,139,87,39,7,2,392
68051302,9,45,72,140,80,41,5,4,396
68051303,33,68,91,147,80,30,9,7,465
68051304,58,74,90,105,47,18,7,4,403
68051305,68,72,73,77,37,23,8,4,362
68051306,32,54,56,60,38,21,4,12,277
68051307,53,70,72,55,30,17,6,8,311
68051308,74,122,130,129,61,48,18,15,597
68051309,59,51,56,46,29,27,10,26,304
68051310,26,42,53,53,41,17,8,2,242
68051311,54,65,95,95,52,38,16,23,438
68051312,62,75,75,82,54,30,14,13,405
68051313,54,74,84,75,48,14,14,11,374
68051314,57,76,88,56,43,19,8,5,352
68051315,42,58,58,72,29,17,1,1,278
68051316,66,91,81,83,39,13,3,4,380
68051317,43,61,58,58,29,11,4,5,269
68051318,77,100,100,124,57,19,6,5,488
68051401,36,78,96,85,56,29,9,14,403
68051402,42,41,60,60,34,22,10,9,278
68051403,58,71,74,84,52,21,7,6,373
68051404,71,90,99,75,45,21,6,7,414
68051405,58,93,94,115,65,31,13,15,484
68051406,41,64,66,66,32,24,8,12,313
68051407,47,54,65,65,42,22,8,6,309
68051408,32,57,67,64,25,25,15,10,295
68051409,61,56,86,69,31,14,8,8,333
68051410,49,56,71,64,41,14,2,7,304
68051411,37,75,68,86,37,22,10,8,343
68051412,41,72,75,83,37,14,11,11,344
68051413,34,66,86,80,46,32,15,16,375
68051414,33,59,90,69,55,37,9,17,369
68051415,41,65,73,57,48,35,11,23,353
68051416,77,117,116,115,55,45,13,18,556
68051501,42,70,70,49,29,13,0,2,275
68051502,47,72,67,59,25,11,1,3,285
68051503,63,109,81,65,37,16,9,1,381
68051504,48,76,73,70,39,18,5,7,336
68051505,35,73,87,71,47,17,7,3,340
68051506,86,95,100,94,67,38,16,7,503
68051507,44,97,95,98,49,13,1,7,404
68051508,53,74,106,96,59,25,8,12,433
68051509,82,106,86,84,40,19,2,0,419
68051510,39,68,98,88,43,23,2,3,364
68051511,38,64,64,66,31,25,5,6,299
68051512,38,52,57,52,28,13,1,3,244
68051513,51,98,79,81,31,15,6,5,366
68051601,52,66,90,96,59,43,16,26,448
68051602,88,99,107,112,63,56,10,15,550
68051603,39,71,73,76,46,27,8,7,347
68051604,43,93,98,98,63,38,13,30,476
68051605,45,71,64,51,26,21,1,2,281
68051606,46,54,75,74,43,21,6,13,332
68051607,44,87,80,65,42,19,12,12,361
68051608,41,67,72,69,48,31,10,12,350
68051609,29,29,56,83,78,35,2,4,316
68051610,69,114,110,130,83,53,15,20,594
68051611,62,88,91,74,31,20,6,12,384
68051701,49,69,80,61,65,38,14,17,393
68051702,70,101,110,83,46,14,5,4,433
68051703,35,66,53,47,20,13,2,0,236
68051704,43,66,51,48,39,10,7,3,267
68051705,51,118,91,70,51,23,7,6,417
68051706,66,97,105,85,51,22,14,7,447
68051707,65,95,129,86,49,26,12,10,472
68051708,82,97,100,91,46,24,14,15,469
68051709,67,107,110,127,68,27,8,12,526
68051710,38,81,107,87,62,31,13,12,431
68051711,56,73,87,101,63,33,12,18,443
68051801,16,39,58,48,42,17,4,3,227
68051802,37,57,44,49,35,15,4,8,249
68051803,64,117,113,85,50,20,6,15,470
68051804,76,109,93,82,41,16,5,8,430
68051805,49,75,78,79,40,19,4,7,351
68051806,33,67,67,56,35,11,3,1,273
68051807,45,66,64,61,32,8,2,4,282
68051808,77,114,86,89,36,26,5,7,440
68051809,58,100,98,78,39,21,2,8,404
68051810,76,98,84,87,53,28,7,6,439
68051811,89,115,111,91,43,11,6,2,468
68051812,42,62,76,89,70,40,20,32,431
68051901,40,43,57,56,30,28,2,3,259
68051902,24,54,55,72,44,17,5,3,274
68051903,43,68,62,67,35,14,3,3,295
68051904,28,47,42,58,33,18,2,1,229
68051905,29,66,70,65,44,15,6,5,300
68051906,59,115,95,111,62,37,4,8,491
68051907,30,56,66,72,18,13,0,1,256
68051908,36,50,47,59,22,7,2,3,226
68051909,37,76,76,61,40,23,7,5,325
68051910,21,64,58,48,19,8,4,5,227
68051911,72,105,117,94,43,28,8,8,475
68051912,53,93,88,82,51,22,8,6,403
68051913,35,22,8,12,3,2,0,0,82
68051914,62,66,60,59,22,12,0,6,287
68052001,27,56,33,25,17,8,2,2,170
68052002,35,62,64,49,28,31,3,6,278
68052003,48,60,53,52,22,10,2,6,253
68052004,78,113,109,108,73,44,8,17,550
68052005,67,88,94,75,39,36,14,10,423
68052006,41,44,54,64,45,43,16,22,329
68052007,47,77,102,106,78,51,22,50,533
68052008,40,69,60,56,29,16,6,9,285
68052009,49,57,66,79,46,31,10,13,351
68052010,36,83,83,75,33,26,8,8,352
68052011,34,68,74,86,59,27,11,21,380
68052012,36,73,68,69,35,18,6,8,313
68052013,25,57,68,67,40,32,12,17,318
68052014,48,81,62,65,29,19,2,6,312
68052101,59,57,59,68,44,23,6,18,334
68052102,28,58,54,58,46,31,4,10,289
68052103,48,70,119,102,84,43,20,20,506
68052104,63,117,126,126,61,47,22,15,577
68052105,51,62,78,76,48,15,10,13,353
68052106,46,57,72,84,37,28,9,12,345
68052107,17,36,54,50,49,35,8,22,271
68052108,28,63,75,53,40,32,10,11,312
68052109,34,61,81,58,41,29,8,13,325
68052110,35,55,72,74,44,29,11,9,329
68052111,83,80,81,90,45,30,7,8,424
68052112,55,71,69,73,46,33,9,14,370
68052113,40,72,73,77,46,36,13,17,374
68052114,43,75,65,44,35,23,14,8,307
68052201,39,64,94,93,62,45,19,20,436
68052202,61,72,87,106,77,56,19,21,499
68052203,62,79,97,101,58,50,15,20,482
68052204,45,84,136,121,58,45,16,18,523
68052205,68,104,105,120,70,39,22,15,543
68052206,59,76,85,89,50,25,14,14,412
68052207,48,58,84,96,40,31,10,14,381
68052208,50,72,71,73,43,18,3,10,340
68052209,42,94,94,106,58,25,4,7,430
68052210,31,56,61,57,37,18,9,3,272
68052301,41,40,75,69,50,38,16,15,344
68052302,29,75,79,77,60,49,20,22,411
68052303,49,92,104,107,55,49,14,9,479
68052304,41,88,105,104,59,41,15,9,462
68052305,42,54,70,104,49,29,8,9,365
68052306,41,78,70,77,38,22,2,5,333
68052307,38,59,93,104,71,55,13,23,456
68052308,31,47,49,52,34,27,4,6,250
68052309,9,31,40,49,36,16,10,13,204
68052310,30,64,82,82,61,38,19,16,392
68052311,22,29,46,46,38,15,9,7,212
68052312,108,156,245,277,220,177,62,81,1326
68052313,17,58,72,118,56,18,7,4,350
68052314,55,46,91,92,64,59,25,25,457
68052315,31,47,65,74,66,46,14,19,362
68052401,38,81,103,99,39,38,9,8,415
68052402,64,101,77,109,52,26,6,12,447
68052403,46,64,69,71,46,17,6,3,322
68052404,60,87,77,76,42,19,9,4,374
68052405,62,76,111,94,71,55,16,21,506
68052406,29,47,45,50,24,22,5,4,226
68052407,14,34,34,61,26,9,3,5,186
68052408,43,58,74,80,43,29,9,16,352
68052409,34,67,84,93,59,25,18,21,401
68052410,38,77,114,86,55,47,9,5,431
68052501,28,50,69,77,50,20,8,7,309
68052502,30,55,68,78,41,23,4,8,307
68052503,13,37,38,37,21,7,2,1,156
68052504,13,42,35,29,15,4,1,0,139
68052505,56,82,85,85,40,43,15,14,420
68052506,57,80,92,90,66,35,20,20,460
68052507,52,89,129,92,97,69,33,40,601
68052508,17,23,17,31,53,46,19,11,217
68052509,60,68,48,62,26,15,3,1,283
68052510,49,68,59,59,27,13,6,1,282
68052511,48,84,82,66,36,24,8,11,359
68052512,71,82,109,101,48,42,9,11,473
68052601,19,12,8,5,1,0,0,4,49
68052602,29,14,12,8,8,1,1,2,75
68052603,48,52,25,14,16,0,0,2,157
68052604,23,22,12,5,4,3,1,1,71
68052605,18,10,13,6,4,1,0,0,52
68052606,11,13,11,5,1,3,0,0,44
68052607,12,6,2,2,4,1,0,0,27
68052608,20,29,16,10,3,2,0,2,82
68052609,75,78,50,50,23,14,4,5,299
68052610,69,57,35,27,22,5,3,4,222
68052611,32,35,17,10,11,5,1,1,112
68052612,21,23,14,11,8,2,2,1,82
68052613,22,29,15,13,2,3,0,0,84
68052614,8,9,7,5,4,1,2,1,37
68052615,25,29,31,19,7,9,1,0,121
68052616,21,16,6,5,3,5,1,0,57
68052617,8,5,4,0,0,0,0,1,18
68052618,15,19,17,11,5,4,1,2,74
68052619,32,32,19,22,4,7,0,3,119
68052620,54,53,26,18,16,6,2,4,179
68052621,15,20,13,15,6,3,0,0,72
68400101,8,25,32,22,15,9,4,6,121
68400102,42,53,77,72,42,31,12,9,338
68400103,75,110,107,89,79,33,16,28,537
68400104,45,57,54,53,44,18,8,13,292
68400105,46,98,104,111,77,30,20,17,503
68400106,41,68,95,92,52,34,12,15,409
68400107,37,60,85,99,66,41,17,17,422
68400108,26,24,35,35,31,17,10,20,198
68400109,35,59,58,67,48,25,12,9,313
68400110,45,83,95,84,53,38,14,18,430
68400111,57,67,73,56,39,22,9,12,335
68400112,42,80,78,69,43,30,6,9,357
68400113,79,131,117,117,64,38,15,11,572
68400201,45,79,87,83,64,20,13,7,398
68400202,54,101,94,94,39,29,12,14,437
68400203,71,90,70,53,29,11,4,3,331
68400204,42,75,60,56,37,15,5,4,294
68400205,46,86,64,64,28,19,5,8,320
68400206,64,96,71,53,29,12,3,1,329
68400207,31,50,52,45,22,6,5,2,213
68400208,43,63,57,41,25,8,3,1,241
68400209,51,62,82,83,34,28,4,6,350
68400210,41,74,61,54,32,11,2,4,279
68400211,44,79,61,58,36,20,2,3,303
68400212,59,93,91,82,36,22,8,8,399
68400301,61,95,87,61,45,12,2,5,368
68400302,70,112,83,77,45,23,9,8,427
68400303,55,69,63,65,31,18,7,8,316
68400304,60,96,73,85,42,36,3,8,403
68400305,50,75,79,91,45,28,8,15,391
68400306,51,78,78,63,40,23,11,19,363
68400307,59,76,108,88,37,29,11,7,415
68400308,57,117,109,90,65,26,5,8,477
68400309,40,58,62,61,31,25,7,8,292
68400310,45,61,55,42,34,21,7,5,270
68400311,58,115,90,107,64,25,7,9,475
68400312,46,95,87,93,42,45,11,7,426
68400401,76,73,106,91,69,47,10,17,489
68400402,34,63,105,74,63,58,26,36,459
68400403,26,60,57,68,30,21,8,9,279
68400404,35,58,48,54,28,17,5,2,247
68400405,55,65,63,50,31,14,5,4,287
68400406,45,46,61,61,25,11,2,11,262
68400407,59,93,66,63,25,12,6,3,327
68400408,25,43,29,24,18,6,2,3,150
68400409,43,74,65,51,31,16,4,2,286
68400410,61,92,96,90,51,33,4,6,433
68400411,40,65,67,68,39,16,7,9,311
68400412,40,40,51,35,25,12,5,4,212
68400413,59,95,81,68,32,31,10,5,381
68400414,37,104,96,66,24,11,2,2,342
68400415,37,90,95,87,46,19,6,3,383
68400416,42,129,108,92,20,8,0,0,399
68400417,35,75,108,105,55,18,5,5,406
68400501,41,62,61,79,46,34,14,9,346
68400502,34,86,58,67,29,12,6,1,293
68400503,44,96,64,57,30,13,5,9,318
68400504,54,88,64,51,22,12,4,5,300
68400505,48,76,58,66,29,16,5,2,300
68400506,36,59,49,38,25,7,1,1,216
68400507,40,89,68,52,31,13,1,1,295
68400508,87,104,98,83,43,14,3,1,433
68400509,30,60,56,56,24,7,1,1,235
68400510,37,87,59,69,30,13,4,3,302
68400511,55,126,116,130,44,8,3,3,485
68400512,65,89,95,80,58,21,5,5,418
68400601,64,93,81,76,58,24,6,5,407
68400602,29,51,49,40,28,6,2,3,208
68400603,36,56,66,55,32,13,5,3,266
68400604,52,65,63,60,36,16,3,11,306
68400605,60,101,93,75,33,17,1,2,382
68400606,70,92,99,82,41,20,3,3,410
68400607,46,88,78,52,22,8,2,1,297
68400608,40,60,49,44,10,6,1,1,211
68400609,41,68,40,31,29,9,1,4,223
68400610,47,61,57,57,15,6,2,4,249
68400611,41,50,42,39,20,8,2,2,204
68400612,26,44,56,42,15,10,2,2,197
68400613,35,69,70,42,40,15,5,12,288
68400614,57,84,87,71,40,20,5,5,369
68400615,58,76,65,57,29,12,5,7,309
68400616,53,77,71,68,36,12,4,7,328
68400701,75,102,88,88,39,19,4,3,418
68400702,72,104,86,82,35,20,2,1,402
68400703,47,84,81,64,16,10,2,0,304
68400704,63,88,77,59,15,12,1,1,316
68400705,46,61,63,47,24,8,2,1,252
68400706,60,75,73,48,27,6,2,1,292
68400707,59,86,64,58,33,9,3,4,316
68400708,62,94,79,73,35,13,3,0,359
68400709,82,97,69,59,30,14,2,2,355
68400710,64,116,96,78,28,5,3,1,391
68400711,59,103,82,54,31,8,2,2,341
68400801,64,91,60,50,17,12,5,2,301
68400802,25,47,38,44,21,9,1,3,188
68400803,23,37,37,55,20,2,1,2,177
68400804,40,71,67,64,19,21,4,5,291
68400805,52,99,74,65,25,15,2,1,333
68400806,30,63,54,51,23,5,4,1,231
68400807,48,75,65,46,28,8,1,2,273
68400808,41,62,59,45,16,8,5,1,237
68400809,64,101,77,92,38,8,3,5,388
68400810,45,78,45,52,16,4,1,1,242
68400811,53,98,61,69,21,8,3,2,315
68400812,47,118,78,69,29,18,3,4,366
68400901,37,73,74,74,27,11,3,3,302
68400902,36,66,51,38,19,6,1,0,217
68400903,68,112,55,70,17,5,0,0,327
68400904,16,35,49,79,28,2,0,1,210
68400905,53,79,38,38,9,1,2,2,222
68400906,73,117,60,36,13,7,0,0,306
68400907,68,78,66,51,18,5,1,0,287
68400908,48,66,48,51,17,4,1,0,235
68400909,52,80,43,42,18,7,0,0,242
68400910,56,109,79,52,20,4,0,0,320
68401001,79,121,83,85,31,10,1,1,411
68401002,83,141,76,93,35,11,0,2,441
68401003,69,76,42,34,16,2,1,0,240
68401004,100,114,51,43,6,4,2,0,320
68401005,40,56,44,42,19,4,1,1,207
68401006,105,111,66,33,6,2,3,2,328
68401007,77,92,68,49,12,6,1,0,305
68401008,78,104,38,27,7,2,2,0,258
68401009,63,72,27,21,3,1,0,0,187
68401010,78,84,46,29,8,3,1,1,250
68401011,71,81,46,43,15,2,1,0,259
68401012,39,56,32,29,14,6,3,1,180
68401013,64,79,43,29,11,4,1,1,232
68401101,43,96,67,47,18,7,1,3,282
68401102,38,56,56,46,23,8,6,3,236
68401103,25,54,32,29,18,6,3,3,170
68401104,19,34,20,15,11,3,1,2,105
68401105,40,73,59,51,20,14,5,4,266
68401106,66,96,91,73,33,15,3,1,378
68401107,59,76,60,52,23,9,0,0,279
68401108,76,125,91,72,44,9,5,0,422
68401109,73,92,71,44,18,13,2,2,315
68401110,76,111,93,86,29,9,4,2,410
68401111,75,113,63,70,33,8,3,3,368
68401112,65,92,65,73,31,9,0,1,336
68401201,68,95,92,72,23,10,3,2,365
68401202,79,94,82,68,37,10,4,2,376
68401203,63,107,84,71,28,9,3,1,366
68401204,43,50,52,30,16,8,0,1,200
68401205,55,95,72,52,28,12,1,2,317
68401206,0,1,0,2,0,0,0,1,4
68401207,37,69,31,48,15,6,4,4,214
68401208,42,60,62,48,15,9,1,0,237
68401209,51,77,57,51,26,9,1,1,273
68401210,56,95,71,62,26,5,1,4,320
68401211,65,94,73,73,37,9,2,5,358
68401301,63,84,77,74,25,7,2,1,333
68401302,32,65,54,33,11,9,1,0,205
68401303,79,104,116,64,30,4,2,4,403
68401304,68,110,70,62,23,10,3,1,347
68401305,55,83,58,60,18,3,3,2,282
68401306,42,75,49,46,13,8,0,0,233
68401307,60,59,48,20,15,6,0,2,210
68401308,50,60,53,34,16,6,3,0,222
68401309,68,112,75,48,24,8,2,0,337
68401310,89,123,87,70,46,8,4,4,431
68401311,35,65,58,53,23,13,2,0,249
68401312,83,119,71,52,20,9,2,1,357
68401313,66,81,31,18,7,1,0,1,205
68401314,60,51,32,27,8,2,0,0,180
68401401,69,85,76,57,28,12,7,3,337
68401402,47,66,56,28,22,9,2,1,231
68401403,48,67,58,45,20,8,5,0,251
68401404,62,131,89,85,34,21,5,3,430
68401405,68,74,69,52,27,8,3,3,304
68401406,61,67,67,45,17,4,0,1,262
68401407,62,88,62,47,22,12,1,0,294
68401408,19,44,39,40,13,1,2,1,159
68401409,53,64,70,62,26,11,5,0,291
68401410,49,92,56,63,29,10,4,4,307
68401501,41,60,45,39,17,10,2,0,214
68401502,110,125,82,44,34,6,4,2,407
68401503,54,82,47,46,26,4,2,0,261
68401504,44,86,56,50,15,4,1,0,256
68401505,99,119,76,60,18,11,3,2,388
68401506,89,123,85,51,19,7,4,3,381
68401507,51,53,42,33,12,4,0,0,195
68401508,80,88,49,21,9,2,0,0,249
68401509,74,107,70,61,21,8,2,0,343
68401510,76,131,79,63,19,5,2,1,376
68401511,26,69,37,38,7,5,0,0,182
68401512,55,80,37,36,13,2,1,0,224
68401513,78,84,63,65,24,9,1,0,324
68401514,61,109,69,66,18,8,2,2,335
68401601,51,65,60,51,13,12,0,2,254
68401602,64,84,62,48,18,6,1,1,284
68401603,60,94,66,61,15,4,3,0,303
68401604,78,95,62,45,27,4,0,0,311
68401605,71,94,76,49,19,6,5,3,323
68401606,70,100,63,56,18,8,0,2,317
68401607,43,59,49,48,18,4,0,3,224
68401608,83,101,73,48,20,6,4,1,336
68401609,84,96,62,52,16,5,2,2,319
68401610,50,65,37,39,16,14,0,0,221
68401611,48,58,41,31,12,3,1,1,195
68401612,45,58,52,32,19,1,3,0,210
68401613,97,113,62,28,17,5,2,1,325
68401614,37,37,31,31,16,4,0,2,158
68401701,58,80,66,40,20,7,1,1,273
68401702,83,151,106,66,27,3,1,1,438
68401703,78,86,77,56,20,9,4,2,332
68401704,48,86,63,41,21,2,3,2,266
68401705,74,73,61,60,30,11,2,2,313
68401706,75,127,95,70,28,16,4,4,419
68401707,47,67,56,43,19,1,2,2,237
68401708,63,91,56,57,23,10,2,4,306
68401709,29,63,39,44,19,5,1,1,201
68401710,41,71,59,40,24,13,1,2,251
68401711,37,56,42,33,16,7,1,4,196
68401712,42,50,43,53,21,5,3,0,217
68401713,48,67,41,32,18,6,2,1,215
68401801,10,18,29,30,14,8,1,7,117
68401802,68,102,53,38,15,6,2,1,285
68401803,61,58,34,30,5,1,1,0,190
68401804,63,86,41,18,7,5,0,0,220
68401805,54,48,39,24,9,3,0,0,177
68401806,111,123,82,49,18,5,0,2,390
68401807,88,130,85,55,25,9,2,0,394
68401808,82,108,82,57,38,24,4,3,398
68401809,66,97,64,66,24,14,8,8,347
68401810,61,104,66,69,42,11,3,4,360
68401811,53,65,49,35,23,3,0,1,229
68401812,35,59,45,51,21,5,1,1,218
68401813,58,107,82,59,28,12,2,2,350
68401814,49,94,58,50,13,9,1,1,275
68401901,75,58,35,24,7,4,0,0,203
68401902,68,83,39,23,8,7,0,0,228
68401903,78,97,66,60,27,5,2,3,338
68401904,113,156,91,86,23,9,1,1,480
68401905,71,79,78,54,37,12,2,2,335
68401906,67,92,103,77,30,20,7,2,398
68401907,70,80,42,58,23,8,1,0,282
68401908,64,89,64,66,29,12,5,5,334
68401909,39,54,60,40,36,8,2,4,243
68401910,44,69,56,29,14,8,1,1,222
68401911,57,86,60,71,35,16,3,4,332
68401912,54,75,67,58,35,10,3,2,304
68402001,54,94,66,43,24,8,1,3,293
68402002,46,63,81,48,19,15,2,1,275
68402003,66,92,93,71,32,16,3,5,378
68402004,67,99,74,68,35,14,0,1,358
68402005,75,78,70,61,31,12,4,3,334
68402006,68,80,65,56,27,15,7,4,322
68402007,60,75,60,58,24,11,3,4,295
68402008,45,67,44,67,19,8,4,3,257
68402009,40,63,90,58,37,15,4,4,311
68402010,39,69,51,43,25,15,1,2,245
68402011,68,99,77,65,40,10,6,5,370
68402101,52,81,59,48,19,9,1,2,271
68402102,47,48,50,45,21,6,0,1,218
68402103,44,52,35,20,19,5,0,1,176
68402104,38,68,51,49,17,10,2,2,237
68402105,33,51,46,34,20,23,6,3,216
68402106,67,111,84,69,43,14,3,0,391
68402107,72,114,71,77,30,10,5,2,381
68402108,39,64,58,65,37,27,9,6,305
68402109,42,77,70,57,46,42,12,16,362
68402110,57,85,73,85,39,35,8,11,393
68402201,67,88,83,71,46,21,11,12,399
68402202,57,87,63,72,29,15,4,0,327
68402203,66,86,74,68,35,13,6,5,353
68402204,52,99,63,60,23,18,6,1,322
68402205,52,66,61,46,36,18,1,4,284
68402206,63,73,62,69,36,13,1,5,322
68402207,68,111,74,72,28,18,3,6,380
68402208,75,92,101,70,33,23,8,5,407
68402301,47,79,59,46,17,9,2,1,260
68402302,52,83,72,48,26,6,3,3,293
68402303,38,36,43,22,19,8,4,2,172
68402304,46,58,46,36,23,10,5,1,225
68402305,55,113,86,65,31,12,2,3,367
68402306,31,56,43,31,21,7,2,0,191
68402307,37,50,34,34,17,8,5,4,189
68402308,56,92,98,90,58,25,12,13,444
68402309,39,75,47,47,10,9,6,5,238
68402310,54,88,52,53,36,11,2,9,305
68402401,60,90,74,64,34,19,3,2,346
68402402,60,86,51,52,20,13,4,2,288
68402403,43,45,46,38,18,11,0,1,202
68402404,48,53,48,40,30,15,1,6,241
68402405,57,47,46,52,26,16,6,19,269
68402406,56,58,53,49,20,30,8,6,280
68402407,50,70,69,53,33,20,2,1,298
68402408,77,59,47,42,24,9,5,1,264
68402409,59,73,75,45,14,13,0,0,279
68402410,48,42,35,40,19,3,1,1,189
68402501,17,22,20,25,21,13,4,3,125
68402502,10,9,9,14,5,6,3,3,59
68402503,22,36,29,34,18,22,3,6,170
68402504,30,50,48,47,28,26,8,11,248
68402505,21,28,21,43,17,9,5,7,151
68402506,25,40,73,80,44,44,6,20,332
68402507,7,20,26,30,16,13,4,7,123
68402508,28,30,29,25,27,20,1,4,164
68402509,17,33,37,28,17,12,2,14,160
68402510,35,41,50,47,48,17,7,12,257
68402511,25,40,31,38,29,26,11,11,211
68402601,42,60,74,64,74,75,13,20,422
68402602,137,183,217,197,125,93,27,36,1015
68402603,55,64,75,70,46,28,8,13,359
68402604,34,31,36,30,14,13,1,3,162
68402605,47,81,64,53,34,27,8,5,319
68402606,113,199,205,179,122,73,20,27,938
68402607,36,56,50,27,16,11,3,0,199
68402608,0,3,2,1,0,0,0,0,6
68402701,51,65,55,36,26,9,6,2,250
68402702,61,84,74,71,42,21,11,9,373
68402703,47,43,65,58,34,29,10,17,303
68402704,52,108,70,68,32,27,1,5,363
68402705,31,23,24,15,7,3,0,0,103
68402706,36,39,29,21,13,6,0,1,145
68402707,59,80,57,39,25,11,1,3,275
68402708,48,61,59,53,35,12,5,4,277
68402709,65,91,60,56,20,10,2,2,306
68402710,75,97,54,59,38,21,4,3,351
68402711,43,60,62,42,17,12,3,1,240
68402712,56,74,86,59,17,19,5,8,324
68402713,48,83,74,41,22,10,7,3,288
68402801,42,76,48,70,37,13,9,10,305
68402802,62,73,66,56,34,19,2,1,313
68402803,36,36,37,35,29,19,5,7,204
68402804,42,69,43,61,30,20,6,3,274
68402805,57,87,83,75,35,24,14,5,380
68402806,41,64,56,50,28,26,8,4,277
68402807,69,90,93,82,37,15,2,2,390
68402808,41,64,45,42,23,10,4,3,232
68402809,49,66,62,66,35,12,3,4,297
68402810,44,67,47,45,25,10,4,3,245
68402811,64,74,74,68,32,16,6,10,344
68402901,59,91,65,57,38,11,7,5,333
68402902,50,66,60,51,20,12,1,3,263
68402903,69,106,93,77,57,29,12,9,452
68402904,60,74,48,64,28,19,6,4,303
68402905,66,104,90,68,41,12,4,4,389
68402906,68,93,45,31,16,8,3,2,266
68402907,50,86,64,54,32,18,5,6,315
68402908,61,83,76,46,24,8,3,1,302
68402909,63,95,75,70,28,13,5,2,351
68402910,58,83,91,83,39,10,4,3,371
68402911,32,49,37,36,16,7,0,2,179
68403001,57,90,57,38,23,7,0,1,273
68403002,27,43,30,29,12,13,2,1,157
68403003,65,91,51,32,15,8,1,0,263
68403004,67,79,65,54,21,13,2,3,304
68403005,35,52,34,28,14,4,2,1,170
68403006,36,89,42,21,27,5,3,7,230
68403007,40,63,57,34,20,11,3,3,231
68403008,67,88,75,61,23,3,3,3,323
68403009,61,68,59,29,19,2,2,1,241
68403010,62,74,43,24,4,4,4,0,215
68403011,60,98,53,51,23,6,4,1,296
68403012,60,52,44,22,8,2,1,0,189
68403013,79,73,28,23,11,1,0,1,216
68403101,20,24,34,16,18,10,0,0,122
68403102,77,87,63,67,28,17,0,4,343
68403103,114,103,79,37,18,6,1,5,363
68403104,53,57,40,53,13,9,0,2,227
68403105,78,97,65,53,23,12,5,2,335
68403106,76,100,53,66,29,19,4,5,352
68403107,83,80,46,52,24,14,2,2,303
68403108,64,111,67,53,28,5,3,2,333
68403109,73,117,80,68,28,10,1,3,380
68403110,42,70,68,50,25,9,1,3,268
68403201,35,41,23,32,8,5,4,0,148
68403202,71,80,48,60,27,14,3,2,305
68403203,47,76,57,35,14,7,2,5,243
68403204,70,87,71,52,26,13,1,1,321
68403205,52,65,55,46,28,10,1,3,260
68403206,60,80,44,45,24,9,1,4,267
68403207,62,87,67,55,23,9,3,2,308
68403208,53,96,63,49,29,14,6,4,314
68403209,63,83,65,59,27,11,2,2,312
68610101,43,76,40,49,24,9,2,0,243
68610102,31,57,24,34,12,7,2,1,168
68610103,74,79,51,30,13,2,1,0,250
68610104,86,98,53,45,21,3,0,2,308
68610105,73,112,60,48,13,7,1,0,314
68610106,56,69,46,35,11,3,2,0,222
68610107,83,83,50,26,5,4,2,0,253
68610108,48,78,40,60,29,6,0,0,261
68610109,39,71,56,47,20,9,3,0,245
68610110,80,71,38,29,12,5,0,1,236
68610111,58,54,42,23,20,2,0,1,200
68610201,59,68,46,56,21,10,5,8,273
68610202,36,67,42,45,13,6,2,0,211
68610203,41,44,18,22,10,5,2,1,143
68610204,76,105,60,52,34,10,2,1,340
68610205,92,62,31,21,12,3,1,0,222
68610206,42,63,31,21,14,1,1,0,173
68610207,43,67,38,26,17,6,4,1,202
68610208,55,41,19,13,11,0,0,0,139
68610209,31,60,59,70,26,13,2,5,266
68610210,52,94,43,58,38,12,3,1,301
68610211,36,64,46,64,26,7,3,0,246
68610212,89,67,32,31,9,4,1,1,234
68610301,132,101,48,32,11,3,0,1,328
68610302,75,76,35,34,8,4,1,0,233
68610303,99,105,52,34,20,10,1,2,323
68610304,116,143,59,34,7,3,1,0,363
68610305,118,91,39,24,6,2,0,0,280
68610306,116,83,38,15,5,1,0,0,258
68610307,95,78,39,26,4,5,1,0,248
68610308,109,84,51,24,9,3,1,0,281
68610309,81,55,30,7,3,3,0,0,179
68610310,92,78,41,17,4,0,1,0,233
68610311,131,121,50,18,3,0,0,1,324
68610401,151,86,31,16,2,0,0,0,286
68610402,137,87,20,13,9,4,0,0,270
68610403,130,99,34,10,8,0,1,0,282
68610404,69,62,20,12,3,1,0,0,167
68610405,101,98,38,26,1,2,1,0,267
68610406,81,107,50,37,9,0,0,0,284
68610407,100,112,75,45,20,1,0,0,353
68610408,85,87,19,19,4,0,0,0,214
68610409,66,72,48,26,12,9,1,0,234
68610410,56,88,36,44,20,13,1,0,258
68610411,60,66,28,26,12,5,2,0,199
68610501,85,75,36,32,15,6,1,2,252
68610502,95,75,33,16,4,0,0,0,223
68610503,81,59,34,28,16,8,1,1,228
68610504,57,84,47,52,17,6,0,1,264
68610505,46,73,47,42,18,5,0,1,232
68610506,0,0,0,0,0,0,0,0,0
68610507,83,93,18,33,10,3,0,0,240
68610508,48,101,62,74,32,18,2,1,338
68610509,143,92,42,32,12,4,0,0,325
68610601,35,31,17,15,5,1,0,0,104
68610602,100,65,32,18,5,1,0,0,221
68610603,37,82,58,52,19,6,3,0,257
68610604,102,95,48,24,5,0,0,0,274
68610605,49,42,23,14,1,3,0,1,133
68610606,70,96,48,33,6,3,2,0,258
68610607,141,84,49,15,6,1,0,0,296
68610608,78,56,17,10,2,1,0,0,164
68610609,121,94,32,17,7,1,1,0,273
68610610,126,131,63,46,17,7,1,2,393
68610611,45,59,25,15,5,1,0,0,150
68610701,40,70,49,60,28,9,2,1,259
68610702,94,100,31,15,7,2,1,0,250
68610703,135,99,32,12,5,2,1,0,286
68610704,44,75,47,49,25,4,3,1,248
68610705,85,100,67,34,16,7,1,0,310
68610706,42,62,32,21,14,7,2,0,180
68610707,81,75,51,47,17,3,0,1,275
68610708,74,109,52,31,10,7,1,1,285
68610709,38,92,47,44,31,17,1,0,270
68610801,121,117,62,20,18,1,0,2,341
68610802,84,84,57,53,18,9,1,0,306
68610803,38,59,38,31,22,10,2,0,200
68610804,62,82,58,53,26,3,4,0,288
68610805,64,53,35,23,5,4,1,1,186
68610806,65,80,37,34,12,5,0,1,234
68610807,72,71,37,24,7,1,1,0,213
68610808,76,100,37,28,12,3,1,0,257
68610809,37,52,32,32,6,3,1,1,164
68610810,49,67,57,50,40,11,1,2,277
68610811,94,69,38,22,7,2,1,0,233
68610901,100,111,58,50,18,6,2,1,346
68610902,86,89,27,18,4,2,1,0,227
68610903,50,60,57,41,10,5,1,0,224
68610904,58,75,39,45,10,10,0,2,239
68610905,90,124,69,70,27,12,4,1,397
68610906,79,99,68,65,17,6,0,1,335
68610907,72,105,62,55,18,8,1,1,322
68610908,98,84,53,23,12,4,0,0,274
68610909,36,41,25,11,9,3,1,0,126
68610910,79,87,57,32,14,4,2,2,277
68610911,74,108,91,74,34,15,2,2,400
68610912,58,98,57,51,26,9,1,2,302
68611001,66,86,80,63,30,9,3,1,338
68611002,103,107,91,63,32,11,1,1,409
68611003,64,101,74,77,28,14,5,3,366
68611004,58,94,84,55,32,7,3,4,337
68611005,49,99,62,72,34,4,2,2,324
68611006,53,90,65,65,23,14,3,1,314
68611007,88,93,61,63,21,7,0,0,333
68611008,74,92,75,60,21,11,1,3,337
68611009,55,81,53,63,20,6,0,2,280
68611010,50,104,55,59,32,3,1,0,304
68611101,52,101,76,72,22,8,2,2,335
68611102,40,72,46,48,24,8,3,2,243
68611103,70,90,52,59,19,8,1,1,300
68611104,60,70,48,38,13,1,4,2,236
68611105,35,61,48,41,14,6,2,0,207
68611106,58,94,74,70,29,6,1,1,333
68611107,55,103,90,74,32,19,2,0,375
68611108,52,64,56,40,15,5,2,2,236
68611109,76,88,62,53,22,5,2,0,308
68611110,73,84,48,27,14,2,0,1,249
68611201,81,77,45,42,13,5,1,1,265
68611202,49,82,52,52,20,5,3,1,264
68611203,41,68,36,30,11,4,0,0,190
68611204,29,66,34,36,11,11,0,2,189
68611205,81,111,49,60,27,6,3,2,339
68611206,53,86,45,41,19,4,0,4,252
68611207,63,93,59,52,32,6,3,1,309
68611208,63,92,58,74,24,9,3,0,323
68611209,48,79,46,60,38,7,2,1,281
68611301,41,57,32,25,9,2,0,1,167
68611302,78,77,45,28,5,4,0,1,238
68611303,83,69,52,24,8,4,1,0,241
68611304,75,87,52,47,19,2,0,0,282
68611305,95,81,55,48,6,9,2,0,296
68611306,83,113,55,44,24,8,0,0,327
68611307,42,85,51,45,22,5,0,1,251
68611308,41,66,39,47,28,7,0,0,228
68611309,45,88,61,68,30,13,1,3,309
68611401,121,74,36,24,3,1,0,1,260
68611402,80,75,44,26,4,3,0,0,232
68611403,63,92,36,39,11,5,1,2,249
68611404,45,90,54,64,29,7,0,1,290
68611405,62,69,31,26,14,3,1,0,206
68611406,49,49,37,40,10,3,1,0,189
68611407,59,105,68,62,23,4,0,1,322
68611408,60,93,37,50,16,1,4,0,261
68611409,74,105,72,79,11,12,2,0,355
68611410,59,78,38,48,20,2,2,1,248
68611411,51,50,27,14,1,1,1,1,146
68611412,98,79,29,16,5,1,0,1,229
68611501,118,103,25,24,3,1,0,0,274
68611502,138,113,39,19,6,0,0,0,315
68611503,111,124,78,39,29,10,0,1,392
68611504,25,31,22,13,3,0,2,0,96
68611505,71,67,22,18,7,0,0,0,185
68611506,65,92,52,54,8,7,0,0,278
68611507,66,87,64,47,17,3,5,0,289
68611508,161,151,46,46,7,6,0,0,417
68611509,92,98,42,18,3,1,1,0,255
68611510,63,106,67,53,24,5,3,1,322
68611601,36,71,39,45,15,4,1,0,211
68611602,42,63,41,38,12,5,0,0,201
68611603,53,67,57,62,20,10,0,0,269
68611604,66,104,75,55,27,3,2,0,332
68611605,44,74,65,73,28,8,0,0,292
68611606,68,93,72,55,21,2,0,1,312
68611607,57,89,74,63,26,8,1,0,318
68611608,56,76,49,49,23,9,3,1,266
68611609,64,102,75,79,29,8,2,5,364
68611610,72,86,63,68,21,10,0,1,321
68611611,41,80,60,64,23,7,0,5,280
68611701,52,93,72,69,31,8,1,0,326
68611702,41,98,61,67,29,12,0,0,308
68611703,34,89,54,58,19,4,1,0,259
68611704,46,67,35,61,11,7,0,1,228
68611705,40,83,50,46,23,8,2,2,254
68611706,44,55,56,74,17,11,0,0,257
68611707,56,93,69,78,31,10,4,3,344
68611708,60,82,77,58,30,7,2,7,323
68611709,60,106,62,68,23,6,2,0,327
68611801,84,109,81,70,32,8,4,0,388
68611802,58,103,74,70,34,10,2,0,351
68611803,49,83,72,59,25,10,2,2,302
68611804,63,75,50,44,25,3,3,0,263
68611805,47,57,42,35,15,5,2,2,205
68611806,78,93,71,61,26,13,5,1,348
68611807,74,87,57,51,24,11,5,0,309
68611808,56,93,60,61,21,11,3,0,305
68611809,74,93,58,57,26,11,3,0,322
68611810,67,107,85,81,21,8,2,0,371
68611901,79,77,63,46,22,7,3,1,298
68611902,33,39,22,19,4,2,0,0,119
68611903,75,107,71,38,8,2,0,2,303
68611904,76,99,53,55,22,8,0,1,314
68611905,60,102,68,74,24,10,1,2,341
68611906,47,78,78,61,24,8,0,0,296
68611907,52,95,76,68,26,7,1,0,325
68611908,42,80,48,52,24,11,2,0,259
68611909,51,88,55,57,22,6,0,1,280
68611910,53,80,55,54,20,10,1,1,274
68611911,77,108,62,63,21,8,2,0,341
68611912,46,114,84,77,27,10,1,1,360
68611913,73,93,50,33,9,8,1,0,267
68611914,41,64,46,68,14,4,1,1,239
68611915,42,52,55,36,7,4,2,1,199
68612001,100,85,80,42,51,4,0,0,362
68612002,75,73,52,30,35,5,0,0,270
68612003,112,81,80,39,44,3,0,0,359
68612004,114,76,68,33,35,3,0,0,329
68612005,126,82,72,41,34,3,0,0,358
68612006,125,71,92,32,47,1,0,0,368
68612007,92,68,64,42,38,2,0,0,306
68612008,79,61,55,23,25,3,0,0,246
68612101,45,92,88,59,35,7,3,2,331
68612102,56,68,59,57,29,6,1,0,276
68612103,65,94,68,62,21,6,1,1,318
68612104,49,90,72,63,29,8,2,0,313
68612105,61,104,65,51,16,7,2,0,306
68612106,67,101,77,72,32,7,3,1,360
68612107,55,101,70,74,27,10,1,0,338
68612108,77,135,68,85,25,11,2,0,403
68612109,59,83,60,60,14,7,1,0,284
68612201,71,90,63,61,25,9,2,1,322
68612202,57,89,68,75,29,10,3,1,332
68612203,60,94,75,79,15,9,1,1,334
68612204,58,100,66,56,20,7,1,1,309
68612205,64,102,74,74,26,10,0,0,350
68612206,48,101,77,60,26,4,3,0,319
68612207,51,88,75,64,38,12,4,0,332
68612208,70,112,83,80,19,7,1,3,375
68612209,31,64,41,41,25,6,3,1,212
68612210,34,59,44,51,19,3,6,0,216
68612211,40,53,56,39,11,4,3,1,207
68612212,21,50,47,45,15,8,1,0,187
68612301,81,85,96,80,45,19,9,9,424
68612302,93,93,85,70,27,16,5,9,398
68612303,73,80,108,76,37,15,5,5,399
68612304,42,65,46,59,40,23,18,17,310
68612305,64,82,66,62,51,47,12,20,404
68612306,23,50,43,20,17,4,2,3,162
68612307,49,98,96,97,34,19,3,5,401
68612308,44,62,59,51,11,5,0,2,234
68612309,61,61,43,41,19,13,2,5,245
68612401,78,127,91,66,27,13,4,4,410
68612402,64,119,91,63,32,15,4,6,394
68612403,56,55,56,47,22,6,5,4,251
68612404,37,70,44,56,19,6,4,1,237
68612405,69,91,88,74,30,22,2,4,380
68612406,55,85,51,52,25,8,3,2,281
68612407,73,114,87,108,45,5,0,1,433
68612408,62,113,74,98,29,5,0,2,383
68612409,70,90,79,56,29,7,0,2,333
68612410,78,104,72,60,31,4,1,2,352
68612411,59,127,95,103,27,14,1,3,429
68612501,44,64,45,44,20,10,3,0,230
68612502,61,143,101,72,42,15,3,4,441
68612503,67,120,79,55,39,13,5,4,382
68612504,26,34,45,41,31,21,4,4,206
68612505,57,66,50,61,28,16,7,5,290
68612506,46,75,69,57,26,10,3,2,288
68612507,85,88,73,38,19,7,3,3,316
68612508,95,109,77,68,25,15,1,0,390
68612509,59,104,89,59,29,12,5,3,360
68612601,79,117,83,73,26,11,6,1,396
68612602,52,80,64,71,15,8,2,0,292
68612603,51,77,66,51,19,3,1,2,270
68612604,66,93,63,58,18,8,4,1,311
68612605,41,99,67,55,30,9,1,0,302
68612606,78,115,74,47,13,7,1,2,337
68612607,82,115,56,66,18,7,0,2,346
68612608,79,109,92,83,31,11,5,2,412
68612609,65,87,78,62,21,10,2,3,328
68612610,58,87,69,61,23,6,3,2,309
68612701,91,119,69,64,13,6,4,1,367
68612702,58,105,69,52,19,6,1,1,311
68612703,37,92,58,58,22,8,3,2,280
68612704,51,64,51,39,31,4,0,3,243
68612705,35,63,51,64,23,6,0,0,242
68612706,53,90,56,52,26,11,2,2,292
68612707,87,101,70,49,24,10,3,2,346
68612708,59,94,83,56,27,10,2,2,333
68612709,47,86,65,49,20,1,1,1,270
68612710,58,83,47,57,24,11,3,4,287
68612801,48,69,34,24,7,5,2,2,191
68612802,73,105,80,54,24,9,3,3,351
68612803,45,73,45,36,27,9,1,2,238
68612804,71,103,60,48,21,4,3,1,311
68612805,51,82,58,40,15,6,0,3,255
68612806,77,82,59,36,21,6,3,1,285
68612807,46,89,68,39,18,6,1,1,268
68612808,38,62,37,29,20,3,1,0,190
68612809,56,80,53,43,11,6,3,1,253
68612810,59,80,81,49,19,5,5,0,298
68612901,82,151,104,83,51,28,9,7,515
68612902,60,92,55,45,23,12,0,1,288
68612903,68,104,81,63,21,9,1,2,349
68612904,60,62,51,57,28,5,2,0,265
68612905,61,84,55,51,27,10,1,7,296
68612906,24,49,38,44,18,8,0,3,184
68612907,44,57,59,53,19,22,3,5,262
68612908,67,97,91,104,73,29,19,22,502
68612909,7,10,38,70,31,19,6,2,183
68612910,91,107,44,72,28,8,1,0,351
68612911,32,86,57,53,18,5,0,1,252
68612912,45,60,39,38,9,2,0,0,193
68613001,54,72,61,54,25,6,2,3,277
68613002,36,55,65,44,36,24,9,22,291
68613003,68,78,78,78,40,35,7,9,393
68613004,56,77,102,111,60,54,10,22,492
68613005,36,37,52,48,33,23,12,9,250
68613006,27,51,58,52,32,27,6,6,259
68613007,19,46,49,43,33,33,15,17,255
68613008,9,15,21,10,7,4,1,1,68
68613009,62,111,92,87,65,21,7,8,453
68613010,45,70,46,26,20,6,2,2,217
68613011,62,76,66,46,19,9,2,3,283
68613012,62,111,79,61,22,4,6,4,349
68613101,77,124,116,72,38,10,5,0,442
68613102,180,152,130,80,49,13,2,3,609
68613103,74,110,83,60,21,7,5,2,362
68613104,151,166,142,109,66,20,2,5,661
68613105,46,69,44,43,18,13,1,3,237
68613106,76,82,59,65,26,26,4,3,341
68613107,83,107,119,69,46,10,3,4,441
68613108,86,103,89,60,34,22,1,4,399
68613109,71,68,75,55,25,16,5,5,320
68613110,85,107,73,88,31,17,4,5,410
68613201,78,40,46,19,27,3,0,0,213
68613202,128,99,76,54,40,7,0,0,404
68613203,31,21,10,7,7,3,0,0,79
68613204,47,24,19,5,12,0,0,0,107
68613205,78,18,41,15,10,1,0,0,163
68613206,67,52,52,37,36,5,0,0,249
68613207,106,78,83,48,57,8,1,2,383
68613208,83,64,42,35,24,6,0,0,254
68613209,78,41,32,34,12,6,0,0,203
68613210,116,71,89,38,47,3,0,0,364
68613301,92,90,68,39,48,6,0,0,343
68613302,95,89,60,52,44,10,0,0,350
68613303,111,97,69,44,43,7,0,0,371
68613304,88,58,42,36,22,6,0,0,252
68613305,108,79,77,41,47,5,0,0,357
68613306,91,76,39,37,23,7,0,0,273
68613307,88,76,72,34,48,4,0,0,322
68613308,101,80,64,40,38,6,0,0,329
68613309,104,74,91,37,55,3,0,0,364
68613310,120,74,100,38,58,2,0,0,392
60070101,38,54,35,38,8,3,0,2,178
60070102,62,73,60,24,20,8,5,1,253
60070103,6,3,2,1,1,0,0,0,13
60070104,0,1,0,0,0,0,0,0,1
60070105,4,2,2,2,0,2,0,0,12
60070106,2,0,1,1,0,1,0,0,5
60070107,9,8,19,15,9,3,1,0,64
60070108,4,3,2,2,0,0,0,0,11
60070109,2,2,2,2,0,0,0,0,8
60070110,7,1,1,2,0,0,0,0,11
60070111,4,1,1,2,0,0,0,0,8
60070112,2,3,2,0,0,0,0,0,7
60070113,3,4,4,4,0,0,0,0,15
60070114,3,6,6,5,1,0,0,0,21
60070115,29,41,30,22,8,8,2,0,140
60070201,0,1,1,3,1,1,1,0,8
60070202,4,0,1,1,0,1,0,0,7
60070203,2,2,3,3,1,0,1,0,12
60070204,1,0,0,0,3,0,0,0,4
60070205,1,4,0,2,0,0,0,0,7
60070206,6,2,5,1,1,0,0,0,15
60070207,3,0,0,0,0,0,0,0,3
60070208,1,2,0,1,0,0,0,0,4
60070209,2,0,2,2,0,0,0,0,6
60070301,0,3,1,1,0,0,0,0,5
60070302,2,2,1,0,1,1,0,0,7
60070303,1,4,3,5,2,0,0,0,15
60070304,0,4,6,2,0,0,0,0,12
60070305,2,1,1,0,0,0,0,0,4
60070306,3,4,4,3,2,2,1,0,19
60070307,0,1,3,0,1,0,0,0,5
60070308,3,4,4,0,0,0,0,0,11
60070401,4,6,3,0,0,0,0,0,13
60070402,8,14,12,10,4,4,3,1,56
60070403,73,78,35,26,14,5,2,1,234
60070404,52,76,55,41,17,11,0,1,253
60070405,95,98,73,37,19,6,3,1,332
60070406,43,54,29,23,7,4,1,0,161
60070407,57,47,44,13,14,12,7,1,195
60070408,1,1,0,2,1,1,0,0,6
60070409,0,1,0,2,1,0,0,0,4
60070410,0,1,1,0,0,0,0,0,2
60070411,0,1,0,0,1,0,1,0,3
60070412,2,0,0,0,0,0,0,0,2
60070413,1,2,3,0,0,0,0,0,6
60070501,9,19,5,8,2,0,0,0,43
60070502,0,0,0,0,0,0,0,0,0
60070503,0,1,1,1,0,1,0,0,4
60070504,2,5,1,2,0,0,0,0,10
60070505,1,1,0,1,0,0,0,0,3
60070506,2,1,0,0,0,0,1,0,4
60070507,0,2,1,1,0,0,0,0,4
60070508,0,1,0,1,0,0,0,0,2
60070509,2,0,1,3,0,0,0,0,6
60070510,0,1,2,0,0,0,0,0,3
60070511,1,1,1,0,0,1,0,0,4
60070512,1,1,2,0,0,1,0,0,5
60070513,1,1,0,0,0,0,0,0,2
60070514,0,2,3,2,1,0,0,0,8
60070515,1,3,4,3,0,0,0,0,11
60070516,0,0,2,1,0,0,0,0,3
60070601,31,59,32,28,9,5,1,0,165
60070602,2,1,2,1,0,1,0,0,7
60070603,6,2,1,1,0,0,0,0,10
60070604,1,0,0,0,0,0,0,0,1
60070605,2,3,3,1,0,0,0,0,9
60070606,3,4,5,1,0,1,0,0,14
60070607,1,0,0,0,0,0,0,0,1
60070608,2,2,1,1,0,0,0,0,6
60070609,0,5,2,1,0,0,0,0,8
60070610,4,2,2,0,1,0,0,0,9
60070611,0,5,2,0,0,0,0,0,7
60070612,14,13,15,4,3,1,0,0,50
60070613,1,4,3,0,0,0,0,0,8
60070614,1,1,1,1,0,0,0,0,4
60070615,1,4,0,2,1,0,0,0,8
60070701,0,5,0,2,0,1,0,1,9
60070702,41,48,35,42,25,10,5,7,213
60070703,2,1,1,2,0,0,0,0,6
60070704,1,3,1,0,0,0,0,0,5
60070801,9,11,2,2,5,1,1,1,32
60070802,25,26,15,16,11,12,3,2,110
60070803,55,67,43,51,24,10,5,2,257
60070804,54,61,57,35,10,5,4,1,227
60070805,39,53,34,31,10,5,0,4,176
60070806,67,92,56,50,16,5,3,0,289
60070807,88,104,61,44,11,4,0,1,313
60070808,68,87,50,32,10,2,2,0,251
60070809,91,111,64,63,20,6,2,1,358
60070810,84,96,63,49,12,2,0,3,309
60070811,53,54,48,39,15,9,2,2,222
60070812,47,52,34,25,19,5,2,3,187
60070813,36,54,38,33,20,16,5,3,205
60070814,46,61,69,70,40,11,6,9,312
60070901,2,3,0,0,0,0,0,0,5
60070902,4,2,0,0,0,1,2,0,9
60070903,0,7,0,0,0,0,0,0,7
60070904,3,2,1,0,0,0,0,0,6
60070905,2,1,0,0,0,0,0,0,3
60070906,0,2,2,1,0,0,0,0,5
60071001,6,3,3,0,0,0,0,0,12
60071002,1,2,0,0,0,0,0,0,3
60071003,1,2,0,2,0,0,0,0,5
60071004,1,0,2,1,0,0,0,0,4
60071005,4,5,1,2,0,0,0,1,13
60071006,4,4,3,2,0,0,0,0,13
60071007,0,4,1,1,0,0,0,0,6
60071008,1,0,0,0,1,0,0,0,2
60071009,0,4,1,0,1,0,0,0,6
60071010,1,4,2,2,0,0,0,1,10
60071011,1,5,0,2,0,0,1,0,9
60071012,2,3,0,0,0,0,0,0,5
60071101,1,2,3,3,1,0,1,0,11
60071102,0,0,0,0,0,0,0,0,0
60071103,1,4,0,1,0,0,0,0,6
60071104,5,0,0,1,1,2,0,0,9
60071105,1,1,0,0,1,1,0,0,4
60071106,1,1,1,0,0,0,0,0,3
60071107,2,1,0,2,0,0,0,0,5
60071108,2,0,3,0,0,0,0,1,6
60071109,0,0,0,0,0,0,0,0,0
60071110,2,0,2,1,1,0,0,0,6
60071111,0,4,0,1,0,0,1,0,6
60140101,14,2,2,5,2,2,0,0,27
60140201,3,0,2,4,1,1,0,0,11
60140301,8,7,13,9,7,8,2,2,56
60140302,14,1,3,9,5,1,0,1,34
60140401,9,10,4,6,3,2,0,1,35
60140501,35,61,28,20,8,0,1,0,153
60140502,8,6,5,4,9,1,2,2,37
60140503,6,13,7,4,5,1,0,0,36
60140504,67,99,57,43,18,10,3,4,301
60140505,28,49,35,27,8,4,2,1,154
60140601,6,6,4,1,1,1,0,0,19
60140701,1,3,1,7,0,0,0,0,12
60140801,7,11,4,6,1,1,0,0,30
60140901,2,5,5,2,1,0,0,0,15
60141001,29,28,18,28,11,7,4,2,127
60141002,6,5,7,6,4,1,0,0,29
60141003,32,37,26,28,15,7,2,3,150
60141004,29,49,42,34,20,7,1,1,183
60141005,32,68,51,31,17,15,1,6,221
60141006,42,60,35,36,23,6,1,1,204
60141007,19,20,31,33,15,10,4,5,137
60141008,35,57,45,37,23,13,3,0,213
60141009,76,94,41,36,21,9,0,0,277
60141010,95,101,75,48,20,11,3,1,354
60141011,87,101,53,41,21,3,0,1,307
60141012,36,46,42,45,9,11,1,3,193
60141013,65,113,49,53,19,5,0,2,306
60141014,58,46,41,35,17,8,7,0,212
60141015,27,64,62,66,36,13,11,3,282
60141101,3,5,5,2,1,2,0,0,18
60141201,1,8,0,5,2,0,0,1,17
60141202,9,5,2,2,0,0,0,0,18
60141301,5,4,6,0,4,1,1,0,21
60141401,3,1,2,0,1,0,0,0,7
60141501,1,0,2,0,0,0,0,0,3
60210101,4,4,0,0,0,1,0,0,9
60210102,1,3,2,0,0,0,0,0,6
60210201,37,48,22,32,11,0,2,2,154
60210202,29,45,37,23,7,5,0,1,147
60210203,2,5,3,2,1,0,0,1,14
60210204,0,2,3,0,0,1,0,0,6
60210205,0,0,1,1,1,0,0,0,3
60210206,6,24,10,8,5,1,2,2,58
60210207,2,2,3,2,1,1,0,0,11
60210301,3,2,0,1,1,0,0,0,7
60210302,1,1,4,1,0,0,0,0,7
60210401,3,2,2,5,0,0,0,0,12
60210402,1,3,1,1,0,0,0,0,6
60210501,30,38,20,21,17,7,5,0,138
60210502,2,4,1,2,2,0,0,0,11
60210503,2,0,2,1,0,0,0,0,5
60210601,30,27,27,18,12,6,2,1,123
60210602,78,128,87,74,37,15,3,0,422
60210603,83,94,48,49,15,6,1,0,296
60210604,68,113,80,65,40,14,1,3,384
60210605,87,85,36,32,18,2,1,0,261
60210606,69,86,72,45,16,6,0,0,294
60210607,78,112,70,71,34,12,9,9,395
60210608,29,50,31,18,10,4,1,0,143
60210609,6,7,4,4,3,0,1,1,26
60210610,17,21,19,14,13,5,1,3,93
60210611,66,79,77,54,36,11,4,4,331
60210612,47,50,58,37,23,6,3,3,227
60210701,1,1,2,1,1,0,0,0,6
60210702,1,2,2,0,0,0,0,0,5
60210801,20,11,14,17,8,0,0,0,70
60210802,2,3,1,0,0,0,0,0,6
60210803,4,6,1,3,2,0,0,0,16
60210804,6,3,3,2,2,0,0,0,16
60210901,3,4,2,1,1,1,0,0,12
60210902,5,3,0,1,1,0,0,0,10
60210903,1,8,1,3,0,0,0,0,13
60210904,5,8,3,0,1,0,0,0,17
60211001,3,4,2,1,0,0,1,0,11
60211002,13,19,9,6,2,0,0,0,49
60211003,1,3,2,0,0,2,0,0,8
60420101,59,77,75,80,43,22,10,15,381
60420102,83,92,38,32,23,8,0,0,276
60420103,86,100,52,36,14,7,0,1,296
60420104,84,72,43,28,17,3,0,0,247
60420105,47,66,36,40,30,8,4,4,235
60420106,56,68,55,42,21,7,1,1,251
60420107,44,66,49,36,23,6,3,5,232
60420108,124,132,70,46,14,8,4,1,399
60420109,92,113,90,74,30,19,1,5,424
60420201,10,19,11,8,4,1,2,0,55
60420301,20,18,12,11,5,2,0,0,68
60420401,11,6,11,4,7,0,1,1,41
60420501,21,21,22,13,16,6,0,0,99
60420601,16,16,8,10,4,1,0,3,58
60420701,18,17,12,9,5,0,3,0,64
60420801,9,13,7,9,2,2,0,0,42
60420901,29,23,12,15,9,4,1,0,93
60421001,10,13,11,11,5,1,0,1,52
60421101,7,10,2,2,2,1,0,0,24
60421102,38,39,26,28,13,9,2,3,158
60421103,61,67,59,48,28,20,6,10,299
60421201,14,12,8,9,6,2,1,0,52
60421301,20,11,5,5,1,2,0,0,44
60421401,23,18,13,9,3,3,0,0,69
60421501,12,10,3,4,3,3,1,1,37
60421601,10,12,5,5,1,1,0,0,34
60421701,5,9,8,7,6,1,0,0,36
60421801,3,4,5,2,1,2,0,1,18
60421901,53,71,89,64,29,6,8,9,329
60421902,69,70,70,48,23,9,6,5,300
60421903,68,80,75,56,38,24,16,10,367
60421904,82,100,61,41,18,6,2,1,311
60421905,82,86,52,51,22,10,3,3,309
60421906,83,89,68,31,30,6,1,2,310
60421907,41,63,41,35,27,15,4,5,231
60421908,27,46,36,59,28,14,4,10,224
60421909,112,88,87,96,47,35,18,19,502
60490101,63,70,31,37,13,3,1,1,219
60490102,73,65,36,19,14,2,1,0,210
60490103,67,77,56,36,16,5,2,0,259
60490104,107,102,34,30,14,4,0,0,291
60490105,108,75,46,27,7,2,0,0,265
60490106,89,84,38,20,10,4,1,0,246
60490107,72,96,51,26,16,3,1,3,268
60490108,84,87,56,45,23,3,0,1,299
60490109,91,100,54,20,5,3,0,1,274
60490110,55,75,54,56,20,13,8,8,289
60490111,35,57,69,40,31,14,5,2,253
60490112,36,36,35,25,12,11,5,3,163
60490113,54,90,47,32,9,7,0,2,241
60490114,40,41,57,56,34,15,6,6,255
60490115,28,35,34,36,24,9,9,13,188
60490116,22,44,37,35,26,12,7,6,189
60490201,88,77,43,29,16,4,1,0,258
60490202,66,107,54,31,15,7,1,2,283
60490203,72,93,62,33,19,5,0,0,284
60490204,72,101,74,62,33,17,3,3,365
60490205,51,64,76,54,49,32,13,21,360
60490206,67,103,56,49,17,7,2,0,301
60490207,54,99,40,34,11,4,3,3,248
60490208,69,98,63,35,23,9,4,3,304
60490209,58,86,81,41,25,15,8,4,318
60490210,27,57,38,45,24,14,7,5,217
60490211,52,69,62,49,24,16,1,6,279
60490212,51,67,59,55,29,20,5,11,297
60490213,34,70,46,29,29,9,5,13,235
60490301,12,21,12,7,2,0,0,0,54
60490302,12,7,5,4,2,0,0,1,31
60490401,23,40,28,16,9,8,4,0,128
60490402,9,20,19,23,13,3,1,1,89
60490403,12,13,29,26,8,3,0,1,92
60490404,20,31,21,16,13,2,0,0,103
60490405,13,30,33,46,16,4,0,0,142
60490406,21,36,29,46,16,4,1,1,154
60490407,26,44,35,27,19,7,8,10,176
60490501,64,94,46,34,18,5,0,0,261
60490502,67,85,29,38,17,2,0,0,238
60490503,70,74,39,33,14,3,0,3,236
60490504,78,131,72,73,38,15,4,3,414
60490505,81,103,63,53,14,11,0,4,329
60490506,73,96,68,31,9,4,1,0,282
60490507,86,87,59,40,27,11,3,2,315
60490508,77,93,90,71,28,16,5,2,382
60490601,58,102,74,57,22,3,1,0,317
60490602,35,42,41,42,21,22,5,4,212
60490603,93,96,75,64,36,16,10,10,400
60490604,80,81,51,44,16,10,5,2,289
60490605,60,82,52,47,21,5,1,0,268
60490606,97,115,86,38,22,11,1,3,373
60490607,70,87,68,63,35,15,2,5,345
60490608,75,103,84,79,39,28,3,9,420
60490609,50,81,58,61,40,16,8,4,318
60490610,27,34,34,39,16,3,1,2,156
60490611,44,55,74,68,49,25,8,12,335
60490612,36,61,73,66,31,20,8,8,303
60490613,55,89,79,90,62,26,9,13,423
60490614,40,61,59,59,41,21,7,3,291
60490615,24,26,29,28,12,11,7,5,142
60490701,0,1,0,1,2,0,0,0,4
60490702,10,9,7,4,4,1,0,0,35
60490801,4,7,4,3,1,1,0,0,20
60490901,6,7,7,8,1,1,1,0,31
60491001,44,22,22,8,7,8,3,2,116
60491002,42,36,16,14,12,0,2,2,124
60491003,44,56,32,32,13,8,0,3,188
60491004,31,33,21,15,7,3,1,0,111
60491005,19,28,24,11,9,5,0,1,97
60491006,22,37,23,23,7,3,2,0,117
60491007,22,21,28,18,15,3,5,3,115
60491008,39,51,33,23,18,9,2,2,177
60491009,14,15,8,10,6,4,0,0,57
60491101,6,13,7,3,2,1,0,0,32
60491102,14,15,3,5,2,3,0,0,42
60491201,10,15,6,8,2,1,0,0,42
60491301,12,12,4,9,1,0,0,0,38
60491401,6,4,4,1,2,1,0,0,18
60491402,6,7,2,5,1,0,0,0,21
60491501,10,8,8,8,0,0,0,1,35
60491601,8,5,7,6,2,4,0,0,32
60491701,13,10,5,8,3,1,0,0,40
60491801,36,17,12,15,7,3,1,1,92
60491901,14,16,10,5,5,4,1,1,56
60492001,107,103,75,70,25,6,3,2,391
60492002,88,91,67,61,25,12,5,8,357
60492003,9,7,6,6,3,3,0,1,35
60492004,12,6,8,5,2,0,1,0,34
60492005,1,5,6,3,0,0,0,1,16
60492006,58,35,38,30,11,9,7,1,189
60492007,40,69,37,34,19,3,0,0,202
60492101,11,10,10,6,8,0,0,1,46
60492102,10,15,6,8,6,2,0,1,48
60492201,23,19,6,12,9,6,1,3,79
60492301,17,21,11,10,4,0,0,1,64
60492401,3,5,6,2,1,2,0,0,19
60492501,55,44,52,42,35,21,10,13,272
60492502,39,68,79,115,73,26,16,15,431
60492503,63,58,47,33,19,3,1,1,225
60492504,40,71,47,44,40,21,5,8,276
60492505,34,35,41,40,25,25,12,28,240
60492506,47,58,53,55,23,12,1,0,249
60492507,80,116,74,90,49,21,2,5,437
60492508,65,116,84,79,29,11,3,0,387
60492509,72,86,87,81,41,33,8,7,415
60492510,32,58,54,66,42,22,7,11,292
60560101,111,121,55,20,15,3,1,0,326
60560102,135,146,41,24,9,2,4,0,361
60560103,179,145,36,23,7,1,0,0,391
60560104,67,57,20,12,10,0,0,0,166
60560105,74,69,30,18,2,1,0,0,194
60560106,57,80,25,11,4,0,0,0,177
60560107,139,68,17,10,3,1,1,0,239
60560108,148,194,85,37,12,3,0,0,479
60560109,72,75,20,13,4,1,0,0,185
60560110,91,92,24,24,5,4,0,0,240
60560111,109,114,43,23,6,1,0,1,297
60560112,115,90,43,20,8,1,0,0,277
60560113,86,83,31,30,6,4,1,0,241
60560114,107,76,22,13,4,1,0,0,223
60560115,68,85,40,23,11,0,1,1,229
60560116,76,82,21,22,8,5,0,0,214
60560117,76,78,38,23,2,2,1,0,220
60560118,76,56,19,24,1,0,0,0,176
60560119,104,108,46,27,5,3,0,2,295
60560201,46,53,66,50,42,20,12,13,302
60560202,56,82,79,81,49,20,3,7,377
60560203,24,55,37,35,17,12,2,0,182
60560204,16,58,41,49,21,6,1,1,193
60560205,25,62,34,34,23,7,3,1,189
60560206,59,64,32,26,11,0,0,0,192
60560207,88,110,50,32,15,5,1,0,301
60560208,101,113,71,54,17,5,3,0,364
60560209,48,71,60,45,17,9,1,1,252
60560210,62,95,65,42,23,4,2,1,294
60560211,46,81,69,77,29,12,2,2,318
60560212,72,84,77,55,31,5,1,4,329
60560213,32,73,29,24,15,0,1,3,177
60560214,61,67,55,29,24,8,2,1,247
60560301,76,57,27,9,8,4,0,0,181
60560302,95,92,25,16,9,1,0,0,238
60560303,83,106,56,30,5,4,1,0,285
60560304,64,94,48,46,17,2,2,0,273
60560305,34,37,24,19,4,5,0,0,123
60560306,149,97,42,33,11,2,0,1,335
60560307,52,70,45,31,13,6,4,0,221
60560308,40,64,38,21,8,9,2,2,184
60560309,53,68,37,34,17,8,0,1,218
60560310,69,88,48,42,20,8,3,1,279
60560311,95,103,69,59,26,11,0,0,363
60560312,54,65,51,38,22,1,1,1,233
60560401,91,100,90,66,30,8,1,1,387
60560402,33,60,55,40,20,17,5,3,233
60560403,38,82,79,72,29,10,6,1,317
60560404,106,144,98,76,33,12,0,1,470
60560405,108,139,107,51,21,8,4,2,440
60560406,122,124,95,59,23,8,5,3,439
60560407,69,99,65,56,18,6,1,1,315
60560408,60,86,60,35,13,4,0,0,258
60560409,56,70,40,28,12,3,2,0,211
60560410,34,41,29,22,16,8,0,0,150
60560501,45,43,47,41,34,12,5,1,228
60560502,53,70,61,61,29,17,6,4,301
60560503,62,84,79,85,44,21,15,17,407
60560504,77,99,93,78,26,10,3,9,395
60560505,29,43,40,26,19,6,2,4,169
60560506,67,92,65,63,29,6,5,0,327
60560507,76,68,74,69,26,10,3,3,329
60560508,47,51,42,44,22,6,2,2,216
60560509,55,109,81,62,40,12,8,6,373
60560601,41,49,57,67,33,15,4,6,272
60560602,49,83,64,78,31,6,5,2,318
60560603,46,72,67,48,33,6,1,5,278
60560604,34,53,55,41,21,7,0,2,213
60560605,61,93,83,94,43,23,9,6,412
60560606,48,58,42,30,15,2,3,3,201
60560607,52,93,105,90,40,16,4,1,401
60560608,63,56,77,73,42,16,10,7,344
60560609,54,70,78,86,43,17,5,8,361
60560701,70,109,90,69,38,12,4,2,394
60560702,82,107,54,33,26,6,0,1,309
60560703,71,98,82,62,33,20,3,1,370
60560704,83,118,77,63,34,6,5,4,390
60560705,30,56,53,51,23,7,3,0,223
60560706,43,58,52,56,19,9,1,4,242
60560707,63,100,72,56,35,16,3,2,347
60560708,43,83,65,54,23,4,3,2,277
60560709,47,77,81,86,37,14,8,7,357
60560710,63,92,64,58,33,14,4,2,330
60560711,59,93,77,74,35,24,7,5,374
60560801,41,97,116,96,71,31,10,14,476
60560802,61,80,76,111,79,34,18,16,475
60560803,32,75,87,96,35,29,4,9,367
60560804,56,65,86,100,60,34,9,12,422
60560805,77,111,93,86,52,34,7,12,472
60560806,44,57,45,41,28,16,15,6,252
60560807,35,59,48,40,21,32,5,8,248
60560808,3,15,13,8,17,8,3,6,73
60560809,57,84,105,93,75,55,21,19,509
60560810,39,45,42,47,17,15,3,10,218
60560811,6,7,0,1,3,5,0,1,23
60560812,48,45,44,55,33,32,11,7,275
60560813,38,51,53,91,38,28,12,14,325
60560814,42,66,70,96,60,32,17,17,400
60560815,20,29,42,37,25,23,18,8,202
60560901,105,127,47,22,6,1,1,0,309
60560902,96,86,36,32,14,5,1,0,270
60560903,83,87,54,28,8,1,1,1,263
60560904,69,87,48,36,10,3,1,1,255
60560905,56,77,40,32,9,7,1,2,224
60560906,96,106,57,36,18,9,3,1,326
60560907,74,72,26,41,10,2,0,1,226
60560908,65,95,39,37,14,12,1,1,264
60560909,24,44,24,25,21,12,1,2,153
60560910,37,60,32,29,21,5,0,1,185
60560911,40,63,45,30,15,9,4,2,208
60561001,50,51,17,6,2,2,1,0,129
60561002,83,64,20,10,5,1,0,0,183
60561003,153,80,35,13,7,0,0,0,288
60561004,137,94,43,22,10,1,1,0,308
60561005,96,48,28,13,7,3,0,2,197
60561006,68,49,30,14,7,2,1,0,171
60561007,90,91,30,27,6,1,0,0,245
60561008,127,102,55,28,7,3,3,0,325
60561009,87,73,34,22,9,4,1,0,230
60561010,88,66,42,25,8,1,0,0,230
60561011,53,62,33,33,11,1,2,0,195
60561101,65,73,37,25,6,2,1,1,210
60561102,41,57,21,12,13,1,0,1,146
60561103,49,50,29,14,4,2,0,0,148
60561104,129,81,24,5,5,0,0,0,244
60561105,115,62,24,10,3,1,0,0,215
60561106,103,71,27,9,3,0,1,0,214
60561107,120,86,31,15,4,1,1,0,258
60561108,112,75,30,14,2,1,0,0,234
60561109,80,70,26,7,3,0,1,0,187
60561110,122,78,37,25,6,2,1,0,271
60561111,102,80,36,9,8,0,1,0,236
60561112,107,90,56,18,6,1,0,1,279
60561113,106,88,35,12,9,1,0,2,253
60561114,85,62,40,18,2,1,1,0,209
60561201,126,119,37,19,8,1,0,0,310
60561202,127,114,31,16,4,1,1,0,294
60561203,76,63,33,20,1,0,0,0,193
60561204,101,101,45,15,4,4,1,0,271
60561205,147,92,27,12,5,1,0,0,284
60561206,144,77,28,12,3,1,0,0,265
60561207,95,69,24,11,2,1,1,0,203
60561208,84,85,41,13,9,1,0,0,233
60561209,95,86,26,21,13,1,0,0,242
60561210,66,55,18,4,2,0,0,0,145
60561211,71,64,21,7,5,1,0,0,169
60561301,201,146,82,43,19,4,0,1,496
60561302,105,115,43,26,12,7,3,0,311
60561303,121,128,35,18,10,0,0,1,313
60561304,81,56,20,8,4,2,1,0,172
60561305,57,61,30,22,7,1,0,0,178
60561306,85,74,59,33,3,4,1,1,260
60561307,131,115,43,20,10,1,1,0,321
60561308,129,114,39,17,7,3,1,1,311
60561309,76,68,15,6,4,1,0,2,172
60561310,91,86,40,15,6,4,0,0,242
60561401,52,77,49,21,5,2,1,1,208
60561402,49,77,43,31,14,6,1,0,221
60561403,92,96,39,23,9,2,0,0,261
60561404,76,74,42,28,3,4,0,0,227
60561405,79,77,38,16,5,2,0,0,217
60561406,136,123,66,56,20,5,2,1,409
60561407,89,85,27,28,8,3,0,0,240
60561408,126,104,50,18,6,0,1,0,305
60561409,60,61,23,19,5,1,1,0,170
60561410,123,118,45,18,5,1,0,0,310
60561411,74,56,42,24,8,2,0,0,206
60561412,64,68,20,16,5,3,0,0,176
60561413,127,99,34,17,5,0,0,0,282
60561414,145,111,46,17,12,9,0,0,340
60561415,106,54,21,7,1,2,0,0,191
60561416,118,126,47,25,9,3,0,0,328
60561417,115,94,38,26,6,1,0,0,280
60561418,95,80,28,10,3,1,0,0,217
60561419,87,98,48,15,6,2,0,0,256
60561420,60,39,11,4,0,0,0,0,114
60561421,84,57,26,14,6,1,0,0,188
60561501,47,57,65,61,38,16,14,4,302
60561502,52,80,89,94,44,18,3,3,383
60561503,57,96,64,80,27,9,2,1,336
60561504,49,73,53,35,23,8,3,2,246
60561505,42,71,58,61,28,17,4,1,282
60561506,35,71,70,77,36,18,10,2,319
60561507,52,87,75,51,27,8,6,1,307
60561508,48,81,81,88,47,20,6,10,381
60561509,15,43,39,45,18,11,3,3,177
60561510,30,62,45,45,16,12,1,1,212
60561511,25,72,61,45,18,12,2,1,236
60561512,58,88,119,76,38,16,3,2,400
60561513,36,50,49,57,21,13,6,2,234
60561514,45,65,74,70,44,30,5,8,341
60561515,74,93,94,99,52,20,3,12,447
60561516,20,37,31,49,24,6,4,4,175
60561517,22,39,34,44,20,9,2,3,173
60561601,43,67,41,44,15,4,0,0,214
60561602,40,52,47,43,13,4,2,1,202
60561603,66,71,45,39,18,5,0,0,244
60561604,41,65,31,31,9,5,0,0,182
60561605,67,116,63,52,13,1,1,0,313
60561606,39,61,35,25,7,4,0,0,171
60561607,56,58,35,26,13,1,0,1,190
60561608,74,99,69,48,17,6,1,1,315
60561609,89,85,76,45,15,3,2,0,315
60561610,90,74,53,32,15,4,1,1,270
60561611,110,109,50,46,15,3,0,2,335
60561612,88,87,37,32,10,3,1,0,258
60561613,143,104,55,24,11,3,0,1,341
60561614,76,82,51,26,13,2,1,0,251
60561701,78,116,69,50,24,6,1,0,344
60561702,82,106,66,46,21,8,1,1,331
60561703,84,101,72,63,16,2,2,0,340
60561704,57,59,39,38,15,4,2,0,214
60561705,56,71,29,13,10,5,0,0,184
60561706,86,105,59,35,20,5,1,0,311
60561707,92,97,72,44,11,2,0,1,319
60561708,62,103,46,31,11,5,1,0,259
60561709,81,73,43,32,19,4,0,1,253
60561710,92,71,44,32,14,8,0,0,261
60561801,75,110,78,71,29,17,2,2,384
60561802,75,110,76,70,24,14,2,0,371
60561803,49,67,54,34,16,1,1,0,222
60561804,26,66,50,54,24,8,3,2,233
60561805,60,109,60,47,25,6,3,1,311
60561806,61,98,61,42,21,7,2,3,295
60561807,81,106,71,65,14,13,5,0,355
60561808,60,113,63,55,20,9,5,2,327
60561809,71,94,53,48,24,14,0,5,309
60561810,64,73,50,32,18,11,3,1,252
60561901,68,98,73,56,27,13,8,6,349
60561902,71,101,65,67,26,6,2,4,342
60561903,68,138,111,56,46,14,7,0,440
60561904,42,85,70,60,47,24,5,8,341
60561905,36,72,83,81,49,25,22,15,383
60561906,71,135,109,79,35,15,1,6,451
60561907,54,86,67,90,47,29,9,11,393
60561908,26,31,49,54,40,21,8,11,240
60561909,44,52,42,47,32,20,8,3,248
60561910,59,69,93,95,82,51,15,15,479
60561911,66,95,64,53,38,14,5,5,340
60561912,58,98,87,84,44,16,3,7,397
60561913,69,108,78,85,40,20,9,4,413
60561914,41,60,57,40,20,1,3,6,228
60562001,112,124,88,64,16,8,2,0,414
60562002,93,134,79,52,23,4,2,0,387
60562003,75,99,65,42,24,5,1,0,311
60562004,103,93,63,38,17,4,2,0,320
60562005,82,126,61,61,20,5,1,1,357
60562006,89,84,44,24,7,4,1,1,254
60562007,79,85,40,24,6,4,2,0,240
60562008,45,55,37,29,13,7,1,2,189
60562009,32,61,45,36,8,8,2,1,193
60562010,39,58,44,32,21,6,3,1,204
60562101,65,98,55,50,36,11,2,2,319
60562102,59,103,57,53,18,8,2,0,300
60562103,41,53,44,41,23,4,3,0,209
60562104,30,73,49,39,20,8,2,4,225
60562105,84,95,75,56,30,9,0,2,351
60562106,15,41,25,40,19,10,4,4,158
60562107,68,71,53,82,34,32,3,9,352
60562108,55,67,55,28,9,0,0,0,214
60562109,64,82,62,41,17,2,1,0,269
60562110,32,85,50,54,17,10,2,2,252
60562111,54,80,70,79,31,18,6,3,341
60562201,68,103,74,60,30,5,1,2,343
60562202,77,106,60,60,26,10,3,3,345
60562203,64,95,82,89,21,14,3,2,370
60562204,79,94,94,72,38,27,2,4,410
60562205,33,59,47,57,24,22,6,5,253
60562206,80,71,62,56,42,22,8,10,351
60562207,32,51,48,45,29,6,3,2,216
60562208,67,105,81,74,39,21,2,2,391
60562209,50,52,44,35,13,7,4,1,206
60562210,63,75,54,52,23,11,3,2,283
60562211,67,82,42,48,19,5,0,1,264
60562212,6,8,16,20,18,19,4,10,101
60562213,59,38,42,64,35,30,16,11,295
60562214,43,69,68,64,41,8,8,8,309
60562215,48,59,60,70,39,11,7,3,297
60562216,67,107,78,55,24,8,3,1,343
60562217,63,105,77,65,25,17,2,1,355
60562301,30,26,43,34,26,20,10,6,195
60562302,44,54,60,51,41,18,6,6,280
60562303,53,59,65,67,37,32,13,8,334
60562304,51,93,116,100,69,29,12,11,481
60562305,51,65,52,52,24,9,4,0,257
60562306,40,73,62,68,35,15,8,8,309
60562307,35,55,58,66,36,12,7,3,272
60562308,36,84,68,67,26,5,5,1,292
60562309,62,72,85,71,41,21,14,12,378
60562310,70,77,47,57,19,5,6,3,284
60562311,34,47,25,35,22,10,3,3,179
60562312,49,53,32,41,10,15,4,3,207
60562313,73,53,44,45,20,11,4,0,250
60562314,64,73,66,53,39,17,3,3,318
60562315,44,51,61,45,28,17,8,9,263
60562316,56,43,52,60,42,21,8,14,296
60562401,36,86,96,108,44,18,2,2,392
60562402,53,80,108,113,50,40,15,14,473
60562403,35,64,64,81,31,15,8,7,305
60562404,26,67,91,111,47,22,1,0,365
60562405,36,44,78,69,56,21,11,10,325
60562406,43,91,94,131,47,25,0,3,434
60562407,39,83,94,99,40,20,10,5,390
60562408,101,82,176,163,106,60,20,24,732
60562409,41,67,78,82,36,38,12,7,361
60562410,26,65,67,51,29,19,6,4,267
60562411,41,46,42,31,17,9,5,3,194
60562412,56,66,69,93,47,42,21,19,413
60562413,58,83,83,77,46,43,6,9,405
60562414,36,43,54,52,26,12,4,7,234
60562415,38,48,51,34,26,20,11,10,238
60562416,52,69,62,73,48,30,12,10,356
60562417,36,51,29,24,27,11,4,4,186
60562501,49,81,96,115,35,11,0,2,389
60562502,68,115,107,111,51,19,10,6,487
60562503,29,74,58,61,32,13,5,6,278
60562504,43,87,92,96,46,23,11,7,405
60562505,32,77,82,59,45,29,14,16,354
60562506,60,80,89,90,50,30,9,13,421
60562507,38,95,91,97,42,22,6,10,401
60562508,74,95,90,84,41,8,1,2,395
60562509,38,75,88,97,36,18,8,2,362
60562510,47,93,73,83,25,4,1,2,328
60562511,69,91,75,66,31,11,0,0,343
60562512,58,68,83,86,44,5,2,2,348
60562513,68,93,52,60,11,3,2,0,289
60562514,73,107,74,45,10,4,0,1,314
60562515,60,97,35,50,14,2,1,0,259
60562516,103,102,73,40,18,4,3,0,343
60562601,24,57,72,76,28,16,3,5,281
60562602,35,67,73,51,40,13,4,6,289
60562603,44,70,76,46,39,22,8,8,313
60562604,13,31,30,39,8,5,1,1,128
60562605,45,69,76,67,28,11,5,0,301
60562606,30,47,41,46,16,5,2,2,189
60562607,31,89,74,86,23,11,2,0,316
60562608,40,79,69,77,32,12,0,0,309
60562609,22,40,48,48,27,10,1,0,196
60562610,70,109,115,161,77,29,7,4,572
60562611,36,93,85,139,57,16,0,0,426
60562612,21,40,39,36,13,12,4,1,166
60562613,55,76,98,118,46,30,6,9,438
60562614,35,73,79,109,58,17,2,2,375
60562615,25,42,47,68,37,18,10,10,257
60562616,26,40,51,45,39,28,12,15,256
60562617,62,72,96,110,65,37,11,15,468
60562618,17,34,50,37,33,18,4,8,201
60562619,14,27,26,44,25,20,8,12,176
60562701,9,13,14,6,0,3,0,1,46
60562702,24,39,70,58,30,15,4,4,244
60562703,34,54,72,71,46,21,6,8,312
60562704,44,49,66,53,43,28,3,4,290
60562705,16,26,28,35,13,7,0,1,126
60562706,14,21,25,17,11,8,0,4,100
60562707,37,71,71,63,37,21,9,16,325
60562708,27,24,36,29,19,14,4,2,155
60562801,5,9,5,2,1,0,0,0,22
60562901,5,3,5,3,1,0,0,0,17
60563001,8,14,7,5,2,4,3,0,43
60563002,23,39,32,23,12,5,4,2,140
60563003,55,66,25,33,13,12,0,3,207
60563004,46,74,31,24,15,13,1,1,205
60563005,22,28,16,19,9,12,0,0,106
60563006,20,20,12,14,4,0,1,2,73
60563007,5,8,7,3,0,2,2,0,27
60563101,18,15,17,5,2,1,1,0,59
60563201,12,5,3,1,2,0,0,0,23
60563202,54,64,38,33,20,13,2,2,226
60563203,61,61,69,74,46,14,3,11,339
60563204,40,20,14,13,10,13,2,1,113
60563205,62,91,72,69,24,11,5,8,342
60563206,52,65,74,75,48,18,4,4,340
60563207,27,35,19,40,21,12,6,9,169
60563208,29,46,44,54,35,23,10,6,247
60563209,59,92,82,72,33,19,8,10,375
60563210,65,90,49,65,30,9,5,2,315
60563211,65,79,69,49,30,14,8,6,320
60563212,22,0,0,0,0,0,0,0,22
60630101,41,63,58,49,34,22,8,11,286
60630102,79,94,57,52,22,10,6,4,324
60630103,60,80,77,63,25,18,7,4,334
60630104,42,53,87,70,47,22,10,13,344
60630105,85,88,89,78,44,17,11,5,417
60630106,59,92,58,43,26,6,1,2,287
60630107,75,98,47,57,21,6,3,0,307
60630108,76,107,76,69,35,11,5,3,382
60630109,61,87,74,78,46,20,8,7,381
60630110,54,62,51,43,19,8,3,0,240
60630111,73,96,54,44,24,3,2,1,297
60630112,64,65,40,20,19,8,1,0,217
60630113,82,86,48,33,11,10,0,2,272
60630114,72,84,40,44,20,7,2,0,269
60630115,54,77,79,74,36,14,11,6,351
60630116,44,56,43,46,18,18,9,7,241
60630117,38,59,57,42,25,9,4,2,236
60630201,75,105,101,89,34,22,10,10,446
60630202,90,88,46,52,18,0,3,2,299
60630203,70,104,62,43,16,7,1,0,303
60630204,54,66,62,59,42,18,6,4,311
60630205,75,102,78,56,35,13,2,0,361
60630206,31,34,37,20,18,13,1,5,159
60630207,59,101,56,58,29,14,3,5,325
60630208,57,97,69,66,28,10,3,0,330
60630301,6,2,4,1,0,1,0,0,14
60630302,33,40,36,26,20,6,0,1,162
60630303,15,7,6,6,10,4,0,0,48
60630304,5,4,1,2,3,2,0,0,17
60630305,10,8,5,6,0,1,0,2,32
60630306,7,4,3,3,4,0,0,1,22
60630401,0,3,1,1,1,0,0,1,7
60630402,12,7,2,3,2,0,2,0,28
60630403,7,9,1,3,3,0,0,0,23
60630404,14,10,6,6,3,0,0,1,40
60630405,2,2,0,2,2,4,0,0,12
60630406,6,6,9,6,2,0,0,0,29
60630501,1,1,2,0,1,3,0,0,8
60630502,4,5,3,2,2,0,0,0,16
60630601,15,13,4,4,3,3,0,1,43
60630602,5,7,2,5,3,0,0,0,22
60630603,7,5,2,6,5,0,0,0,25
60630604,5,4,6,5,2,1,0,1,24
60630605,4,12,6,4,4,0,0,0,30
60630606,9,3,3,1,1,1,0,0,18
60630607,7,4,1,5,1,0,0,0,18
60630701,50,67,94,97,56,29,18,19,430
60630702,26,38,34,35,27,9,12,8,189
60630703,41,69,57,64,47,26,6,4,314
60630704,25,53,65,79,24,10,1,1,258
60630705,24,34,50,33,28,6,1,2,178
60630706,44,66,82,78,48,29,12,7,366
60630707,61,54,40,44,26,10,4,1,240
60630708,45,83,86,97,46,25,14,10,406
60630709,28,56,61,71,34,11,2,2,265
60630801,2,3,0,1,0,0,0,0,6
60630802,18,16,10,6,6,3,0,1,60
60630803,3,1,3,0,0,1,0,0,8
60630804,7,7,5,2,3,2,1,0,27
60630805,11,20,11,10,4,0,0,0,56
60630806,17,20,8,8,9,3,1,0,66
60630901,23,17,14,16,7,3,1,1,82
60630902,6,8,1,2,0,0,0,0,17
60630903,2,9,5,1,0,0,0,0,17
60630904,4,1,0,2,0,0,0,0,7
60630905,2,3,2,0,2,0,0,0,9
60630906,26,30,15,18,6,4,1,0,100
60631001,4,7,5,0,1,2,0,1,20
60631002,30,28,22,25,10,5,0,2,122
60631003,15,16,6,4,2,0,0,0,43
60631004,7,8,4,2,0,2,0,0,23
60631101,4,5,8,3,1,0,2,0,23
60631102,8,16,5,8,3,2,2,2,46
60631103,13,8,14,6,3,0,0,0,44
60631104,11,11,6,9,3,2,2,1,45
60631105,8,12,5,6,5,1,1,2,40
60631106,14,12,4,7,2,1,1,1,42
60631107,3,9,2,2,1,1,0,0,18
60631201,1,4,2,7,1,0,0,0,15
60631202,5,3,5,2,2,0,0,0,17
60631203,2,2,3,0,1,0,0,0,8
60631301,91,94,45,42,7,2,1,0,282
60631302,76,92,84,53,20,9,1,1,336
60631303,93,131,88,89,28,7,1,2,439
60631304,90,123,55,51,16,3,1,1,340
60631305,98,97,57,52,21,6,2,0,333
60631306,53,86,65,43,26,7,1,1,282
60631307,77,99,86,65,30,13,2,0,372
60631308,65,101,85,66,37,15,2,1,372
60700101,35,57,35,22,11,6,0,0,166
60700102,73,43,22,14,12,4,0,0,168
60700103,48,67,60,34,14,4,1,1,229
60700104,38,43,27,17,14,5,0,1,145
60700105,56,62,45,33,16,4,0,1,217
60700106,66,85,53,47,27,11,2,0,291
60700107,68,85,50,47,30,9,3,0,292
60700108,63,86,55,47,14,6,3,1,275
60700109,68,101,52,57,19,4,0,0,301
60700110,58,84,65,51,15,9,1,1,284
60700111,31,43,33,29,12,2,1,0,151
60700112,31,35,25,18,12,2,2,0,125
60700113,41,44,32,22,11,7,2,2,161
60700201,49,113,118,98,48,24,5,4,459
60700202,62,66,58,59,38,20,8,3,314
60700203,60,42,43,34,17,5,0,1,202
60700204,78,101,55,70,31,17,3,0,355
60700205,49,84,69,79,43,21,6,6,357
60700206,50,71,84,89,51,27,8,7,387
60700207,37,59,39,35,10,4,1,0,185
60700208,35,50,60,63,33,23,10,12,286
60700209,57,67,53,61,32,14,8,4,296
60700210,67,81,92,83,62,44,18,20,467
60700211,38,50,49,49,28,21,3,8,246
60700212,51,82,65,74,57,27,10,7,373
60700213,42,72,53,55,37,20,7,0,286
60700214,65,76,71,86,36,8,6,6,354
60700215,51,58,57,66,45,17,1,1,296
60700216,26,47,28,48,24,17,8,3,201
60700217,29,41,21,26,11,4,1,1,134
60700218,12,31,27,45,22,3,3,0,143
60700301,6,15,10,8,7,5,1,1,53
60700302,20,16,17,13,6,5,3,1,81
60700303,4,19,21,16,11,3,0,1,75
60700304,17,22,12,15,7,2,0,3,78
60700305,51,108,103,88,45,42,13,6,456
60700306,38,58,95,114,80,44,16,9,454
60700401,79,93,71,60,45,16,11,10,385
60700402,5,8,4,0,0,1,0,1,19
60700403,4,3,4,4,4,0,0,0,19
60700404,20,23,19,22,9,8,8,2,111
60700501,13,12,7,5,2,2,1,0,42
60700502,6,9,2,5,2,2,0,0,26
60700601,3,5,3,3,1,0,0,1,16
60700602,13,11,4,8,5,1,0,1,43
60700701,6,7,3,3,2,1,0,0,22
60700702,4,5,3,2,3,1,1,0,19
60700801,30,39,24,22,12,6,1,1,135
60700802,1,4,1,2,0,0,0,0,8
60700803,1,4,1,2,1,0,0,0,9
60700804,3,4,3,2,2,0,1,0,15
60700805,1,4,4,3,1,0,0,0,13
60700806,1,0,1,1,0,0,0,1,4
60700901,4,1,2,0,0,0,0,0,7
60700902,2,2,0,1,0,0,0,0,5
60700903,4,3,2,3,0,1,0,0,13
60700904,1,1,1,2,0,0,0,0,5
60701001,8,13,4,17,8,7,1,0,58
60701002,4,2,0,3,8,1,1,0,19
60701003,9,2,2,3,2,1,0,0,19
60701004,2,3,2,2,0,0,0,0,9
60701101,1,0,1,2,0,1,0,0,5
60701102,2,0,3,0,0,0,0,0,5
60701201,7,5,2,2,2,0,3,0,21
60701202,8,4,1,3,4,0,0,1,21
60770101,47,59,61,64,44,27,5,17,324
60770102,37,49,65,48,35,20,8,10,272
60770103,60,72,38,36,13,7,3,0,229
60770104,89,74,40,30,15,6,1,2,257
60770105,71,115,41,53,20,2,1,1,304
60770106,103,112,78,59,33,7,4,4,400
60770107,17,23,24,16,9,10,4,4,107
60770108,50,70,39,23,16,8,3,1,210
60770109,83,82,45,50,22,6,3,2,293
60770201,3,6,6,5,1,1,0,0,22
60770202,5,3,3,1,3,0,1,1,17
60770301,3,3,1,1,3,2,0,0,13
60770302,4,1,1,1,1,0,0,0,8
60770401,53,75,42,45,23,14,2,1,255
60770402,42,51,25,25,13,8,2,2,168
60770403,5,3,4,3,1,0,0,0,16
60770404,6,2,1,1,1,0,0,0,11
60770405,3,6,4,2,1,0,0,1,17
60770501,87,114,74,68,38,12,0,5,398
60770502,40,60,44,33,18,12,4,4,215
60770503,45,71,60,55,39,24,6,8,308
60770504,35,48,38,30,19,3,2,1,176
60770505,30,53,43,57,42,15,7,10,257
60770506,7,8,6,4,5,0,0,0,30
60770507,4,2,1,1,2,1,0,1,12
60770508,4,9,6,0,1,0,2,0,22
60770509,69,101,108,110,50,22,3,4,467
60770510,41,83,135,165,89,48,12,14,587
60770511,72,90,64,58,25,15,4,1,329
60770512,35,46,46,32,21,6,3,2,191
60770513,28,58,43,35,21,10,3,2,200
60770514,10,22,22,26,11,4,1,1,97
60770601,3,5,2,9,1,0,1,0,21
60770602,7,7,8,6,3,0,0,0,31
60770603,4,4,3,3,3,1,0,0,18
60770701,4,3,4,2,1,0,0,0,14
60770801,6,4,1,2,1,0,0,0,14
60770901,4,3,3,0,1,0,1,0,12
60770902,1,2,1,2,1,1,0,0,8
60770903,2,2,5,1,2,0,0,1,13
60770904,7,8,2,5,1,1,0,0,24
60770905,5,2,0,3,1,0,0,0,11
60771001,3,1,0,0,0,0,0,0,4
60771002,2,4,2,1,1,0,0,0,10
60771003,2,4,1,0,0,1,0,0,8
60771101,1,2,1,0,1,0,0,0,5
60771102,1,2,1,2,2,0,0,0,8
60771103,1,4,1,5,0,0,0,0,11
60771201,3,6,6,4,1,1,0,0,21
60771202,0,6,4,2,0,0,0,1,13
60771302,8,5,2,3,0,0,1,0,19
60771303,2,4,4,1,1,0,0,1,13
60771401,50,53,75,60,54,30,13,19,354
60771402,91,120,77,45,28,15,2,2,380
60771403,79,82,78,43,20,14,3,1,320
60771404,77,110,84,52,25,8,0,2,358
60771405,63,73,57,36,11,7,2,0,249
60771406,94,96,69,40,18,10,8,0,335
60771407,77,84,48,45,23,4,4,0,285
60771408,59,83,78,86,63,41,11,11,432
60771409,45,74,72,65,43,21,14,9,343
60840101,2,5,6,4,1,1,0,0,19
60840102,5,2,2,5,1,1,0,0,16
60840103,9,11,5,5,0,0,2,0,32
60840201,6,4,3,3,1,0,1,0,18
60840202,3,2,2,4,0,2,0,0,13
60840301,16,17,11,6,2,3,1,1,57
60840302,1,4,2,6,3,2,0,0,18
60840303,4,1,5,1,2,0,0,0,13
60840304,4,3,4,4,2,0,0,0,17
60840305,1,7,1,3,1,0,0,0,13
60840401,0,3,0,1,0,0,0,0,4
60840402,8,8,2,9,2,1,0,0,30
60840403,4,1,1,5,3,1,1,0,16
60840501,10,8,6,6,4,0,0,0,34
60840502,2,4,4,2,4,1,0,0,17
60840602,1,1,0,1,2,0,0,0,5
60840603,1,2,2,0,1,0,0,0,6
60840604,3,1,3,2,0,1,0,0,10
60840605,2,3,2,2,0,0,0,0,9
60840701,18,22,8,9,5,2,1,2,67
60840702,30,47,34,37,16,16,2,9,191
60840703,41,41,46,32,23,14,3,7,207
60840704,88,103,50,48,21,7,3,0,320
60840705,41,47,29,29,11,9,2,2,170
60840706,86,76,61,37,20,2,2,1,285
60840707,77,90,49,37,12,3,5,0,273
60840708,89,98,46,37,9,9,2,2,292
60840709,81,72,52,25,12,2,1,0,245
60840710,79,92,66,30,13,4,1,0,285
60840711,47,79,82,71,31,16,11,5,342
60840801,12,7,6,11,2,2,1,2,43
60840802,2,3,3,1,1,2,0,0,12
60840803,5,14,6,2,0,3,0,0,30
60840804,1,2,1,2,0,0,0,0,6
60840901,35,55,34,34,13,4,2,2,179
60840902,38,77,52,39,16,9,2,5,238
60840903,17,33,33,27,11,8,0,0,129
60840904,34,33,27,21,13,8,2,0,138
60840905,37,64,39,35,21,5,2,2,205
60840906,45,67,51,31,15,9,3,4,225
60840907,5,7,6,7,5,0,0,0,30
60840908,0,3,0,2,1,0,0,0,6
60840909,2,0,6,3,1,1,0,0,13
60841001,1,3,2,2,3,0,0,1,12
60841002,4,2,1,0,0,0,0,0,7
60841003,2,3,3,0,1,1,0,0,10
60841101,3,2,1,1,0,1,0,0,8
60841102,8,10,5,5,0,5,0,0,33
60841201,16,21,9,20,6,3,0,0,75
60841202,24,24,32,23,27,8,0,2,140
60841203,38,53,41,43,17,11,1,2,206
60841204,77,105,66,49,21,9,0,4,331
60841205,37,48,50,58,19,10,3,8,233
60841206,71,94,74,88,54,20,10,2,413
60841207,54,69,40,21,12,4,0,0,200
60841208,79,97,72,51,19,10,3,4,335
60841209,39,49,42,33,15,11,4,6,199
60841210,50,55,69,64,37,16,10,5,306
60980101,77,63,62,55,22,9,5,3,296
60980102,36,79,62,55,36,15,5,5,293
60980103,61,92,66,55,24,10,3,5,316
60980104,69,73,73,55,17,4,3,1,295
60980105,46,77,58,63,13,7,2,1,267
60980106,69,73,60,56,29,6,2,4,299
60980107,58,69,39,43,19,5,2,0,235
60980108,61,78,52,44,16,5,1,1,258
60980109,46,79,53,45,24,6,1,0,254
60980110,55,70,70,64,34,13,4,2,312
60980111,50,102,76,78,40,12,5,4,367
60980112,51,66,64,52,14,7,0,0,254
60980201,56,74,61,59,17,12,1,3,283
60980202,57,101,75,57,32,21,4,0,347
60980203,54,66,62,48,21,8,5,4,268
60980204,64,90,86,85,53,20,5,3,406
60980205,59,85,75,61,23,10,3,5,321
60980206,69,76,60,60,28,6,3,2,304
60980207,58,90,86,75,38,19,9,2,377
60980208,54,74,64,86,42,22,10,8,360
60980209,34,52,44,43,29,9,3,6,220
60980210,41,61,75,58,30,30,8,7,310
60980211,26,24,54,53,41,12,5,11,226
60980212,41,61,90,107,66,42,19,23,449
60980213,45,62,33,44,24,5,1,0,214
60980214,31,39,53,58,31,13,4,7,236
60980215,36,41,70,42,28,14,9,6,246
60980301,26,47,28,18,11,5,1,1,137
60980302,38,24,29,22,8,5,1,1,128
60980303,90,69,66,66,49,17,4,2,363
60980304,44,47,64,68,37,20,2,3,285
60980305,42,69,54,48,31,10,2,4,260
60980306,53,67,79,81,52,24,5,3,364
60980307,43,63,50,44,33,17,2,6,258
60980308,75,84,102,80,40,26,10,7,424
60980309,38,78,89,112,74,46,15,25,477
60980310,64,96,95,97,62,49,7,22,492
60980311,56,56,36,43,27,11,3,2,234
60980312,29,60,33,25,12,8,1,0,168
60980313,25,37,29,22,17,8,0,2,140
60980401,6,14,7,13,8,6,1,0,55
60980402,18,14,28,28,21,18,8,9,144
60980403,23,42,41,38,20,13,2,0,179
60980404,18,24,22,21,10,4,1,1,101
60980405,4,2,0,3,1,0,0,0,10
60980406,35,39,44,25,14,4,5,3,169
60980407,12,23,17,13,6,2,2,1,76
60980408,11,13,7,5,5,3,1,0,45
60980501,32,45,53,65,48,25,12,10,290
60980502,59,75,77,80,45,21,2,11,370
60980503,41,62,73,70,27,24,8,6,311
60980504,41,76,56,51,37,18,8,3,290
60980505,35,52,64,75,52,20,14,16,328
60980506,55,33,49,46,39,17,12,12,263
60980507,36,55,51,47,26,16,4,5,240
60980508,39,58,49,56,36,18,5,3,264
60980509,29,52,61,64,40,21,3,9,279
60980510,40,56,52,73,48,23,16,11,319
60980601,59,67,55,53,19,7,1,3,264
60980602,70,111,85,69,36,11,5,0,387
60980603,81,105,105,110,53,25,9,3,491
60980604,30,49,55,44,29,14,3,7,231
60980605,68,81,89,82,44,14,6,3,387
60980606,60,89,60,53,26,9,1,0,298
60980607,62,81,83,41,24,7,0,2,300
60980608,64,86,77,73,30,11,3,1,345
60980609,62,96,93,80,42,24,11,12,420
60980610,33,34,49,48,35,15,7,5,226
60980611,44,62,61,74,45,16,7,7,316
60980612,25,32,37,44,26,18,3,7,192
60980613,23,41,57,46,31,25,6,11,240
60980614,44,42,64,53,27,24,3,4,261
60980615,48,52,47,46,32,16,8,5,254
60980616,29,60,73,70,39,19,8,11,309
60980617,29,41,55,60,27,12,6,2,232
60980701,58,55,35,39,29,15,10,10,251
60980702,64,94,131,154,90,39,14,10,596
60980703,44,35,39,31,14,2,0,0,165
60980704,58,74,66,51,30,8,3,3,293
60980705,54,78,70,61,25,13,5,3,309
60980706,76,89,80,70,34,12,4,3,368
60980707,5,6,1,1,0,0,0,0,13
60980801,51,55,76,73,43,30,3,5,336
60980802,28,56,82,73,52,45,18,13,367
60980803,40,49,54,40,25,24,3,5,240
60980804,35,59,51,51,29,26,12,10,273
60980805,51,35,32,25,13,5,2,1,164
60980806,89,68,51,27,19,8,1,1,264
60980807,54,66,32,21,8,3,1,2,187
60980808,75,74,45,26,17,5,1,0,243
60980809,73,80,37,35,12,2,3,0,242
60980810,57,64,97,107,73,37,7,16,458
60980811,71,67,45,39,21,8,4,5,260
60980812,47,69,37,44,18,10,5,1,231
60980813,33,55,54,37,33,19,2,6,239
60980814,58,62,69,62,28,22,3,2,306
60980815,59,70,58,57,50,24,6,2,326
60980816,54,74,67,57,25,16,14,4,311
60980817,57,68,68,71,52,29,19,14,378
61050101,86,127,90,59,14,5,5,4,390
61050102,78,89,70,58,23,6,3,5,332
61050103,84,107,38,36,17,4,2,1,289
61050104,110,127,69,47,13,8,3,1,378
61050105,73,84,43,28,10,1,0,2,241
61050106,80,88,37,30,8,6,3,1,253
61050107,83,97,51,46,19,5,0,1,302
61050108,76,104,69,52,15,9,4,2,331
61050109,68,85,43,36,13,4,0,1,250
61050201,75,101,75,53,24,14,2,4,348
61050202,88,110,64,44,20,11,1,2,340
61050203,66,110,69,47,23,5,3,2,325
61050204,54,56,31,15,6,1,0,2,165
61050205,91,106,60,30,14,2,1,0,304
61050206,70,90,48,38,20,9,1,1,277
61050207,91,132,61,42,30,4,4,1,365
61050208,41,49,29,24,7,1,0,0,151
61050209,59,66,32,31,13,3,1,2,207
61050210,82,89,49,44,16,7,0,0,287
61050211,91,104,74,53,17,4,3,0,346
61050301,20,28,21,17,12,1,0,2,101
61050401,6,15,10,9,3,2,1,0,46
61050402,5,9,2,5,0,1,0,0,22
61050403,25,20,12,14,3,2,1,2,79
61050501,14,9,7,7,1,1,1,0,40
61050601,23,14,7,11,7,1,1,1,65
61050602,8,12,9,6,2,0,0,0,37
61050701,11,11,6,12,4,0,0,0,44
61050801,24,40,27,23,9,6,3,6,138
61050802,25,50,29,27,22,13,8,5,179
61050803,44,61,50,47,30,26,8,7,273
61050804,1,0,1,0,1,0,1,0,4
61050805,12,20,15,12,5,4,1,1,70
61050806,5,4,6,5,3,5,0,3,31
61050807,9,10,8,8,0,2,0,1,38
61050808,19,16,10,6,3,2,0,1,57
61050809,6,11,7,8,3,0,0,0,35
61050901,9,14,10,7,2,0,0,0,42
61051001,16,16,14,6,1,0,0,1,54
61051002,8,20,10,8,4,2,0,0,52
61051101,16,17,14,6,3,3,0,0,59
61051102,42,51,29,31,5,4,1,0,163
61051103,41,56,27,21,6,5,0,0,156
61051104,41,62,38,27,5,4,0,1,178
61051105,99,82,73,43,16,5,2,2,322
61051106,25,30,18,16,7,2,1,1,100
61051107,25,34,22,16,13,2,0,1,113
61051201,9,18,4,5,3,0,1,0,40
61051301,45,56,41,16,10,6,1,1,176
61051302,27,48,17,19,12,2,2,1,128
61051303,44,55,42,46,19,16,5,6,233
61051304,18,21,16,12,6,3,2,1,79
61051401,56,93,79,93,50,28,10,15,424
61051402,34,52,58,57,29,15,9,8,262
61051403,25,41,40,47,18,7,1,3,182
61051404,34,50,37,38,26,10,0,0,195
61051405,39,64,49,44,20,6,2,1,225
61051406,32,59,58,53,44,6,9,10,271
61051407,47,61,61,60,26,16,6,6,283
61051408,18,18,16,9,9,5,1,3,79
61051409,3,11,4,5,6,0,0,1,30
61051410,60,78,84,46,23,7,8,8,314
61051411,34,41,46,29,9,4,2,0,165
61051412,48,56,36,32,16,5,5,0,198
61051413,39,67,70,68,43,22,11,19,339
61120101,52,56,58,36,21,4,3,1,231
61120102,85,100,64,53,34,19,5,5,365
61120103,78,118,95,60,26,23,2,6,408
61120104,76,51,26,11,6,1,0,1,172
61120105,82,68,36,25,8,5,2,3,229
61120106,78,101,44,27,21,10,2,1,284
61120107,62,108,45,34,14,4,3,1,271
61120108,65,99,50,25,14,7,3,0,263
61120109,89,109,76,68,34,13,11,9,409
61120110,76,121,112,96,49,25,9,4,492
61120111,70,96,64,58,27,10,3,2,330
61120112,61,118,81,101,51,19,7,2,440
61120113,36,49,52,55,29,27,12,11,271
61120201,54,68,61,61,24,23,11,16,318
61120202,65,57,61,67,47,23,13,8,341
61120203,80,89,86,62,45,19,8,6,395
61120204,27,47,43,35,21,5,0,0,178
61120205,71,124,67,46,19,12,1,2,342
61120206,65,94,58,55,22,9,1,3,307
61120207,65,90,57,45,9,7,1,0,274
61120208,17,30,19,21,16,6,1,3,113
61120209,39,65,42,26,8,11,2,4,197
61120210,74,95,50,44,21,5,5,3,297
61120211,77,149,93,85,38,20,4,4,470
61120301,15,20,6,14,12,3,1,1,72
61120302,2,1,2,3,1,0,0,0,9
61120303,0,1,0,1,2,3,0,0,7
61120304,3,1,3,1,0,0,0,0,8
61120305,1,3,2,4,2,0,0,0,12
61120306,0,1,4,2,0,0,1,0,8
61120307,0,8,1,1,0,0,0,0,10
61120308,2,2,1,2,0,1,0,1,9
61120309,3,3,0,2,1,0,1,0,10
61120310,17,16,14,6,7,2,0,2,64
61120401,0,2,0,3,0,0,0,1,6
61120402,4,0,0,2,0,0,0,0,6
61120403,0,4,0,0,1,0,0,0,5
61120501,37,38,34,28,9,6,3,1,156
61120502,2,2,2,2,2,0,0,0,10
61120503,2,1,0,1,0,0,0,0,4
61120504,0,2,1,1,0,0,0,0,4
61120505,3,1,0,3,2,0,0,0,9
61120506,3,0,3,1,0,0,0,0,7
61120601,5,5,1,1,2,1,0,0,15
61120602,1,6,0,2,0,0,0,0,9
61120603,2,4,4,2,1,0,0,1,14
61120604,3,3,3,2,1,3,0,0,15
61120605,2,3,2,1,0,2,0,0,10
61120606,2,3,0,1,1,1,0,0,8
61120701,31,42,32,23,10,8,5,6,157
61120702,69,96,70,63,25,15,6,6,350
61120703,13,16,19,13,10,2,1,4,78
61120704,4,3,0,3,0,0,0,0,10
61120705,2,0,2,3,1,0,0,0,8
61120706,2,1,0,2,1,0,0,1,7
61120707,0,2,2,1,0,0,1,0,6
61120708,0,2,1,0,1,2,0,0,6
61120709,34,56,26,29,9,5,2,3,164
61120710,12,23,19,12,6,6,0,1,79
61120801,3,1,2,0,0,1,0,0,7
61120802,9,7,2,5,1,1,0,0,25
61120803,1,4,5,1,1,1,0,0,13
61120804,2,1,1,1,0,0,1,0,6
61120805,2,4,3,0,2,1,1,0,13
61120901,12,7,8,8,2,0,1,2,40
61120902,0,0,0,2,0,0,0,0,2
61120903,3,5,1,0,1,1,0,0,11
61120904,6,4,1,2,0,1,0,0,14
61120905,1,3,0,1,1,0,0,0,6
61120906,6,6,5,4,3,3,0,0,27
61120907,2,2,4,1,0,1,0,0,10
61120908,0,0,2,1,0,0,0,0,3
61121001,15,9,8,8,3,2,0,1,46
61121002,28,42,42,28,16,6,0,0,162
61121003,60,99,79,72,27,25,8,6,376
61121004,14,22,8,5,3,3,0,0,55
61121005,28,47,43,46,18,10,1,1,194
61121101,56,47,37,31,14,5,5,0,195
61121102,16,23,9,12,11,3,0,0,74
61121103,40,50,34,28,17,6,4,2,181
61121104,11,9,12,12,3,5,1,0,53
61121105,0,0,0,0,0,0,0,0,0
61121106,6,13,8,4,2,2,1,0,36
61121107,2,2,2,0,1,0,0,0,7
61121108,49,63,68,74,51,21,4,6,336
61121109,62,87,98,87,53,24,15,9,435
61121201,3,4,2,1,0,0,0,0,10
61121202,2,2,0,1,0,0,0,0,5
61121203,1,3,0,2,0,0,0,0,6
61121204,1,2,1,0,0,0,0,0,4
61121205,2,0,1,2,0,0,0,0,5
61121301,26,36,19,22,14,8,1,2,128
61121302,3,6,1,1,0,0,0,0,11
61121303,9,7,2,4,0,1,1,0,24
61121304,6,2,1,3,0,0,1,0,13
61121305,21,24,9,15,12,4,0,1,86
61121401,43,74,57,43,38,27,5,4,291
61121402,70,71,76,59,31,12,7,8,334
61121403,71,88,58,40,14,7,4,0,282
61121404,78,113,58,39,16,8,3,2,317
61121405,92,103,52,40,5,6,0,1,299
61121406,89,80,50,38,14,5,0,0,276
61121407,83,95,55,29,3,6,2,1,274
61121408,80,111,50,40,14,3,0,1,299
61121409,71,95,48,31,15,9,1,2,272
61121410,99,80,56,28,11,4,1,0,279
61190101,5,6,5,5,4,2,0,0,27
61190102,4,0,4,3,2,0,0,0,13
61190103,3,3,1,3,1,1,0,0,12
61190104,2,5,4,2,1,1,0,0,15
61190201,2,2,1,4,1,0,0,0,10
61190202,7,3,2,2,2,1,1,0,18
61190203,23,27,18,19,14,5,3,3,112
61190204,5,7,6,4,3,2,0,1,28
61190205,10,7,8,5,3,2,2,1,38
61190206,4,7,2,3,1,0,0,0,17
61190301,86,85,44,56,19,4,1,1,296
61190302,78,85,59,36,30,12,4,4,308
61190303,83,98,67,66,38,11,5,0,368
61190304,72,92,94,86,61,27,8,7,447
61190305,63,98,75,69,29,27,13,10,384
61190306,28,29,44,38,28,9,3,2,181
61190307,49,55,67,61,32,14,4,2,284
61190308,50,57,52,81,37,23,17,4,321
61190309,36,39,62,50,50,18,7,16,278
61190310,18,16,8,10,8,3,1,0,64
61190401,30,39,34,20,13,9,3,5,153
61190402,4,2,1,2,2,1,0,0,12
61190403,25,30,28,19,12,8,0,1,123
61190404,8,18,15,5,7,1,0,1,55
61190405,8,7,3,4,3,1,0,0,26
61190406,8,11,9,5,4,1,1,0,39
61190407,59,84,68,68,19,15,5,3,321
61190408,15,22,20,23,15,9,6,1,111
61190409,39,55,42,60,35,7,5,3,246
61190501,7,19,18,18,8,1,1,1,73
61190502,3,7,6,7,4,0,2,1,30
61190601,7,6,2,3,1,0,0,0,19
61190602,4,7,2,3,0,2,1,0,19
61190603,5,5,6,3,4,1,2,0,26
61190701,34,45,41,41,26,7,6,1,201
61190702,75,65,70,57,53,29,7,8,364
61190703,7,6,4,3,2,1,0,0,23
61190704,1,4,5,2,0,0,0,0,12
61190705,1,4,4,4,2,1,1,0,17
61190706,1,1,0,4,1,0,0,0,7
61190707,55,70,40,43,20,7,2,1,238
61190801,25,20,15,11,8,2,0,1,82
61190802,1,3,3,2,1,1,1,0,12
61190804,0,2,3,2,0,0,0,0,7
61190805,6,4,1,2,1,0,1,0,15
61190806,4,4,5,1,2,2,1,1,20
61190901,16,17,17,9,4,2,2,0,67
61190902,4,4,5,1,6,0,0,1,21
61190903,5,3,4,0,3,1,0,1,17
61190904,22,28,18,18,6,4,2,0,98
61191001,20,19,11,7,16,3,2,2,80
61191002,61,76,67,57,49,26,12,9,357
61191003,47,76,56,68,47,23,16,7,340
61191004,32,43,43,40,24,23,6,13,224
61191005,54,48,57,58,38,24,10,5,294
61191006,68,73,99,94,57,21,9,5,426
61191007,51,90,57,50,12,8,6,1,275
61191008,80,91,68,67,27,10,7,2,352
61191009,43,51,66,50,26,18,7,6,267
61191010,7,10,5,5,5,1,0,1,34
61260101,55,87,69,46,17,7,1,0,282
61260102,99,147,99,69,41,3,4,3,465
61260103,44,88,61,51,31,19,2,3,299
61260104,47,58,44,41,23,13,3,2,231
61260105,37,60,69,54,23,9,1,2,255
61260106,46,58,67,58,19,9,1,3,261
61260107,48,66,51,52,20,7,3,3,250
61260108,48,62,60,62,22,8,0,3,265
61260109,54,94,74,58,28,9,7,4,328
61260110,63,72,53,55,24,13,4,2,286
61260111,44,73,59,55,16,5,0,1,253
61260112,52,112,70,79,33,9,3,4,362
61260113,45,76,51,34,18,6,8,4,242
61260114,51,57,48,40,19,9,1,2,227
61260201,39,52,64,72,72,56,19,19,393
61260202,65,87,104,83,52,37,10,4,442
61260203,52,81,81,85,29,11,5,3,347
61260204,39,75,70,66,39,17,10,8,324
61260205,65,97,86,82,30,8,3,3,374
61260206,31,63,45,49,24,14,6,6,238
61260207,35,50,65,54,24,8,5,6,247
61260208,30,71,68,61,30,12,11,3,286
61260209,57,89,99,65,38,19,10,5,382
61260210,46,76,65,71,40,15,11,11,335
61260211,34,58,54,37,15,8,0,1,207
61260301,57,108,48,19,15,6,1,2,256
61260302,99,80,42,33,14,3,0,2,273
61260303,98,106,78,54,14,6,1,0,357
61260304,54,50,29,24,4,4,2,0,167
61260305,52,53,37,30,11,6,2,0,191
61260306,56,77,43,39,18,10,1,1,245
61260307,58,102,62,66,22,8,1,0,319
61260308,51,76,36,36,14,4,2,4,223
61260309,55,87,69,57,24,5,3,1,301
61260310,69,101,83,71,28,10,3,3,368
61260311,53,103,62,65,13,6,1,5,308
61260401,37,88,59,40,18,7,0,0,249
61260402,58,75,42,43,23,6,1,0,248
61260403,3,2,6,3,1,1,0,1,17
61260404,47,58,78,97,61,40,19,32,432
61260405,7,6,6,2,5,2,0,0,28
61260406,3,4,5,1,1,1,0,0,15
61260407,65,77,87,103,71,40,21,28,492
61260501,31,55,85,74,40,24,7,5,321
61260502,54,87,89,70,33,33,5,4,375
61260503,52,79,71,51,30,23,6,5,317
61260504,49,39,58,69,49,28,12,16,320
61260505,55,85,65,71,42,28,17,14,377
61260506,47,58,63,42,34,13,10,10,277
61260507,30,49,51,47,31,35,10,10,263
61260508,9,43,80,135,61,22,4,5,359
61260509,47,65,95,99,70,69,22,35,502
61260510,30,36,47,52,31,24,10,7,237
61260511,23,38,39,72,35,25,6,5,243
61260512,42,56,74,75,65,55,9,18,394
61260513,36,56,40,62,30,19,1,13,257
61260514,26,43,48,52,33,26,5,13,246
61260515,41,52,59,67,37,33,17,15,321
61260516,50,66,67,62,37,37,10,20,349
61260517,5,3,1,1,4,2,0,1,17
61260601,29,22,24,26,7,3,5,1,117
61260602,9,2,2,3,0,1,0,0,17
61260603,7,5,5,8,4,2,1,0,32
61260604,13,19,24,33,15,0,3,1,108
61260605,14,21,24,21,17,3,2,0,102
61260606,12,28,21,39,9,3,2,2,116
61260607,9,28,22,31,10,8,0,0,108
61260608,15,23,23,20,12,4,1,1,99
61260609,12,33,20,22,11,9,0,1,108
61260701,35,62,75,69,53,36,12,15,357
61260702,35,64,65,55,38,24,5,10,296
61260703,66,107,88,64,60,35,17,17,454
61260704,33,44,54,54,47,37,10,19,298
61260705,39,53,65,63,57,29,14,20,340
61260706,18,53,60,46,33,15,2,6,233
61260707,33,76,66,75,42,25,6,8,331
61260708,30,70,68,65,46,30,10,9,328
61260709,61,80,117,122,49,25,7,7,468
61260710,16,57,81,74,43,15,5,4,295
61260801,6,11,4,5,2,2,0,2,32
61260802,47,47,38,34,9,3,2,2,182
61260803,57,58,47,29,17,7,4,0,219
61260804,65,92,62,32,5,10,4,3,273
61260805,78,93,54,50,27,11,3,3,319
61260806,48,81,70,34,15,8,1,3,260
61260807,52,69,55,53,28,8,4,0,269
61260808,63,81,59,63,17,12,4,2,301
61260809,67,60,61,33,13,10,2,0,246
61260901,70,88,101,103,56,42,15,20,495
61260902,30,60,64,56,35,18,6,8,277
61260903,34,54,68,54,28,17,9,14,278
61260905,11,17,21,20,12,6,0,2,89
61260906,13,17,12,17,14,8,1,4,86
61260907,42,73,124,128,77,29,9,10,492
61260908,40,86,77,63,28,9,3,2,308
61260909,44,71,82,85,72,40,12,14,420
61260910,49,67,75,103,58,36,18,14,420
61260911,24,50,67,101,49,29,12,11,343
61260912,0,1,0,0,0,0,0,0,1
61260913,8,25,22,36,16,5,1,1,114
61260914,25,34,51,44,31,33,11,16,245
61260915,15,29,21,34,27,21,9,9,165
61260916,12,19,8,8,8,2,2,1,60
61260917,12,16,13,18,8,4,2,1,74
61260918,17,29,29,37,28,18,15,16,189
61260919,12,18,22,12,10,2,3,2,81
61261001,26,15,13,15,9,8,2,5,93
61261002,15,10,6,5,3,2,2,3,46
61261003,42,61,33,33,13,8,7,6,203
61261004,10,7,6,8,1,1,2,2,37
61261005,14,15,8,0,2,2,0,1,42
61340101,33,65,62,49,42,14,13,10,288
61340102,22,26,37,28,16,15,1,7,152
61340103,35,42,33,38,28,16,17,15,224
61340104,11,19,19,22,11,7,2,3,94
61340105,59,81,68,74,69,35,22,19,427
61340106,32,43,47,51,32,21,9,13,248
61340107,34,46,38,30,19,5,7,4,183
61340108,13,11,6,12,8,9,2,2,63
61340109,32,21,27,32,16,16,11,8,163
61340110,31,25,22,25,19,15,3,5,145
61340111,19,26,25,24,14,10,1,5,124
61340112,33,62,37,57,25,8,2,1,225
61340113,6,5,6,5,3,5,2,1,33
61340114,9,8,6,6,7,5,1,0,42
61340201,45,82,79,77,37,27,7,0,354
61340202,29,61,46,63,25,17,12,2,255
61340203,43,50,57,51,40,32,9,19,301
61340204,81,104,97,83,40,26,4,3,438
61340205,13,7,10,9,6,1,0,2,48
61340206,29,36,43,47,19,14,4,6,198
61340207,59,71,78,76,43,27,10,22,386
61340208,36,52,84,61,47,25,10,6,321
61340209,42,32,64,76,37,27,9,19,306
61340301,77,114,114,116,61,34,18,16,550
61340302,45,63,59,55,41,12,11,6,292
61340303,40,67,56,45,35,9,3,2,257
61340304,73,112,76,69,37,11,5,2,385
61340305,64,85,63,53,17,11,0,3,296
61340306,76,85,63,45,24,12,1,2,308
61340307,81,110,112,92,46,20,4,9,474
61340308,76,110,99,86,46,26,8,12,463
61340309,127,149,83,57,26,11,1,0,454
61340401,7,7,9,9,2,6,1,2,43
61340402,26,44,32,41,25,10,3,4,185
61340403,9,16,10,10,6,4,0,0,55
61340404,16,13,9,16,3,5,1,4,67
61340405,4,1,3,2,1,0,0,1,12
61340406,32,29,28,31,23,6,3,6,158
61340501,22,29,28,32,17,8,1,4,141
61340502,5,9,5,4,2,5,1,1,32
61340601,9,14,10,5,3,1,3,0,45
61340602,13,8,9,8,2,3,0,2,45
61340701,5,9,3,4,1,1,0,1,24
61340702,3,4,3,6,2,0,0,0,18
61340801,28,17,18,16,15,7,2,2,105
61340802,4,4,1,3,1,1,0,0,14
61340803,8,7,6,5,3,2,0,0,31
61340804,3,2,5,2,0,1,0,0,13
61340901,8,3,4,5,7,3,5,3,38
61340902,46,38,20,30,11,10,2,5,162
61340903,32,31,22,18,14,7,3,6,133
61340904,29,14,33,34,9,11,1,10,141
61340905,19,20,28,18,15,13,8,9,130
61340906,18,32,34,38,30,7,3,7,169
61340907,15,42,34,53,25,19,8,13,209
61340908,34,50,64,61,41,41,13,19,323
61340909,59,78,90,83,45,32,8,14,409
61340910,35,53,59,60,39,20,10,4,280
61340911,34,43,53,59,39,26,7,11,272
61340912,9,9,6,13,3,2,2,0,44
61340913,57,67,55,52,24,8,4,3,270
61340914,29,48,21,35,13,6,3,4,159
61341001,1,11,13,6,4,2,1,0,38
61341002,37,66,88,75,55,40,8,12,381
61341003,43,50,56,60,45,44,9,12,319
61341004,40,36,54,70,41,26,9,15,291
61341005,42,60,55,64,28,26,10,14,299
61341006,69,78,51,49,32,16,2,0,297
61341007,29,42,39,42,25,13,1,2,193
61341008,45,67,64,49,27,18,10,10,290
61341009,73,91,106,117,49,40,9,17,502
61341010,58,91,97,79,47,22,7,4,405
61341011,15,20,19,8,5,4,0,2,73
61400101,7,7,8,5,4,2,2,1,36
61400102,4,5,2,5,0,0,1,0,17
61400103,3,8,6,7,3,0,2,0,29
61400201,3,2,0,3,1,0,0,0,9
61400202,3,8,3,1,0,0,0,0,15
61400203,5,4,3,4,2,0,0,2,20
61400204,5,4,5,4,1,0,0,0,19
61400301,38,48,46,42,19,19,2,3,217
61400302,83,103,71,70,36,26,7,5,401
61400303,50,74,62,45,27,17,3,6,284
61400304,60,68,60,49,24,9,3,2,275
61400305,81,87,66,52,19,13,5,3,326
61400306,22,49,56,46,30,21,5,7,236
61400307,78,66,54,57,30,7,2,5,299
61400308,79,84,53,51,22,15,3,1,308
61400309,47,56,44,49,33,16,4,2,251
61400310,23,31,44,44,27,15,5,3,192
61400311,4,2,4,3,3,1,0,0,17
61400312,3,4,4,4,2,1,0,0,18
61400313,5,5,1,0,1,1,0,0,13
61400314,3,1,2,1,3,0,1,0,11
61400315,47,77,85,86,39,14,1,1,350
61400316,52,68,68,56,42,28,10,14,338
61400317,58,81,46,54,19,11,1,3,273
61400318,45,49,53,46,28,17,8,5,251
61400319,53,64,64,52,29,8,4,5,279
61400401,23,23,11,9,8,6,1,1,82
61400402,6,5,2,5,3,2,0,0,23
61400403,9,13,3,2,2,1,0,0,30
61400501,4,5,2,4,1,0,1,2,19
61400502,2,5,3,3,0,0,0,1,14
61400503,4,4,2,3,1,0,0,0,14
61400601,0,2,4,0,0,0,0,0,6
61470101,64,94,68,59,26,19,3,5,338
61470102,78,105,56,43,23,12,3,1,321
61470103,65,85,49,25,12,2,2,0,240
61470104,47,67,78,52,18,8,8,2,280
61470105,92,105,46,31,14,1,2,0,291
61470106,79,89,55,42,18,4,1,1,289
61470107,68,77,71,41,22,8,1,3,291
61470108,79,84,63,36,15,3,4,1,285
61470109,39,73,77,63,52,33,5,17,359
61470201,43,43,30,31,11,4,1,4,167
61470202,1,3,2,2,1,2,1,1,13
61470203,11,8,9,6,4,3,1,1,43
61470204,1,1,1,3,2,1,0,0,9
61470205,4,1,4,0,0,0,0,0,9
61470301,26,43,20,23,13,9,4,7,145
61470302,6,9,2,7,1,1,1,0,27
61470303,2,0,0,0,0,1,0,0,3
61470304,7,5,3,1,0,0,0,0,16
61470305,4,5,3,2,1,0,0,0,15
61470306,2,2,3,0,0,0,0,0,7
61470307,6,5,2,3,0,1,0,0,17
61470401,0,5,1,2,0,0,0,0,8
61470402,4,2,5,4,0,0,0,0,15
61470403,5,6,1,1,1,1,0,0,15
61470501,70,95,104,112,54,35,11,16,497
61470502,0,7,3,3,0,1,0,0,14
61470503,7,3,3,0,1,0,0,0,14
61470601,1,0,0,2,1,0,0,0,4
61470602,19,19,35,21,17,11,1,2,125
61470603,3,8,4,1,2,1,0,1,20
61470604,0,0,4,0,0,0,0,0,4
61470701,39,58,48,45,26,8,2,2,228
61470702,2,0,0,0,2,0,0,0,4
61470703,25,9,12,13,11,3,2,1,76
61470704,5,5,2,2,0,1,0,1,16
61470705,3,0,0,0,0,1,0,0,4
61470706,1,1,0,0,0,0,0,0,2
61470707,0,0,0,1,0,0,0,0,1
61470708,7,7,4,3,2,1,1,1,26
61470709,1,3,0,3,0,0,1,0,8
61470710,3,1,2,1,0,0,0,0,7
61470711,4,1,1,2,0,0,0,0,8
61470712,1,0,0,0,1,0,0,0,2
61470801,37,48,39,37,13,5,2,4,185
61470802,4,3,3,0,2,0,0,0,12
61470803,2,3,0,1,1,0,0,0,7
61470804,3,4,2,4,1,1,0,0,15
61470805,3,7,2,5,2,0,0,1,20
61470901,17,20,11,13,6,7,0,0,74
61470902,9,13,10,4,8,3,1,0,48
61470903,4,3,0,1,0,1,0,0,9
61470904,5,2,1,0,2,0,0,0,10
61470905,1,4,3,0,0,1,0,0,9
61470906,2,4,4,1,0,1,0,0,12
61470907,4,7,3,5,0,2,0,1,22
61471001,20,18,15,8,5,1,3,3,73
61471002,3,4,4,4,3,2,2,1,23
61471003,3,6,2,1,2,1,0,0,15
61471101,17,16,4,8,3,4,1,4,57
61471102,0,3,1,2,3,0,0,0,9
61471103,4,3,0,6,0,0,0,0,13
61471201,99,96,74,50,23,5,2,0,349
61471202,65,101,51,56,20,9,2,0,304
61471203,72,95,73,47,23,12,5,3,330
61471204,53,74,45,42,21,7,2,1,245
61471205,69,72,47,31,9,1,2,2,233
61471206,83,76,43,34,12,4,0,0,252
61471207,81,93,51,41,9,8,1,1,285
61471208,89,88,87,51,30,11,3,6,365
61471209,67,85,51,50,29,17,5,1,305
61471210,42,45,60,37,20,17,7,3,231
61540101,38,29,31,19,4,6,5,1,133
61540102,15,26,24,21,12,7,3,0,108
61540103,2,2,2,4,1,3,0,0,14
61540104,4,4,2,1,1,0,0,1,13
61540105,5,1,5,8,1,1,0,0,21
61540201,72,91,69,72,20,13,2,3,342
61540202,25,41,19,29,20,6,1,0,141
61540203,7,7,5,2,0,2,0,0,23
61540204,2,6,4,6,2,1,2,0,23
61540205,14,26,29,34,12,11,5,2,133
61540206,0,4,3,0,1,1,0,0,9
61540207,4,4,2,1,1,2,1,0,15
61540208,8,8,8,2,1,1,2,0,30
61540209,91,105,61,61,21,7,4,2,352
61540210,24,43,23,24,12,10,4,0,140
61540301,3,6,2,8,3,0,1,1,24
61540302,7,8,5,7,2,2,1,0,32
61540401,16,11,9,3,4,1,0,2,46
61540402,27,45,30,19,9,8,2,1,141
61540403,1,1,4,1,3,0,0,0,10
61540404,3,2,4,0,3,0,0,0,12
61540405,5,3,4,3,1,1,0,0,17
61540501,2,7,2,1,0,1,1,0,14
61540502,3,4,1,2,1,1,0,0,12
61540601,41,32,30,25,15,9,3,10,165
61540602,29,40,24,22,19,8,3,1,146
61540603,43,58,32,26,9,6,2,1,177
61540604,42,42,32,13,5,3,0,0,137
61540605,36,47,30,16,5,4,1,1,140
61540606,18,23,12,5,2,0,0,0,60
61540607,52,71,45,33,18,10,2,4,235
61540608,49,57,43,25,18,4,1,3,200
61540609,9,2,3,3,2,1,0,0,20
61540610,7,23,25,28,25,7,3,2,120
61540611,39,49,36,41,21,4,4,1,195
61540612,48,72,55,36,19,10,6,3,249
61540701,5,6,6,3,2,0,0,0,22
61540702,6,5,7,1,0,3,0,0,22
61540703,1,4,4,4,1,1,0,0,15
61540801,25,19,17,18,5,6,1,1,92
61540802,4,6,18,12,2,1,1,2,46
61540803,3,4,3,5,3,1,0,0,19
61540804,7,2,2,1,3,1,0,0,16
61540805,5,3,7,4,2,1,0,0,22
61540806,12,7,5,4,4,1,1,1,35
61540901,7,6,4,8,1,0,1,0,27
61540902,3,2,0,0,2,3,0,1,11
61610101,33,35,38,32,21,13,7,5,184
61610102,49,36,39,40,25,12,5,2,208
61610103,49,46,35,37,21,7,6,2,203
61610104,33,21,32,25,8,7,2,1,129
61610105,32,38,29,38,19,13,1,4,174
61610106,51,55,59,59,23,12,2,5,266
61610107,32,50,31,34,12,3,0,2,164
61610108,38,57,35,20,17,3,2,1,173
61610109,57,78,61,45,21,10,2,1,275
61610110,25,47,31,37,24,10,4,4,182
61610111,19,34,50,64,35,21,3,4,230
61610112,22,28,31,34,26,9,9,5,164
61610113,64,84,53,48,28,7,11,4,299
61610114,48,44,42,36,28,15,3,1,217
61610115,14,22,31,32,26,16,3,4,148
61610116,34,44,34,40,25,11,8,4,200
61610117,60,89,73,67,40,15,2,3,349
61610118,23,20,16,26,15,7,2,0,109
61610201,1,3,2,3,1,0,0,1,11
61610202,5,1,3,1,1,0,0,0,11
61610203,3,1,0,3,0,0,0,0,7
61610204,3,1,4,5,3,1,0,0,17
61610301,5,8,8,5,1,2,0,1,30
61610302,3,1,3,1,0,0,0,0,8
61610401,7,7,6,3,0,2,1,0,26
61610402,4,7,2,5,5,1,1,0,25
61610403,24,40,37,38,19,13,0,5,176
61610404,11,16,11,25,12,9,1,0,85
61610405,9,8,14,7,6,2,1,0,47
61610406,23,29,32,22,10,10,3,2,131
61610501,2,3,3,4,2,0,0,0,14
61610502,2,2,0,0,2,1,0,0,7
61610503,1,1,0,2,3,0,0,0,7
61610504,6,7,4,6,7,2,0,1,33
61610601,20,30,20,22,10,4,4,1,111
61610602,3,3,1,1,2,0,0,0,10
61610603,3,1,2,0,0,0,0,0,6
61610604,3,1,4,3,1,0,1,0,13
61610605,4,7,3,4,3,2,0,1,24
61610606,8,5,7,3,3,1,1,0,28
61610701,5,5,1,8,6,0,1,0,26
61610702,4,3,3,6,4,0,0,0,20
61610703,1,4,2,0,1,2,1,0,11
61610801,10,11,7,4,5,1,2,1,41
61610802,4,4,3,1,1,2,1,0,16
61610803,0,1,0,1,0,0,0,0,2
61610804,2,3,4,1,3,1,0,0,14
61680101,2,1,1,1,4,2,0,1,12
61680102,3,1,2,1,2,0,0,1,10
61680103,2,3,5,2,0,0,0,0,12
61680104,2,2,2,3,0,1,0,0,10
61680201,1,2,2,2,1,1,2,0,11
61680202,1,5,0,1,1,0,0,0,8
61680203,4,5,1,1,1,1,0,0,13
61680204,0,1,0,0,1,2,0,0,4
61680301,5,5,3,1,0,1,1,0,16
61680302,1,1,1,0,0,0,0,0,3
61680303,6,1,6,2,1,0,0,0,16
61680401,2,2,1,1,0,0,0,0,6
61680402,1,4,2,1,0,1,1,0,10
61680403,3,1,0,1,2,1,0,0,8
61680404,2,1,0,0,0,0,0,0,3
61680405,1,0,0,0,0,0,0,0,1
61680406,1,0,1,0,0,0,0,0,2
61680501,8,10,11,8,10,0,0,0,47
61680502,3,0,1,1,2,0,0,0,7
61680503,1,4,0,3,0,0,0,0,8
61680601,1,1,0,2,0,0,0,0,4
61680602,0,3,1,0,0,1,0,0,5
61680603,8,1,2,1,1,0,0,0,13
61680604,1,2,1,1,2,0,0,0,7
61680701,4,3,2,0,1,0,0,0,10
61680702,1,1,2,1,2,0,0,0,7
61680801,3,8,1,3,1,0,1,0,17
61680802,1,2,5,2,1,1,0,0,12
61680803,5,4,3,5,3,1,0,0,21
61680804,2,1,2,1,0,0,0,0,6
61680805,8,10,6,6,2,4,1,1,38
61680806,2,1,3,1,1,0,1,0,9
61680807,36,43,48,37,20,11,1,0,196
61680901,29,63,49,50,27,21,7,6,252
61680902,70,81,51,49,24,5,4,0,284
61680903,66,52,31,39,16,8,3,5,220
61680904,84,85,61,67,25,19,3,4,348
61680905,92,91,51,55,21,3,1,2,316
61680906,43,43,49,39,22,12,7,8,223
61680907,22,41,49,41,21,7,2,0,183
61680908,22,29,36,46,25,10,6,4,178
61681001,20,23,25,17,7,1,2,0,95
61681002,1,1,4,1,0,1,0,1,9
61681003,6,6,2,4,3,1,0,0,22
61681101,5,9,5,4,1,1,0,0,25
61681102,5,1,5,2,1,0,0,0,14
61750101,17,19,14,17,5,4,1,2,79
61750102,9,6,9,3,1,0,2,0,30
61750103,1,3,4,4,0,0,0,0,12
61750104,1,1,2,1,1,0,1,0,7
61750201,20,16,11,12,4,4,0,2,69
61750202,0,1,0,3,1,0,0,0,5
61750203,0,1,1,2,0,0,1,0,5
61750204,0,1,0,1,0,0,0,0,2
61750301,1,1,2,2,0,0,0,0,6
61750302,1,1,0,2,0,0,1,0,5
61750303,2,1,1,0,0,0,0,1,5
61750304,1,0,0,0,0,0,0,0,1
61750401,7,9,5,3,5,0,1,0,30
61750402,56,67,59,87,41,14,7,4,335
61750403,26,45,42,54,45,31,15,15,273
61750404,42,51,43,23,19,5,1,3,187
61750405,86,82,48,42,13,4,0,0,275
61750406,80,73,43,32,20,6,0,0,254
61750407,81,83,48,32,11,3,1,1,260
61750408,87,130,65,60,20,6,2,0,370
61750409,52,65,90,72,30,14,3,1,327
61750410,74,97,55,66,15,14,2,1,324
61750411,58,71,36,22,7,2,1,1,198
61750412,66,73,55,33,15,11,1,4,258
61750413,43,69,37,29,16,3,0,0,197
61750414,54,77,52,50,25,11,2,1,272
61750415,26,29,43,41,19,3,2,1,164
61750416,25,40,27,28,20,4,2,0,146
61750417,17,25,21,14,7,10,2,1,97
61750501,1,6,4,7,2,0,1,0,21
61750502,2,10,10,1,6,1,1,0,31
61750503,1,2,2,0,0,0,0,0,5
61750504,1,4,0,0,0,0,0,0,5
61750505,7,7,8,8,2,2,0,1,35
61750601,40,52,61,67,30,17,9,7,283
61750602,59,65,43,37,18,10,0,0,232
61750603,43,54,50,43,32,15,6,3,246
61750604,34,57,60,59,26,27,7,8,278
61750605,83,110,70,53,28,3,2,2,351
61750606,30,61,37,35,11,7,2,2,185
61750607,42,65,33,31,16,10,4,2,203
61750608,46,65,72,52,29,20,5,6,295
61750609,44,39,47,67,35,22,11,10,275
61750610,43,52,67,53,43,23,10,10,301
61750611,65,70,55,45,26,10,1,3,275
61750612,64,56,79,43,28,10,3,1,284
61750613,52,95,141,153,77,43,19,12,592
61750614,14,21,21,12,8,7,0,2,85
61750615,5,2,3,3,3,0,0,0,16
61820101,25,52,67,61,30,13,1,2,251
61820102,45,63,84,94,39,33,10,7,375
61820103,30,68,97,89,56,24,5,7,376
61820104,21,60,79,77,48,23,10,10,328
61820105,54,105,77,68,32,16,5,2,359
61820106,40,84,54,48,26,10,6,3,271
61820107,66,78,70,55,23,9,2,2,305
61820108,43,55,27,37,27,8,5,1,203
61820109,36,76,80,73,58,32,14,18,387
61820110,14,69,71,86,44,20,6,3,313
61820111,28,56,66,81,56,17,13,7,324
61820112,22,74,75,72,47,21,10,3,324
61820113,26,56,56,53,41,11,3,4,250
61820114,21,49,74,95,56,21,6,4,326
61820201,37,49,64,46,18,3,1,0,218
61820202,77,103,70,43,17,8,4,4,326
61820203,65,78,58,51,15,9,1,1,278
61820204,64,74,59,32,24,9,2,1,265
61820205,49,58,61,44,20,10,2,1,245
61820206,58,74,49,47,22,6,2,2,260
61820207,77,84,45,40,15,7,2,2,272
61820208,59,70,71,48,19,7,3,2,279
61820209,83,71,40,37,15,2,4,0,252
61820210,74,90,42,38,20,7,5,1,277
61820211,44,53,63,31,14,7,4,2,218
61820212,61,51,50,31,17,13,2,0,225
61820213,62,64,48,44,11,9,1,3,242
61820301,3,6,3,10,7,3,0,0,32
61820302,4,2,0,0,0,0,0,0,6
61820303,8,8,8,8,8,5,0,1,46
61820304,0,12,8,10,6,6,9,1,52
61820305,5,13,14,16,12,6,2,0,68
61820306,1,0,0,0,0,0,0,0,1
61820307,0,0,0,0,0,0,0,0,0
61820308,3,3,2,2,0,3,1,0,14
61820309,17,32,51,60,24,7,2,0,193
61820310,5,5,4,2,1,1,0,0,18
61820311,10,36,38,40,14,9,3,2,152
61820312,3,5,7,8,0,1,0,0,24
61820401,3,12,2,2,2,0,0,1,22
61820501,18,47,28,33,12,3,0,1,142
61820502,22,24,30,22,16,7,3,3,127
61820503,27,32,22,25,20,17,3,3,149
61820504,30,71,48,52,30,19,7,6,263
61820505,22,13,17,23,15,8,5,1,104
61820601,3,11,0,1,2,1,1,1,20
61820602,17,16,10,9,6,2,1,0,61
61820603,6,2,4,1,5,0,0,0,18
61820604,43,60,66,79,51,28,10,5,342
61820605,53,66,101,95,58,30,14,25,442
61820606,69,73,73,82,57,30,14,5,403
61820607,71,80,89,78,44,28,9,9,408
61820608,32,49,72,84,47,23,6,4,317
61820609,47,71,60,40,32,14,2,5,271
61820701,4,2,2,3,1,2,0,0,14
61820702,22,29,30,42,38,14,6,18,199
61820703,53,102,69,64,38,17,10,6,359
61820704,46,55,46,39,29,11,4,8,238
61820705,40,62,60,62,37,18,7,6,292
61820706,20,20,23,27,7,14,4,4,119
61820707,0,0,0,0,0,0,0,0,0
61820708,41,62,70,53,28,14,1,7,276
61820709,47,64,62,44,29,20,6,9,281
61820710,63,104,71,56,37,26,6,8,371
61820801,11,6,4,1,0,4,0,0,26
61820901,20,34,12,17,8,3,1,1,96
61820902,13,12,11,0,2,3,0,0,41
61820903,1,2,1,7,2,1,1,0,15
61820904,14,27,13,8,4,2,1,2,71
61820905,11,12,5,8,2,1,0,0,39
61821001,44,44,49,28,13,12,3,2,195
61821002,35,43,25,36,15,2,0,2,158
61821003,79,109,72,40,24,12,2,0,338
61821004,74,105,62,52,22,7,5,2,329
61821005,62,90,56,44,17,9,1,5,284
61821006,55,71,49,46,23,7,3,2,256
61821007,47,64,57,47,20,6,3,3,247
61821008,69,124,60,44,23,7,2,3,332
61821009,104,113,76,46,24,11,3,1,378
61821010,60,90,49,72,30,12,5,2,320
61821011,75,81,58,38,24,9,1,2,288
61821101,44,59,37,38,22,10,3,3,216
61821102,71,83,72,47,38,7,2,2,322
61821103,71,85,69,54,26,15,10,6,336
61821104,49,45,63,37,26,9,5,4,238
61821105,40,55,48,30,14,4,4,4,199
61821106,55,68,47,48,21,9,2,3,253
61821107,30,67,29,31,25,14,2,1,199
61821108,33,70,40,52,45,21,4,6,271
61821109,42,60,61,57,36,29,5,18,308
61821110,7,17,9,17,13,7,5,1,76
61890101,3,1,1,4,0,0,0,0,9
61890102,3,4,0,3,0,0,0,0,10
61890103,0,1,1,1,0,0,0,0,3
61890104,1,4,0,1,1,0,0,0,7
61890201,0,1,0,0,0,0,0,0,1
61890202,1,1,0,0,0,0,0,0,2
61890203,0,1,1,1,0,0,0,0,3
61890204,0,1,0,0,0,0,0,0,1
61890205,0,1,0,0,0,0,0,0,1
61890206,2,2,2,0,0,0,0,0,6
61890207,2,4,2,1,0,0,0,0,9
61890301,3,9,5,6,1,0,0,0,24
61890302,2,0,1,2,0,0,0,0,5
61890303,1,2,1,1,1,1,0,0,7
61890304,1,1,0,0,0,0,0,0,2
61890305,0,3,0,1,1,0,0,0,5
61890401,0,0,1,1,0,0,0,0,2
61890402,1,2,1,1,0,0,0,0,5
61890403,1,4,2,1,0,0,0,0,8
61890501,0,0,0,2,0,0,0,0,2
61890502,1,3,0,0,0,0,0,0,4
61890503,2,2,0,2,0,0,0,0,6
61890504,1,1,1,1,1,0,0,0,5
61890505,2,0,0,0,2,0,0,0,4
61890601,5,7,1,4,0,0,0,0,17
61890602,1,3,1,2,1,2,0,0,10
61890603,1,1,0,1,0,1,0,1,5
61890604,0,4,0,2,0,0,0,1,7
61890605,1,0,0,0,0,0,0,0,1
61890606,0,0,1,0,0,0,0,0,1
61890607,0,3,0,0,1,0,0,0,4
61890608,1,1,2,3,0,0,0,0,7
61890701,2,1,1,2,0,0,0,0,6
61890702,0,1,1,0,1,0,0,0,3
61890703,2,4,3,1,0,1,0,0,11
61890704,0,0,1,1,0,0,0,0,2
61890705,3,1,1,1,0,0,0,0,6
61890706,1,0,0,1,0,0,0,0,2
61890707,4,4,1,1,0,0,0,0,10
61890801,0,1,0,1,0,0,0,0,2
61890802,2,1,2,0,4,0,0,0,9
61890803,0,2,2,0,0,0,0,0,4
61890804,3,0,0,0,0,0,0,0,3
61890901,1,4,2,0,0,0,0,0,7
61890902,11,1,1,3,0,0,0,0,16
61891001,44,52,52,27,21,9,2,2,209
61891002,46,69,52,30,19,11,7,6,240
61891003,36,56,52,63,29,10,1,5,252
61891004,52,88,59,46,16,10,3,4,278
61891005,48,66,49,51,23,12,7,2,258
61891006,98,89,56,33,21,7,2,2,308
61891007,75,112,61,59,18,8,6,2,341
61891008,28,57,48,47,21,9,3,3,216
61891009,21,50,44,45,18,7,3,1,189
61891010,5,7,0,2,3,0,0,0,17
61891101,0,1,2,1,0,0,0,0,4
61891102,1,3,4,1,0,1,0,0,10
61891103,3,0,2,0,0,0,0,0,5
61891104,1,2,0,1,0,0,0,0,4
61891105,8,4,0,1,1,0,0,1,15
61891106,2,2,1,0,0,0,0,0,5
61891107,1,1,0,1,0,0,0,0,3
61891201,32,36,34,30,12,4,0,3,151
61891202,3,1,0,0,3,0,0,0,7
61891203,3,0,1,1,2,0,0,0,7
61891204,0,2,1,0,0,0,0,0,3
61891205,2,1,0,0,3,0,0,0,6
61891206,2,2,2,0,0,1,0,0,7
61891207,1,0,0,0,1,0,0,0,2
61891208,0,3,1,0,1,0,0,0,5
61891209,1,1,1,0,0,0,0,0,3
61891210,1,3,2,1,2,0,0,0,9
61891211,35,31,22,22,13,10,2,1,136
61891301,10,9,8,7,0,0,0,0,34
61891302,2,3,1,1,0,0,0,0,7
61891303,4,1,3,1,3,0,0,0,12
61891304,2,2,2,0,0,0,0,0,6
61891305,1,0,0,0,1,0,0,0,2
61891306,2,1,0,0,1,0,0,0,4
61891307,9,2,0,0,0,0,0,0,11
61891308,2,0,1,1,0,1,0,0,5
61891309,0,0,1,0,0,0,0,0,1
61891401,0,3,1,1,0,0,0,0,5
61891402,0,0,0,1,0,0,1,0,2
61891403,1,4,0,1,0,0,1,0,7
61891404,1,0,1,0,0,0,0,0,2
61891405,0,3,0,1,0,0,0,0,4
61891406,3,1,2,0,0,0,0,0,6
61891501,38,45,32,21,13,4,3,0,156
61891502,87,126,66,42,26,9,6,1,363
61891503,16,25,11,5,3,1,1,1,63
61891504,6,10,3,4,1,0,0,0,24
61891505,5,7,3,2,1,0,0,0,18
61891506,0,0,1,1,0,0,0,0,2
61891507,2,2,1,0,0,0,0,0,5
61891508,7,0,2,0,0,0,0,0,9
61891509,51,73,28,19,5,3,0,0,179
61891601,2,2,4,3,0,0,0,0,11
61891602,0,1,0,0,0,0,0,0,1
61891603,2,5,1,1,0,2,0,0,11
61891604,1,1,0,1,0,0,0,0,3
61891605,3,1,0,0,0,0,0,0,4
61891701,4,9,3,4,0,2,0,1,23
61891702,26,39,42,37,15,5,6,3,173
61891703,91,94,63,37,17,8,4,0,314
61891704,49,66,38,36,16,10,1,2,218
61891705,50,66,51,26,14,6,1,3,217
61891706,81,73,34,18,13,5,1,0,225
61891707,81,108,59,39,29,9,3,0,328
61891708,45,71,54,45,17,24,4,9,269
61891709,5,0,0,6,0,0,0,0,11
61960101,46,60,58,50,27,27,7,9,284
61960102,65,88,63,58,18,10,5,4,311
61960103,60,65,58,41,21,11,6,4,266
61960104,64,59,47,46,27,8,5,2,258
61960105,13,19,16,22,9,13,2,4,98
61960106,24,14,19,27,12,6,1,3,106
61960107,16,16,36,21,18,6,2,2,117
61960108,48,82,61,70,35,5,3,3,307
61960109,13,27,31,25,13,9,2,1,121
61960110,17,32,27,21,12,8,2,3,122
61960111,14,26,30,26,13,6,0,3,118
61960112,39,91,88,69,29,13,4,5,338
61960113,57,78,41,22,19,10,2,4,233
61960114,43,72,39,36,9,1,1,1,202
61960115,65,59,36,21,10,5,0,1,197
61960116,102,96,71,47,18,2,1,2,339
61960117,40,63,38,19,13,6,0,2,181
61960118,33,36,33,36,8,5,1,5,157
61960119,37,38,32,31,15,7,2,2,164
61960201,16,11,19,13,8,6,2,2,77
61960202,18,17,17,22,9,8,5,3,99
61960203,12,22,28,16,17,5,2,2,104
61960204,63,57,41,42,19,14,5,2,243
61960205,89,128,63,49,19,5,2,2,357
61960206,107,95,60,33,18,3,2,0,318
61960207,72,79,37,26,11,10,1,1,237
61960208,70,87,44,32,16,5,5,2,261
61960209,91,108,56,38,20,7,0,1,321
61960210,89,77,54,53,31,7,1,3,315
61960211,37,35,26,29,14,9,2,2,154
61960212,26,29,25,28,15,11,0,3,137
61960213,54,62,40,29,10,6,1,0,202
61960214,39,59,51,34,11,8,1,0,203
61960301,3,1,1,2,2,0,0,0,9
61960302,4,1,2,3,0,0,0,0,10
61960303,1,3,0,2,1,1,0,0,8
61960304,1,0,1,2,0,0,0,0,4
61960305,4,3,0,0,0,0,0,0,7
61960306,3,2,3,1,1,0,0,0,10
61960401,2,11,5,1,0,0,0,0,19
61960402,1,2,2,2,0,3,0,0,10
61960403,1,2,1,0,1,1,0,0,6
61960404,2,2,2,1,0,0,0,0,7
61960501,0,1,4,1,0,0,0,0,6
61960502,1,0,1,0,0,0,0,0,2
61960503,6,1,3,1,1,0,0,0,12
61960504,1,2,0,0,1,0,0,0,4
61960601,1,3,1,2,0,0,0,0,7
61960602,1,0,1,0,0,0,0,1,3
61960603,2,4,1,0,0,0,0,0,7
61960604,2,1,1,0,0,0,0,0,4
61960701,30,33,25,21,12,6,6,3,136
61960702,2,0,2,1,0,0,0,0,5
61960703,2,0,1,0,0,0,0,0,3
61960704,2,2,0,2,0,0,0,0,6
61960705,5,3,1,1,2,0,0,0,12
61960706,0,2,0,0,1,0,0,0,3
61960707,7,5,6,1,1,1,0,0,21
61960708,7,9,8,5,3,1,1,0,34
61960709,3,7,3,0,4,1,1,0,19
61960801,2,4,1,2,0,0,0,0,9
61960802,9,2,1,1,0,0,0,0,13
61960803,3,4,1,2,1,0,0,0,11
61960804,3,3,4,2,0,1,0,0,13
61960805,0,1,0,0,0,0,0,0,1
61960806,2,2,2,1,3,0,0,0,10
61960901,0,1,0,0,0,0,0,0,1
61960902,1,2,0,0,0,0,2,0,5
61960903,4,1,3,4,0,0,0,0,12
61960904,2,7,2,3,1,0,0,0,15
61960905,5,0,3,2,1,0,0,0,11
61961001,3,1,2,2,0,0,1,0,9
61961002,5,3,0,0,1,0,0,0,9
61961003,0,0,0,1,0,1,0,1,3
61961004,2,2,0,0,0,1,0,0,5
61961005,3,2,3,5,0,0,0,0,13
61961101,2,1,2,3,0,0,0,0,8
61961102,5,5,6,2,1,0,0,0,19
61961103,6,3,3,0,0,0,0,0,12
61961104,3,2,1,1,0,0,0,0,7
61961105,3,5,3,2,3,0,0,0,16
61961106,1,2,2,3,0,0,0,0,8
61961107,3,3,0,0,0,0,0,0,6
61961108,0,3,3,0,1,0,0,0,7
61961201,0,2,1,0,1,0,0,0,4
61961202,2,8,3,2,1,0,0,0,16
61961203,0,3,2,0,1,0,0,0,6
61961204,0,0,0,2,0,0,0,0,2
61961205,2,5,5,2,0,0,0,0,14
61961206,6,1,1,0,1,0,0,0,9
61961301,0,1,0,1,0,1,0,0,3
61961302,0,2,1,2,0,0,0,0,5
61961303,1,1,2,3,2,1,0,0,10
61961304,3,4,3,1,0,1,0,0,12
61961305,3,2,1,5,0,0,0,0,11
61961401,0,2,2,0,0,1,0,0,5
61961402,2,5,5,1,0,0,0,0,13
61961403,2,4,1,1,2,0,0,0,10
61961501,24,21,10,6,5,2,3,0,71
61961502,0,4,1,2,2,0,0,0,9
61961503,1,1,2,1,1,0,0,0,6
61961504,2,1,3,0,0,0,0,0,6
61961505,1,0,0,1,0,0,0,0,2
61961506,25,29,9,10,11,5,1,1,91
61961507,39,51,28,23,5,4,0,0,150
61961508,23,33,18,15,6,2,0,1,98
62030101,93,122,54,44,15,8,2,1,339
62030102,77,87,46,28,13,3,2,0,256
62030103,94,102,46,35,8,5,1,2,293
62030104,79,101,48,33,15,2,0,1,279
62030105,64,98,54,34,11,4,2,2,269
62030106,58,92,60,41,19,8,1,1,280
62030107,77,70,48,25,6,1,1,0,228
62030108,67,82,53,49,27,11,3,2,294
62030109,53,76,47,23,14,5,2,0,220
62030110,47,97,65,63,32,9,2,2,317
62030111,48,84,63,45,32,12,6,3,293
62030112,54,84,64,58,27,12,5,4,308
62030113,41,59,67,44,26,17,5,4,263
62030201,48,61,33,31,6,3,0,0,182
62030202,71,65,51,20,13,4,1,1,226
62030203,57,56,39,33,12,2,1,1,201
62030204,36,41,44,31,18,7,1,3,181
62030205,8,5,2,1,0,2,0,0,18
62030206,0,3,4,3,1,0,0,0,11
62030207,11,15,6,3,1,0,0,0,36
62030208,3,3,1,2,1,0,0,0,10
62030209,2,4,1,2,0,0,0,0,9
62030210,53,71,45,39,27,6,4,3,248
62030211,37,43,30,19,10,7,1,0,147
62030212,69,76,62,78,25,6,3,3,322
62030213,39,32,27,13,10,3,3,0,127
62030214,12,5,3,3,2,0,0,1,26
62030215,41,58,42,33,18,2,0,1,195
62030301,2,7,0,3,1,1,0,0,14
62030302,5,3,2,1,1,0,1,0,13
62030303,3,2,2,0,0,1,0,0,8
62030304,4,5,1,4,0,0,0,0,14
62030305,2,2,2,0,1,1,1,0,9
62030306,2,3,2,1,0,1,0,0,9
62030401,9,18,14,13,4,1,0,0,59
62030402,2,1,1,1,0,0,0,0,5
62030403,3,4,2,0,1,0,0,0,10
62030404,1,3,0,0,1,0,0,0,5
62030405,3,0,2,0,1,0,0,0,6
62030406,2,2,0,1,1,0,0,0,6
62030407,1,0,2,1,0,0,1,0,5
62030408,2,6,3,1,0,0,0,0,12
62030501,16,6,6,5,2,2,1,0,38
62030502,0,1,1,1,0,0,0,0,3
62030503,2,3,2,2,1,0,0,0,10
62030504,3,4,2,2,3,0,0,0,14
62030505,1,3,2,1,0,0,0,0,7
62030506,1,4,0,1,1,0,0,0,7
62030507,1,1,1,0,0,0,0,0,3
62030601,3,3,2,0,0,1,0,0,9
62030602,4,3,1,0,0,0,0,0,8
62030603,2,0,1,1,1,0,0,0,5
62030604,2,2,3,2,2,1,0,0,12
62030605,3,1,0,0,0,1,0,0,5
62030701,0,1,0,1,0,0,0,0,2
62030702,1,3,1,0,0,0,0,0,5
62030703,2,1,1,0,1,0,0,0,5
62030704,2,0,0,2,0,1,0,0,5
62030705,0,3,1,0,0,0,0,0,4
62030706,1,1,0,1,0,0,0,0,3
62030707,1,2,0,0,1,0,0,0,4
62030708,1,0,1,0,0,0,0,0,2
62030709,0,2,0,0,0,0,0,0,2
62030710,3,3,1,0,2,0,0,0,9
62030711,2,2,0,0,0,0,1,0,5
62030801,3,2,3,2,1,1,0,0,12
62030802,6,9,5,4,1,2,1,0,28
62030803,28,43,44,52,41,15,7,4,234
62030804,61,74,82,81,41,13,3,1,356
62030805,101,144,72,68,26,10,2,1,424
62030806,103,125,63,57,33,8,2,1,392
62030807,78,115,77,48,25,8,1,1,353
62030808,56,126,114,128,40,14,4,1,483
62030809,80,84,84,50,26,7,2,0,333
62030810,59,90,57,75,25,7,1,1,315
62030811,27,25,19,11,7,3,2,0,94
62030812,27,35,40,38,18,7,2,0,167
62030901,2,5,1,1,0,0,0,0,9
62030902,3,5,3,2,0,1,0,0,14
62030903,1,1,0,0,0,0,0,0,2
62030904,0,0,2,0,0,2,0,0,4
62030905,2,1,0,0,0,0,0,0,3
62030906,0,0,1,0,0,0,0,0,1
62030907,2,2,1,0,0,0,0,0,5
62031001,0,1,0,0,0,0,0,0,1
62031002,2,1,3,2,2,1,0,0,11
62031003,5,5,1,0,1,0,0,0,12
62031004,2,2,0,0,2,0,0,0,6
62031005,1,1,2,1,1,0,0,0,6
62031101,6,3,0,2,1,0,0,0,12
62031102,1,1,4,2,3,1,0,0,12
62031103,0,0,0,0,0,0,0,0,0
62031104,1,0,2,1,0,0,0,0,4
62031105,0,1,2,0,0,0,0,0,3
62031106,0,0,0,0,2,1,0,0,3
62031201,3,2,0,1,0,1,0,0,7
62031202,1,0,2,2,0,1,0,0,6
62031203,4,3,3,2,0,0,0,0,12
62031204,3,5,2,1,1,0,0,0,12
62031205,5,5,1,1,1,0,0,0,13
62031301,0,3,3,0,1,0,0,0,7
62031302,0,2,2,0,0,1,0,0,5
62031303,0,2,4,1,0,0,0,0,7
62031304,3,2,1,2,3,0,0,1,12
62031305,5,3,2,2,1,0,0,0,13
62031306,1,2,3,3,0,0,0,0,9
62031307,4,2,4,0,1,0,0,0,11
62031308,7,3,0,0,0,0,0,0,10
62031401,44,45,26,23,9,4,1,0,152
62031402,3,1,1,3,3,0,0,0,11
62031403,2,2,1,2,0,0,0,0,7
62031404,1,1,1,2,0,0,0,0,5
62031405,11,1,1,4,4,0,0,1,22
62031406,4,1,0,0,0,0,0,0,5
62031407,1,1,1,0,0,0,0,0,3
62031408,0,0,0,0,0,0,0,0,0
62031501,0,3,1,0,0,0,0,0,4
62031502,3,2,3,3,4,2,0,0,17
62031503,3,0,4,3,1,0,0,0,11
62031504,2,4,1,1,0,0,0,0,8
62031601,47,101,106,93,56,16,8,1,428
62031602,33,61,78,53,38,15,9,5,292
62031603,34,46,68,56,27,11,7,6,255
62031604,58,125,95,70,45,23,4,5,425
62031605,54,85,58,47,16,10,4,0,274
62031606,19,37,32,20,20,13,10,7,158
62031607,38,83,74,71,28,16,10,2,322
62031608,49,98,64,45,31,6,5,8,306
62031609,63,118,74,99,35,9,3,4,405
62031610,65,70,70,67,27,10,6,5,320
62031611,7,21,33,26,12,5,1,0,105
62031612,67,68,68,40,25,5,0,1,274
62031613,70,75,59,57,25,13,0,0,299
62100101,33,59,43,32,17,9,1,3,197
62100102,38,54,37,32,14,6,3,3,187
62100103,34,50,38,18,18,4,0,2,164
62100104,38,57,33,22,8,7,1,2,168
62100105,40,52,44,24,12,4,2,0,178
62100106,58,100,50,33,17,9,2,2,271
62100107,47,56,65,70,22,13,4,2,279
62100108,50,67,44,39,15,7,0,2,224
62100109,46,48,45,18,13,3,0,1,174
62100110,43,57,32,14,18,4,0,0,168
62100111,84,87,49,29,14,7,1,1,272
62100112,33,55,30,25,10,6,1,1,161
62100113,37,48,54,41,14,5,2,2,203
62100114,19,33,45,27,17,6,1,2,150
62100115,44,67,51,71,28,12,1,6,280
62100116,91,80,52,46,23,7,1,3,303
62100117,81,92,69,45,23,4,0,1,315
62100118,50,82,48,63,17,10,1,3,274
62100119,50,67,54,58,37,20,5,7,298
62100120,61,73,68,58,25,14,4,3,306
62100121,47,66,65,49,26,13,5,0,271
62100201,35,62,60,64,43,11,1,3,279
62100202,63,103,70,86,52,9,7,2,392
62100203,79,109,90,73,42,18,2,4,417
62100204,83,107,80,43,27,5,2,1,348
62100205,60,74,24,32,13,6,2,1,212
62100206,33,68,33,36,14,10,4,0,198
62100207,71,124,100,79,42,19,2,3,440
62100208,83,90,58,32,15,9,2,0,289
62100209,88,78,46,32,14,5,0,1,264
62100210,95,113,89,66,40,8,4,1,416
62100301,16,21,9,13,6,2,1,2,70
62100401,7,21,7,7,2,6,1,1,52
62100501,34,35,15,17,10,6,3,3,123
62100601,3,3,7,4,4,3,1,0,25
62100602,6,6,4,4,0,0,0,0,20
62100603,33,39,30,33,18,7,2,3,165
62100604,7,12,12,9,3,4,2,2,51
62100605,36,34,20,17,8,1,1,0,117
62100606,45,58,41,31,10,10,1,1,197
62100607,30,37,24,20,6,7,1,1,126
62100608,19,26,17,14,10,6,0,2,94
62100609,3,3,6,1,1,0,0,0,14
62100610,9,3,5,2,1,1,0,0,21
62100611,20,16,12,8,4,2,1,1,64
62100612,43,41,23,12,10,1,0,4,134
62100613,14,22,13,12,4,2,1,0,68
62100701,9,17,15,11,8,2,2,0,64
62100801,26,23,26,19,13,7,2,3,119
62100802,38,66,66,57,23,7,5,3,265
62100803,44,67,61,65,38,24,9,6,314
62100804,65,89,80,80,36,28,6,5,389
62100805,56,108,115,119,73,37,10,16,534
62100806,27,56,38,26,36,18,3,4,208
62100807,16,16,10,15,8,4,4,3,76
62100808,82,158,179,180,121,65,18,15,818
62100809,47,67,59,49,34,19,5,5,285
62100810,40,54,73,77,48,37,10,13,352
62100811,14,25,19,9,8,5,3,4,87
62100901,58,63,38,36,19,6,0,2,222
62100902,60,67,57,43,9,5,0,0,241
62100903,8,21,14,16,4,2,0,0,65
62101001,12,9,11,6,8,2,0,1,49
62101101,3,6,4,2,1,0,1,0,17
62101201,15,25,18,15,4,2,2,0,81
62101301,92,130,63,45,15,8,1,1,355
62101302,60,82,67,60,22,11,4,3,309
62101303,34,62,42,29,11,6,0,3,187
62101304,97,99,56,59,23,10,0,0,344
62101305,56,69,43,40,18,9,3,1,239
62101306,107,107,76,67,32,13,2,0,404
62101307,44,73,62,61,24,12,5,1,282
62101308,70,112,88,85,36,24,2,2,419
62101309,43,82,72,66,41,19,5,4,332
62170101,82,94,54,30,16,2,3,4,285
62170102,81,89,59,40,19,8,5,1,302
62170103,60,74,44,38,18,11,7,2,254
62170104,69,92,68,52,25,13,7,5,331
62170105,65,95,60,43,28,7,3,1,302
62170106,55,42,14,38,15,6,0,1,171
62170107,89,89,49,36,12,6,4,0,285
62170108,62,55,47,24,25,4,0,1,218
62170109,59,84,52,37,13,10,0,1,256
62170110,62,84,31,39,19,0,1,1,237
62170111,66,58,38,29,13,5,2,3,214
62170112,83,73,43,39,18,8,1,1,266
62170113,79,107,96,71,29,17,5,0,404
62170114,42,44,31,14,9,4,1,2,147
62170201,5,6,8,6,3,1,1,0,30
62170202,8,7,2,5,2,0,0,0,24
62170203,0,3,1,2,0,2,1,0,9
62170204,9,5,2,3,3,1,0,0,23
62170205,1,5,7,5,3,0,0,0,21
62170206,4,5,4,0,2,0,0,0,15
62170207,2,2,5,4,1,1,0,0,15
62170301,9,15,4,6,8,3,1,2,48
62170302,8,10,5,7,9,4,2,4,49
62170303,14,14,12,14,11,7,2,5,79
62170304,9,11,3,8,5,1,0,0,37
62170401,37,41,17,25,11,12,1,2,146
62170402,28,34,39,34,28,16,12,8,199
62170403,17,29,17,27,24,6,2,3,125
62170404,27,44,45,26,13,10,1,3,169
62170405,13,23,18,14,16,8,5,4,101
62170406,13,22,17,17,9,2,3,0,83
62170407,17,20,23,14,9,3,3,1,90
62170408,16,23,22,11,12,6,2,2,94
62170409,30,44,36,29,20,4,3,9,175
62170410,37,50,50,35,33,12,4,2,223
62170411,35,47,44,47,28,10,5,4,220
62170412,23,40,34,40,20,16,12,9,194
62170413,66,77,78,82,51,39,6,19,418
62170414,80,96,96,77,40,26,5,12,432
62170415,57,58,43,40,22,13,5,6,244
62170416,47,58,55,50,22,10,7,6,255
62170501,3,3,2,1,2,0,0,0,11
62170502,0,1,1,1,0,0,0,0,3
62170503,1,3,1,1,0,0,0,0,6
62170504,3,1,0,1,0,0,0,0,5
62170505,18,19,9,6,4,0,0,0,56
62170506,6,3,2,2,2,0,0,0,15
62170507,4,3,5,5,2,0,1,0,20
62170508,3,7,7,0,2,0,0,0,19
62170509,0,1,2,0,0,1,0,0,4
62170510,0,2,1,2,0,2,0,0,7
62170511,3,0,5,1,2,1,0,0,12
62170512,1,1,0,2,0,2,0,0,6
62170601,5,3,1,0,0,0,0,0,9
62170602,1,2,1,0,0,2,0,0,6
62170603,2,1,4,1,1,0,0,0,9
62170604,7,4,3,2,3,2,1,0,22
62170605,5,4,4,2,2,0,0,0,17
62170701,2,2,2,1,0,1,0,0,8
62170702,5,2,3,0,2,0,0,0,12
62170801,5,6,7,5,1,1,1,1,27
62170802,6,4,2,4,5,0,0,0,21
62170803,3,5,5,2,4,3,0,0,22
62170901,2,6,3,4,3,0,0,0,18
62170902,8,7,6,8,1,0,1,0,31
62170903,6,3,6,6,3,0,0,0,24
62170904,4,6,4,8,0,2,0,0,24
62170905,0,5,2,2,2,0,0,0,11
62170906,3,7,3,5,2,0,0,0,20
62170907,5,6,1,1,2,1,1,1,18
62171001,52,79,40,47,25,17,2,1,263
62171002,93,108,86,73,48,23,6,3,440
62171003,85,90,80,71,33,13,4,1,377
62171004,61,76,65,50,25,11,4,3,295
62171005,8,2,2,3,2,1,0,0,18
62171006,4,7,5,1,2,1,1,1,22
62171007,5,6,3,2,1,1,0,0,18
62171008,3,8,6,2,0,2,0,0,21
62171009,3,6,7,3,0,2,1,0,22
62171010,18,20,14,12,5,3,1,1,74
62171011,10,22,15,17,6,4,2,1,77
62171012,5,4,1,0,1,0,0,0,11
62171013,39,59,49,48,19,6,2,1,223
62171101,20,15,6,5,7,4,0,0,57
62171102,7,2,5,2,1,1,0,0,18
62171103,7,2,5,2,4,0,0,0,20
62171104,2,1,3,1,1,1,0,0,9
62171105,7,9,7,5,4,3,0,2,37
62171106,5,3,2,1,0,0,2,0,13
62171201,36,57,50,51,32,12,4,3,245
62171202,39,110,130,136,77,46,33,21,592
62171203,46,63,74,71,30,14,0,2,300
62171204,26,35,50,38,27,26,4,9,215
62171205,55,74,70,63,29,17,10,7,325
62171206,64,66,60,37,12,6,2,2,249
62171207,52,67,52,38,16,7,3,0,235
62171208,56,79,48,44,22,5,2,1,257
62171209,39,71,48,34,19,12,1,2,226
62171210,66,116,110,82,30,18,7,3,432
62171211,43,44,29,44,23,9,1,2,195
62171212,35,59,59,63,37,25,7,14,299
62171213,33,56,70,70,28,7,4,3,271
62171214,42,47,42,25,10,9,3,0,178
62171215,36,50,41,62,20,7,0,0,216
62240101,24,33,32,30,20,16,6,5,166
62240102,81,89,62,43,22,9,3,2,311
62240103,82,111,97,55,45,8,5,5,408
62240104,54,66,49,46,22,11,1,1,250
62240105,55,102,66,67,27,13,4,1,335
62240106,42,82,67,51,27,7,4,4,284
62240107,77,104,63,48,16,7,3,2,320
62240108,49,73,41,30,14,8,1,0,216
62240109,69,114,73,45,19,3,2,1,326
62240110,66,107,51,48,19,1,1,1,294
62240111,101,115,70,48,14,9,4,0,361
62240112,134,99,48,29,17,6,2,4,339
62240113,43,72,67,43,25,15,9,8,282
62240114,47,78,66,66,39,13,9,3,321
62240115,22,31,37,38,20,13,11,6,178
62240116,25,35,35,41,28,3,2,4,173
62240117,33,58,55,52,24,8,3,4,237
62240201,34,55,48,49,22,11,1,2,222
62240202,35,72,51,43,30,9,5,3,248
62240203,12,27,36,33,20,11,9,4,152
62240204,53,83,108,90,41,20,9,4,408
62240205,43,63,65,59,23,3,3,8,267
62240206,53,77,48,54,23,10,5,3,273
62240207,71,67,76,59,20,3,2,2,300
62240208,77,107,74,59,31,12,3,3,366
62240209,40,91,56,47,22,12,2,3,273
62240210,99,111,48,42,13,3,0,0,316
62240211,71,95,54,33,5,3,0,0,261
62240212,16,38,29,19,18,4,5,4,133
62240213,12,18,20,24,14,6,6,5,105
62240214,32,53,58,53,25,11,4,2,238
62240301,54,86,60,41,22,9,2,3,277
62240302,43,68,71,79,28,8,4,3,304
62240303,75,86,68,54,17,3,4,3,310
62240304,72,78,63,43,23,4,4,1,288
62240305,31,64,49,42,17,8,1,2,214
62240306,38,70,46,49,18,8,5,3,237
62240307,27,55,67,65,37,26,6,11,294
62240308,34,58,59,61,41,26,9,15,303
62240309,24,42,37,31,17,7,8,1,167
62240310,48,49,54,57,33,20,3,2,266
62240401,25,33,55,61,36,19,9,10,248
62240402,78,145,86,81,26,9,8,0,433
62240403,76,108,77,81,23,12,3,3,383
62240404,77,100,48,45,11,1,2,2,286
62240405,107,108,79,38,20,8,2,1,363
62240406,71,94,58,36,14,8,1,0,282
62240407,95,108,52,39,19,6,0,2,321
62240408,92,97,44,24,7,3,1,0,268
62240409,65,107,93,64,22,12,2,4,369
62240410,35,78,50,40,22,7,2,1,235
62240411,56,98,73,51,21,10,7,1,317
62240412,20,35,25,37,22,8,3,0,150
62240413,105,113,53,37,20,7,1,0,336
62240414,21,33,31,33,20,13,3,1,155
62240415,20,25,33,22,21,8,4,1,134
62240416,30,50,36,35,10,4,2,1,168
62240417,22,40,56,68,31,14,7,10,248
62240501,3,3,2,3,0,1,0,0,12
62240502,1,1,0,4,1,1,0,0,8
62240503,3,10,6,5,0,1,0,0,25
62240504,1,2,0,1,0,0,0,0,4
62240505,4,4,0,4,2,0,0,2,16
62240601,5,6,3,2,0,3,0,0,19
62240602,10,5,4,5,1,1,1,2,29
62240603,9,8,5,7,4,2,0,1,36
62240604,7,10,4,8,5,0,1,0,35
62240701,0,1,0,0,1,0,0,0,2
62240702,5,1,2,6,0,0,0,0,14
62240703,2,7,3,3,0,0,0,0,15
62240801,2,2,1,3,1,0,1,0,10
62240802,1,3,2,4,2,0,0,0,12
62240901,18,37,32,32,14,4,2,1,140
62240902,48,77,70,43,26,16,4,3,287
62240903,13,25,15,19,4,7,0,2,85
62240904,12,15,11,11,4,3,1,2,59
62240905,3,2,2,0,3,0,0,0,10
62240906,15,15,16,12,3,3,5,1,70
62240907,5,9,4,3,2,2,1,3,29
62240908,40,48,52,64,31,28,8,10,281
62240909,21,10,14,16,12,5,2,3,83
62240910,13,6,15,10,8,3,0,0,55
62240911,30,35,36,27,17,10,4,6,165
62240912,23,37,30,30,14,5,4,1,144
62240913,17,18,12,12,7,1,1,1,69
62240914,9,23,10,16,5,3,1,1,68
62240915,28,48,38,31,14,9,5,3,176
62241001,2,1,1,3,1,1,0,0,9
62241002,4,11,1,4,0,1,0,0,21
62241101,5,11,6,6,3,1,1,0,33
62241102,14,14,3,7,4,4,0,0,46
62241103,15,18,11,10,10,3,0,1,68
62241201,16,12,8,5,4,1,0,1,47
62241202,2,3,1,3,1,0,0,0,10
62241203,5,5,4,7,1,0,0,0,22
62241204,28,33,13,16,7,3,2,0,102
62241301,12,18,14,17,5,3,1,1,71
62241302,4,2,3,4,0,1,0,0,14
62241303,1,4,3,4,0,1,0,0,13
62241401,2,4,2,2,1,1,0,0,12
62241402,6,8,0,7,2,1,0,0,24
62241403,7,17,11,6,8,2,0,0,51
62241501,2,3,1,1,1,0,0,0,8
62241502,6,5,3,2,1,1,0,0,18
62241503,2,3,0,2,1,1,1,0,10
62241601,0,5,3,1,0,0,0,0,9
62241602,1,3,3,0,0,0,0,0,7
62241701,21,25,10,7,5,3,1,0,72
62241702,6,0,4,4,2,1,0,0,17
62241703,7,2,8,4,1,1,1,0,24
62241801,1,3,2,3,0,0,1,0,10
62241802,4,7,2,2,3,0,0,0,18
62241901,11,10,3,11,5,5,1,2,48
62241902,0,3,4,0,2,0,0,0,9
62241903,2,3,3,2,2,2,0,0,14
62241904,3,4,4,3,1,2,1,0,18
62242001,40,24,22,23,4,3,0,1,117
62242002,36,23,29,28,11,0,1,1,129
62242003,52,81,68,59,21,7,4,2,294
62242004,1,1,1,1,0,0,0,1,5
62242005,3,2,5,5,0,2,0,1,18
62242006,1,1,1,1,1,1,0,0,6
62242007,3,5,0,0,1,0,1,1,11
62242008,6,2,1,2,0,0,0,0,11
62242009,17,19,16,17,4,2,2,2,79
62242010,32,39,17,32,8,4,0,2,134
62242101,1,2,1,1,3,0,1,0,9
62242102,0,3,1,0,0,0,0,0,4
62242103,2,2,1,0,0,1,0,1,7
62242201,77,83,42,19,10,2,0,0,233
62242202,77,89,44,36,10,1,4,0,261
62242203,96,106,53,46,23,5,1,1,331
62242204,108,91,57,34,14,11,1,0,316
62242205,66,111,57,42,15,2,2,1,296
62242206,88,112,62,63,24,4,0,1,354
62242207,41,54,63,50,18,9,5,2,242
62242208,80,78,58,35,14,6,2,5,278
62242209,41,51,50,45,20,9,1,2,219
62242210,44,42,37,56,21,17,6,4,227
62310101,36,68,50,41,16,10,5,1,227
62310102,43,39,25,37,13,5,1,4,167
62310103,7,2,3,0,3,0,1,0,16
62310104,10,17,16,20,10,3,3,1,80
62310105,3,4,5,5,3,2,0,0,22
62310106,12,6,4,3,2,0,1,1,29
62310107,40,49,44,30,14,10,2,1,190
62310201,6,7,7,1,1,0,0,0,22
62310202,4,7,1,7,1,0,0,1,21
62310203,4,4,3,1,1,0,0,0,13
62310204,0,1,5,1,1,0,0,0,8
62310301,3,2,4,0,1,1,0,0,11
62310302,6,6,1,6,3,2,0,1,25
62310303,4,4,1,5,3,3,0,2,22
62310304,2,2,2,1,0,1,0,0,8
62310401,0,2,0,0,0,0,0,0,2
62310402,1,3,1,2,0,0,0,0,7
62310403,3,3,2,1,0,0,0,0,9
62310404,0,1,5,4,3,0,0,0,13
62310405,0,2,2,2,1,0,0,0,7
62310501,1,3,4,2,2,0,0,0,12
62310502,1,0,4,3,1,1,0,0,10
62310601,2,0,1,0,0,0,0,0,3
62310602,0,4,0,0,2,2,0,0,8
62310603,12,6,3,7,4,1,0,0,33
62310604,0,1,2,1,0,1,0,0,5
62310605,1,1,1,3,1,0,0,0,7
62310606,5,4,8,2,3,0,0,1,23
62310701,1,5,3,5,0,0,0,0,14
62310702,3,2,2,2,0,1,0,0,10
62310703,1,3,1,4,1,0,0,0,10
62310704,2,5,2,2,1,1,1,2,16
62310705,0,0,0,1,0,0,0,0,1
62310706,2,3,0,0,0,0,0,0,5
62310707,1,1,1,0,1,0,0,0,4
62310801,4,5,1,3,1,0,0,0,14
62310802,1,1,0,0,0,0,0,0,2
62310803,52,58,49,40,17,6,4,3,229
62310804,0,1,1,0,0,0,0,0,2
62310805,0,1,3,0,2,0,0,0,6
62310901,3,6,3,1,3,0,0,0,16
62310902,10,7,10,5,2,0,2,1,37
62310903,3,3,5,2,2,0,0,0,15
62311001,38,77,76,67,55,26,10,12,361
62311002,2,1,0,0,0,0,0,0,3
62311003,1,4,4,2,0,0,0,0,11
62311004,0,1,0,0,0,0,0,0,1
62311005,10,11,18,8,4,4,1,0,56
62311101,0,0,2,0,0,0,0,0,2
62311201,30,59,67,72,50,22,5,10,315
62311202,43,55,74,45,36,27,8,9,297
62311203,47,66,45,39,20,5,0,1,223
62311204,74,89,67,52,21,18,1,2,324
62311205,88,87,52,42,22,3,1,2,297
62311206,59,65,36,20,8,8,1,0,197
62311207,70,96,69,45,31,11,5,5,332
62311208,59,97,82,74,45,26,9,6,398
62311209,58,81,42,38,11,9,1,1,241
62311210,75,81,51,44,24,10,4,0,289
62311211,68,53,72,59,41,34,13,16,356
62311212,28,33,38,37,16,16,4,4,176
62311213,24,27,30,36,37,15,6,5,180
62311214,8,8,11,4,4,1,3,0,39
62380101,36,42,43,38,21,6,4,3,193
62380102,37,59,39,29,17,7,4,2,194
62380103,78,92,65,72,30,13,3,3,356
62380104,82,97,68,51,49,10,4,1,362
62380105,94,103,68,53,28,10,1,5,362
62380106,71,64,43,39,20,6,1,3,247
62380107,95,82,78,78,43,30,7,7,420
62380108,63,64,48,37,19,2,2,1,236
62380109,59,85,51,37,25,2,2,1,262
62380110,73,88,76,56,26,11,2,3,335
62380111,50,58,46,38,19,11,3,2,227
62380112,41,62,50,50,25,12,8,4,252
62380113,24,44,34,34,14,6,3,4,163
62380114,38,35,32,29,15,4,2,1,156
62380201,34,53,59,45,32,14,4,4,245
62380202,98,112,67,64,38,10,6,3,398
62380203,77,105,70,39,26,11,0,0,328
62380204,76,61,28,18,8,4,1,0,196
62380205,68,73,38,37,19,4,1,2,242
62380206,65,73,61,46,18,8,3,0,274
62380207,74,117,80,53,47,24,4,4,403
62380208,61,100,68,63,26,15,2,1,336
62380209,63,111,54,51,20,9,5,1,314
62380210,33,50,47,49,22,13,7,7,228
62380211,14,15,20,17,6,9,4,5,90
62380212,45,72,65,71,49,24,4,6,336
62380213,27,32,37,33,14,7,1,2,153
62380214,30,26,40,35,22,14,7,2,176
62380215,2,6,3,4,3,2,0,0,20
62380301,26,20,20,16,12,6,0,0,100
62380302,7,8,3,6,1,0,0,0,25
62380401,6,5,7,6,4,1,0,0,29
62380501,11,17,6,10,3,2,1,1,51
62380601,25,29,27,22,10,8,3,7,131
62380602,6,10,22,36,3,7,1,3,88
62380603,35,42,39,38,27,15,8,3,207
62380604,34,40,65,67,24,21,8,1,260
62380605,2,0,4,2,0,1,0,0,9
62380606,6,7,1,2,2,0,0,0,18
62380607,8,14,9,6,5,1,0,0,43
62380608,0,2,1,1,0,0,0,0,4
62380609,16,28,26,26,18,16,5,5,140
62380610,6,6,2,1,0,0,0,1,16
62380611,33,44,30,47,13,12,2,2,183
62380701,13,10,15,7,3,3,0,0,51
62380702,10,16,9,6,2,2,0,0,45
62380801,1,12,2,6,1,0,0,0,22
62380901,16,10,5,6,3,2,1,0,43
62381001,3,3,2,0,0,0,0,0,8
62381101,8,10,1,5,3,0,0,0,27
62450101,69,100,93,74,40,18,6,4,404
62450102,69,93,75,71,28,28,7,5,376
62450103,75,122,78,89,28,23,2,3,420
62450104,58,78,53,47,18,15,1,0,270
62450105,57,96,73,72,32,14,4,3,351
62450106,80,91,83,79,50,26,8,7,424
62450107,64,82,41,41,20,7,1,3,259
62450108,63,74,64,55,20,10,2,2,290
62450109,60,72,53,49,19,7,0,2,262
62450110,63,77,56,65,31,14,2,3,311
62450111,51,86,66,54,31,12,1,0,301
62450201,61,90,66,78,53,29,10,8,395
62450202,31,52,55,57,22,16,11,4,248
62450203,25,47,44,29,18,16,5,2,186
62450204,37,54,51,47,18,11,1,0,219
62450205,53,100,76,62,54,17,5,5,372
62450206,75,96,96,111,59,26,15,16,494
62450207,81,115,80,74,24,15,5,3,397
62450208,54,76,71,69,24,12,1,2,309
62450209,56,86,66,71,50,15,4,8,356
62450210,34,50,45,32,17,6,1,1,186
62450211,68,86,86,102,70,39,15,22,488
62450212,58,76,75,86,56,30,16,20,417
62450213,41,52,57,49,33,22,10,6,270
62450214,29,62,63,61,32,13,4,3,267
62450215,29,47,33,56,42,19,7,9,242
62450301,60,93,54,59,32,9,2,3,312
62450302,56,103,86,59,41,21,11,5,382
62450303,73,95,71,66,31,16,5,9,366
62450304,86,94,98,103,41,45,13,21,501
62450305,53,85,72,88,51,40,20,14,423
62450306,67,83,73,72,58,28,8,16,405
62450307,60,68,50,52,29,9,1,3,272
62450308,38,64,60,60,20,5,7,5,259
62450309,61,73,87,75,41,33,12,10,392
62450310,35,60,77,73,36,24,7,5,317
62450311,34,50,65,68,52,28,8,12,317
62450401,40,49,45,29,19,18,6,4,210
62450402,31,34,20,21,17,14,6,2,145
62450403,46,56,44,45,35,18,6,6,256
62450404,38,40,50,52,22,22,4,7,235
62450405,49,53,49,46,18,7,5,5,232
62450406,54,36,32,27,12,16,8,6,191
62450407,51,75,53,41,22,19,4,7,272
62450408,14,38,28,42,14,3,0,0,139
62450409,41,40,49,37,31,13,12,8,231
62450410,42,40,39,45,28,19,9,11,233
62450411,8,8,8,5,6,3,2,1,41
62450412,18,16,20,12,9,4,1,2,82
62450413,34,40,55,48,31,20,4,4,236
62450414,10,35,21,24,7,2,1,0,100
62450415,55,70,88,92,64,48,19,17,453
62450416,21,30,23,32,12,2,1,0,121
62450417,26,23,16,14,4,6,2,1,92
62450418,19,30,26,21,15,13,2,4,130
62450501,56,60,66,53,38,18,5,6,302
62450502,47,52,39,30,18,13,5,2,206
62450503,38,41,46,42,23,13,4,5,212
62450504,60,53,57,55,28,12,6,7,278
62450505,113,122,111,93,60,19,5,6,529
62450506,2,0,1,0,0,0,0,0,3
62450507,18,16,8,3,6,2,0,1,54
62520101,16,16,35,31,17,12,9,11,147
62520102,32,45,56,61,42,21,10,7,274
62520103,24,26,27,39,23,25,6,6,176
62520104,47,77,85,88,59,37,21,28,442
62520105,33,62,87,82,59,39,13,19,394
62520106,40,70,124,106,70,51,14,18,493
62520107,62,116,114,126,67,30,16,12,543
62520108,77,119,134,88,57,21,9,19,524
62520109,63,80,34,39,20,11,2,2,251
62520110,39,54,33,26,11,2,0,0,165
62520111,59,69,45,38,19,4,1,1,236
62520112,54,101,86,104,45,15,4,4,413
62520113,72,96,74,51,24,16,1,1,335
62520114,46,62,53,48,27,14,10,7,267
62520115,37,83,57,73,35,12,10,3,310
62520201,24,28,20,20,11,1,0,0,104
62520202,19,45,22,33,13,9,0,0,141
62520203,19,42,41,54,28,12,0,2,198
62520204,32,70,51,52,17,7,1,1,231
62520205,19,38,23,32,15,5,0,1,133
62520206,11,35,36,29,13,4,1,1,130
62520207,17,29,33,53,22,11,4,4,173
62520208,14,13,17,16,3,4,2,0,69
62520209,31,57,66,81,62,55,9,26,387
62520210,29,58,43,44,30,11,2,1,218
62520211,37,62,54,61,30,18,4,6,272
62520212,19,48,45,39,22,7,3,5,188
62520213,30,68,56,50,27,17,2,3,253
62520214,43,70,57,53,34,16,8,6,287
62520215,38,81,95,98,49,23,20,26,430
62520216,19,50,63,58,45,31,12,13,291
62520217,44,53,56,61,33,30,8,9,294
62520301,13,9,6,6,10,4,2,2,52
62520302,11,21,16,30,4,2,1,0,85
62520303,20,22,30,24,9,5,0,2,112
62520304,38,43,54,48,23,15,5,6,232
62520305,41,70,80,87,70,41,19,37,445
62520306,39,71,81,93,47,23,13,12,379
62520307,13,17,18,15,8,10,1,1,83
62520308,16,17,17,23,9,4,1,1,88
62520309,35,49,50,44,17,3,5,1,204
62520401,43,62,69,72,50,27,10,14,347
62520402,61,71,87,81,50,36,11,13,410
62520403,21,44,35,35,26,11,2,3,177
62520404,42,66,54,56,33,9,3,2,265
62520405,51,74,71,63,37,15,2,6,319
62520406,54,68,51,37,21,8,3,2,244
62520407,39,61,51,44,18,7,0,5,225
62520408,78,86,107,107,56,29,5,7,475
62520409,55,90,104,103,84,49,13,11,509
62520410,19,70,53,56,28,13,6,3,248
62520411,2,4,9,10,1,4,0,1,31
62520412,47,114,100,105,77,53,14,25,535
62520413,40,65,67,115,50,19,1,0,357
62520501,82,130,79,66,26,13,3,0,399
62520502,76,84,54,38,7,3,1,0,263
62520503,91,109,71,57,18,8,3,0,357
62520504,126,120,83,72,22,6,1,4,434
62520505,95,86,50,39,12,5,0,1,288
62520506,47,66,46,32,6,8,2,0,207
62520507,67,131,97,90,45,16,7,2,455
62520508,87,113,104,92,39,21,9,7,472
62520509,55,86,75,87,40,22,4,9,378
62520601,17,34,50,47,42,34,8,7,239
62520602,1,2,0,0,0,0,0,0,3
62520603,5,20,20,22,10,8,1,3,89
62520604,24,48,53,52,26,13,7,5,228
62520605,40,64,62,65,41,30,13,12,327
62520606,38,79,52,57,42,16,3,4,291
62520607,3,10,5,9,3,2,4,1,37
62520608,6,7,3,6,1,2,0,0,25
62520609,8,4,9,6,8,1,2,2,40
62520610,8,8,10,4,2,3,0,1,36
62520611,16,21,21,32,11,9,1,1,112
62520612,29,33,29,36,18,7,0,2,154
62520613,27,43,42,44,9,8,2,10,185
62520614,27,31,48,39,25,13,10,6,199
62520701,35,68,82,75,47,19,5,4,335
62520702,47,61,81,82,56,24,8,15,374
62520703,47,71,87,104,46,34,15,16,420
62520704,46,79,100,102,67,45,10,10,459
62520705,39,50,109,111,68,62,18,25,482
62520706,57,69,87,121,99,72,20,41,566
62520707,25,49,72,75,68,40,12,11,352
62520708,52,84,81,99,44,37,17,19,433
62520709,53,74,56,60,20,20,4,1,288
62520710,33,44,57,69,30,17,7,5,262
62520711,66,76,112,106,55,29,7,15,466
62520801,4,11,9,14,10,6,0,6,60
62520802,47,72,85,102,68,46,14,31,465
62520803,53,64,89,83,61,35,22,18,425
62520804,50,57,85,77,55,59,16,17,416
62520805,41,47,68,86,72,53,13,21,401
62520806,67,104,97,81,38,14,6,8,415
62520807,49,69,69,65,34,13,6,8,313
62520808,30,58,52,65,41,12,6,10,274
62520809,6,15,14,29,14,5,0,2,85
62520810,19,48,35,29,16,9,0,1,157
62520901,73,126,163,240,127,66,18,28,841
62520902,47,72,89,108,75,46,33,31,501
62520903,49,63,95,91,73,50,19,15,455
62520904,50,62,85,78,55,44,18,35,427
62520905,62,54,88,76,59,33,10,30,412
62520906,36,46,75,69,52,25,15,19,337
62520907,40,58,72,66,35,36,11,13,331
62520908,34,48,58,49,31,18,4,3,245
62520909,35,61,71,69,38,15,13,8,310
62520910,42,84,86,84,42,36,11,14,399
62520911,56,82,108,101,61,49,17,19,493
62520912,43,57,74,90,60,56,18,16,414
62520913,58,81,101,137,102,76,36,46,637
62520914,45,89,107,99,79,50,17,18,504
62521001,25,46,22,46,23,7,0,3,172
62521002,2,19,5,10,4,1,0,1,42
62521003,26,77,65,77,47,30,7,11,340
62521004,23,69,64,96,49,20,10,12,343
62521005,16,40,36,72,41,12,0,1,218
62521006,42,62,73,66,45,23,5,6,322
62521007,18,49,61,65,43,28,9,13,286
62521008,19,15,51,33,43,34,9,14,218
62521009,35,59,66,79,41,24,4,9,317
62521010,16,57,63,106,49,18,1,1,311
62521011,41,45,59,75,45,41,17,16,339
62521012,43,50,60,78,81,33,16,27,388
62521013,38,70,87,115,64,34,6,11,425
62521014,24,48,44,73,25,6,1,4,225
62521015,24,69,41,40,13,8,3,1,199
62521016,34,55,78,70,35,39,9,10,330
62521017,10,51,62,54,15,8,2,3,205
62521101,47,56,69,50,28,9,3,2,264
62521102,81,132,110,70,39,21,5,11,469
62521103,56,55,53,38,23,6,1,2,234
62521104,76,109,77,57,32,14,0,1,366
62521105,63,110,107,84,36,24,5,5,434
62521106,28,64,78,56,32,16,3,4,281
62521107,44,84,56,63,37,14,5,4,307
62521108,13,26,18,26,11,2,0,1,97
62521109,20,42,35,35,21,9,2,2,166
62521110,54,66,67,78,33,23,4,3,328
62521201,25,53,60,76,55,45,15,21,350
62521202,46,103,120,106,61,51,9,24,520
62521203,44,68,100,93,53,38,8,24,428
62521204,40,86,91,106,67,46,13,24,473
62521205,57,101,114,107,61,31,16,18,505
62521206,58,65,76,72,44,24,13,8,360
62521207,58,67,80,79,67,42,12,15,420
62521208,27,43,68,69,51,38,19,25,340
62521301,27,56,45,46,25,15,6,3,223
62521302,35,66,68,83,48,30,13,27,370
62521303,61,75,79,70,51,33,7,11,387
62521304,50,54,66,75,33,26,7,8,319
62521305,47,68,77,70,51,30,11,7,361
62521306,33,60,71,67,40,27,7,13,318
62521307,38,49,56,48,25,11,3,3,233
62521308,32,58,50,56,27,15,8,5,251
62521309,37,63,51,44,23,8,4,3,233
62521310,44,41,53,47,19,9,2,4,219
62521311,33,59,84,68,29,13,4,3,293
62521312,40,57,72,83,36,23,13,8,332
62521401,29,39,73,70,67,36,9,17,340
62521402,52,77,98,84,48,53,7,12,431
62521403,54,66,91,91,76,63,21,39,501
62521404,39,44,56,47,42,47,16,18,309
62521405,18,29,61,54,29,16,5,2,214
62521406,30,38,35,44,20,31,11,12,221
62521407,31,59,52,64,50,33,8,13,310
62521408,66,87,102,111,57,33,12,24,492
62521409,47,74,94,56,25,24,8,8,336
62521410,42,76,62,63,35,8,8,6,300
62521411,36,68,61,57,40,15,4,12,293
62521412,28,48,77,87,53,67,10,25,395
62521413,51,71,104,144,95,59,33,33,590
62521414,31,48,59,65,66,35,10,13,327
62521415,23,44,71,47,39,24,10,8,266
62521416,41,57,60,48,44,23,12,9,294
62521417,43,65,65,72,26,13,3,5,292
62521418,24,63,53,67,38,18,11,10,284
62521419,49,63,86,79,62,44,16,13,412
62521501,2,1,0,0,0,0,1,0,4
62521502,1,1,0,0,0,0,0,0,2
62521503,37,65,66,82,54,39,6,2,351
62521504,43,75,95,88,61,48,6,10,426
62521505,49,57,73,86,55,24,9,9,362
62521506,44,66,66,76,67,33,18,22,392
62521507,43,65,76,90,56,36,14,14,394
62521508,33,67,78,79,68,50,16,28,419
62521509,51,73,77,85,51,46,13,15,411
62521510,34,40,31,46,30,11,1,1,194
62521511,31,59,78,93,59,36,9,15,380
62521512,26,76,113,116,91,36,19,15,492
62521513,55,58,34,46,37,11,6,1,248
62521514,57,98,94,86,48,17,10,11,421
62521515,64,116,131,122,77,30,22,17,579
62521601,46,40,28,31,17,9,2,2,175
62660101,2,3,1,2,0,0,0,0,8
62660102,20,15,14,14,4,3,0,0,70
62660103,5,4,5,12,2,3,0,0,31
62660104,22,10,7,8,7,6,2,0,62
62660201,5,2,2,4,0,2,0,0,15
62660202,10,8,12,5,1,1,1,0,38
62660203,8,8,3,3,2,2,0,0,26
62660204,17,39,66,64,46,40,18,19,309
62660205,20,25,28,35,10,4,1,2,125
62660301,40,57,56,70,45,25,6,5,304
62660302,60,86,57,45,24,7,3,3,285
62660303,47,54,65,54,24,15,9,6,274
62660304,39,51,33,39,15,12,4,9,202
62660305,13,17,28,30,14,9,1,2,114
62660306,47,41,30,26,13,6,1,2,166
62660307,41,56,34,27,17,5,1,5,186
62660308,43,45,26,22,14,6,2,1,159
62660309,61,49,38,35,9,3,0,2,197
62660310,54,67,57,52,30,17,1,1,279
62660311,50,51,59,55,28,16,4,8,271
62660312,9,6,4,4,2,0,1,0,26
62660401,6,10,8,9,5,8,3,4,53
62660402,0,1,1,0,1,1,0,1,5
62660403,17,12,13,30,9,5,1,3,90
62660501,66,98,79,72,43,26,15,13,412
62660502,35,22,36,35,25,9,10,5,177
62660503,24,25,28,27,21,8,4,2,139
62660504,12,14,15,15,5,6,1,0,68
62660505,14,19,10,5,3,3,0,0,54
62660506,6,20,12,15,11,10,2,0,76
62660507,10,13,3,8,3,2,0,0,39
62660508,38,50,45,46,20,16,5,3,223
62660509,13,24,13,15,6,2,2,0,75
62660601,26,36,25,19,14,12,4,6,142
62660602,42,51,48,48,22,7,3,2,223
62660603,21,29,24,21,13,2,2,1,113
62660604,16,29,13,11,2,4,0,2,77
62660605,25,29,15,20,8,6,1,1,105
62660606,19,25,10,4,1,0,0,2,61
62660607,17,18,10,10,5,4,1,0,65
62660608,20,44,15,12,10,1,0,0,102
62660609,29,33,37,39,22,26,3,7,196
62660610,10,41,36,39,13,10,1,1,151
62660611,12,29,27,25,17,3,1,0,114
62660612,9,27,19,34,15,10,0,1,115
62660701,26,42,60,61,23,22,4,7,245
62660702,51,62,60,50,34,18,5,3,283
62660703,62,81,81,83,67,38,10,7,429
62660704,31,22,19,15,14,4,0,2,107
62660705,69,76,91,88,60,47,15,12,458
62660706,9,21,24,12,7,3,2,2,80
62660707,47,83,56,39,18,6,4,4,257
62660708,47,53,80,64,46,28,7,15,340
62660709,76,78,95,92,32,19,9,2,403
62660710,43,61,56,65,31,26,17,19,318
62660711,19,26,34,34,19,13,6,8,159
62770101,2,1,1,0,0,0,0,0,4
62770102,27,32,24,28,3,3,0,3,120
62770103,23,30,18,27,7,3,3,2,113
62770104,2,5,5,8,1,0,1,0,22
62770105,3,1,2,0,0,0,0,1,7
62770106,12,15,6,6,5,1,0,0,45
62770107,52,61,59,37,35,10,3,3,260
62770108,34,40,42,48,30,18,9,7,228
62770109,40,37,41,44,24,19,7,1,213
62770110,37,53,47,57,30,15,0,4,243
62770111,108,120,75,58,27,24,7,10,429
62770112,56,90,36,18,11,4,4,0,219
62770113,75,78,37,39,17,6,5,2,259
62770114,50,69,44,35,12,9,8,2,229
62770115,49,75,73,66,25,12,1,2,303
62770116,3,9,2,4,2,0,0,0,20
62770201,10,4,6,5,0,2,1,3,31
62770202,16,25,21,18,7,6,3,3,99
62770203,5,8,9,3,1,3,0,0,29
62770204,13,18,21,7,5,2,1,1,68
62770205,1,5,2,1,1,1,0,0,11
62770206,12,7,3,9,1,1,1,0,34
62800101,27,25,35,37,31,19,3,3,180
62800102,24,23,37,39,32,17,2,3,177
62800103,35,31,35,35,27,16,3,2,184
62800104,33,39,55,42,26,27,3,5,230
62800105,19,23,28,26,25,11,5,8,145
62800106,16,29,13,22,26,25,2,4,137
62800107,17,30,45,56,54,38,8,6,254
62800108,10,18,26,33,39,25,3,8,162
62800109,20,22,27,24,14,8,5,9,129
62800110,22,31,38,32,24,14,4,6,171
62800201,52,56,48,56,34,46,4,6,302
62800202,42,67,32,40,34,14,1,1,231
62800203,41,61,31,32,8,4,0,0,177
62800204,38,65,42,42,30,15,3,6,241
62800205,43,91,75,70,40,19,3,1,342
62800206,51,67,47,47,22,5,3,2,244
62800207,86,83,53,45,17,4,2,0,290
62800208,66,53,20,17,10,2,1,0,169
62800301,16,16,4,6,11,3,0,0,56
62800302,9,17,6,4,5,9,0,0,50
62800303,16,20,6,9,6,5,0,0,62
62800304,12,20,11,6,6,1,0,0,56
62800305,22,24,7,15,8,7,0,0,83
62800306,12,11,6,6,4,11,0,0,50
62800307,26,25,12,16,9,2,0,0,90
62800308,14,8,8,12,5,1,0,0,48
62800309,19,11,8,3,4,1,0,0,46
62800310,20,11,10,10,1,0,0,0,52
62800311,14,13,7,2,1,0,0,0,37
62800312,9,15,0,2,1,1,0,0,28
62800313,10,12,2,4,1,0,0,0,29
62800401,53,79,53,37,19,5,4,0,250
62800402,13,17,11,9,3,3,0,0,56
62800403,14,12,4,4,1,0,0,0,35
62800404,6,6,0,0,1,0,0,0,13
62800405,12,10,9,8,4,2,0,0,45
62800406,24,29,14,24,9,2,0,1,103
62800407,16,14,13,13,6,5,1,1,69
62800408,18,18,22,11,15,7,3,2,96
62800409,26,21,18,39,9,10,3,1,127
62800410,24,21,16,28,7,2,1,0,99
62800501,4,1,1,0,0,0,0,1,7
62800502,3,2,3,3,2,0,0,0,13
62800503,3,0,2,1,1,0,0,0,7
62800504,3,0,0,0,0,0,0,0,3
62800505,4,4,1,0,0,0,0,0,9
62800506,5,3,1,1,1,1,0,0,12
62800507,2,0,1,2,1,0,1,1,8
62800508,4,5,5,1,1,0,1,2,19
62800509,1,2,3,1,0,0,0,0,7
62800601,1,1,1,1,1,0,0,0,5
62800602,2,0,3,0,2,0,0,0,7
62800603,8,9,6,4,4,0,0,2,33
62800604,7,12,1,1,3,0,0,0,24
62800605,3,4,1,3,1,0,0,0,12
62800606,39,56,38,36,10,13,2,1,195
62800607,13,13,20,11,7,2,0,2,68
62800608,18,25,29,24,11,6,3,0,116
62800609,6,13,8,11,1,2,0,0,41
62800610,15,26,27,22,19,13,3,3,128
62800611,8,19,17,12,9,1,2,5,73
62800612,14,12,5,5,3,0,0,0,39
62800613,5,6,7,4,1,0,2,1,26
62800614,6,13,7,4,1,2,0,0,33
62800615,3,12,10,6,6,3,4,0,44
62800616,6,12,8,5,2,1,0,0,34
62800617,5,9,8,3,1,0,0,0,26
62800701,1,4,1,2,1,1,0,0,10
62800702,3,3,1,2,0,0,0,0,9
62800703,3,9,2,4,1,1,1,0,21
62800704,13,11,8,15,5,0,0,2,54
62800705,6,2,2,3,2,1,0,2,18
62800706,2,5,5,1,2,0,0,0,15
62800707,2,6,2,0,0,0,0,0,10
62800708,5,8,2,3,2,3,0,0,23
62800709,5,5,2,3,2,2,0,0,19
62800710,3,2,2,1,0,1,0,1,10
62800711,2,6,2,0,1,0,0,0,11
62800801,28,29,16,16,2,3,1,2,97
62800802,0,1,1,1,1,0,0,0,4
62800803,1,3,0,1,0,0,0,0,5
62800804,2,1,0,1,0,0,1,0,5
62800805,0,2,0,1,0,0,0,0,3
62800806,1,3,1,2,0,0,0,0,7
62800807,5,2,4,1,1,0,0,0,13
62800808,3,3,0,0,0,0,0,0,6
62800809,4,3,4,4,2,0,0,0,17
62800810,2,6,0,1,0,0,0,0,9
62800811,4,1,0,3,0,0,0,0,8
62800812,5,4,2,3,1,0,0,0,15
62800813,3,4,1,1,2,0,0,0,11
62800814,2,3,1,0,1,0,0,0,7
62800815,3,2,5,2,1,1,0,0,14
62800816,9,8,6,4,8,1,1,1,38
62800817,1,4,3,1,0,0,0,1,10
62800818,1,0,2,0,1,0,0,0,4
62800819,34,71,40,37,16,11,3,4,216
62800820,18,28,20,13,10,4,2,4,99
62800901,9,13,5,3,4,1,0,1,36
62800902,6,2,2,1,1,0,0,0,12
62800903,2,2,0,0,1,0,0,0,5
62800904,1,6,1,2,1,0,0,0,11
62800905,2,7,4,2,1,0,1,0,17
62800906,3,7,2,5,4,1,0,0,22
62800907,0,2,1,2,0,0,1,0,6
62800908,2,2,2,4,0,1,0,0,11
62800909,8,9,7,11,4,2,0,0,41
62800910,4,4,0,0,1,1,0,0,10
62800911,5,3,3,0,0,0,0,0,11
62800912,10,20,8,12,5,2,0,0,57
62801001,52,69,39,24,13,1,2,0,200
62801002,38,52,47,32,22,3,1,2,197
62801003,21,19,14,13,7,3,1,1,79
62801004,35,40,18,17,6,2,0,0,118
62801005,34,30,13,11,7,0,0,0,95
62801006,8,11,6,3,2,0,0,0,30
62801007,16,27,7,11,3,0,0,0,64
62801008,36,37,18,15,9,9,1,0,125
62801101,37,61,36,50,27,16,5,6,238
62801102,55,74,61,52,37,10,7,3,299
62801103,77,93,85,57,28,17,2,4,363
62801104,27,43,28,27,9,7,1,0,142
62801105,40,61,33,23,13,2,1,1,174
62801106,33,53,33,37,8,7,3,2,176
62801107,30,43,38,28,6,7,0,1,153
62801108,19,38,40,32,20,15,4,2,170
62801109,44,50,45,31,29,10,3,2,214
62801110,24,25,25,29,18,9,3,1,134
62801111,19,23,43,33,18,9,4,4,153
62801112,20,26,37,30,9,6,4,5,137
62801201,12,6,9,3,3,5,0,1,39
62801202,7,2,6,6,6,3,0,0,30
62801203,0,1,2,0,0,0,0,0,3
62801204,7,6,8,4,3,1,0,0,29
62801205,67,105,91,88,55,20,8,4,438
62801206,66,79,70,51,41,13,9,7,336
62801207,64,76,81,68,53,39,6,5,392
62801208,84,76,91,84,57,25,21,20,458
62801209,33,39,42,38,21,7,7,5,192
62801210,35,43,30,38,26,15,6,0,193
62870101,23,28,14,13,10,2,0,1,91
62870201,19,13,11,9,5,0,0,0,57
62870301,5,1,0,2,1,0,0,0,9
62870302,3,5,1,2,2,0,1,0,14
62870401,10,16,14,10,7,3,2,4,66
62870402,2,2,1,2,1,1,0,0,9
62870403,19,23,13,19,9,6,0,2,91
62870404,32,26,46,34,21,13,2,4,178
62870405,76,79,55,41,23,13,4,0,291
62870406,44,70,34,34,13,3,1,0,199
62870407,54,71,59,33,20,8,2,1,248
62870408,34,43,47,32,23,16,5,5,205
62870409,26,32,21,22,12,5,3,3,124
62870410,33,37,21,25,9,3,4,0,132
62870411,73,65,57,38,24,9,4,1,271
62870412,51,64,30,29,9,5,2,0,190
62870413,82,92,73,53,27,14,5,4,350
62870414,50,62,42,38,24,2,4,1,223
62870415,31,42,56,71,50,15,7,7,279
62870416,6,8,6,1,6,0,0,1,28
62870417,5,1,0,1,0,0,0,0,7
62870501,9,5,4,5,4,0,0,0,27
62870502,11,22,10,7,4,5,1,0,60
62870601,8,14,12,16,11,3,2,0,66
62870701,12,8,11,9,3,1,0,1,45
62870702,18,11,8,3,4,1,2,1,48
62940101,5,1,2,1,0,0,0,0,9
62940102,0,0,0,1,0,1,0,0,2
62940103,0,0,0,0,0,0,0,0,0
62940201,3,2,0,1,0,0,0,0,6
62940202,19,22,21,16,9,6,3,2,98
62940203,81,88,84,71,45,12,1,1,383
62940204,89,93,62,65,19,4,1,3,336
62940205,5,6,1,5,2,1,0,0,20
62940206,2,1,1,1,2,0,1,0,8
62940207,1,4,1,0,2,0,0,0,8
62940208,0,1,0,0,0,0,0,0,1
62940209,2,1,6,0,2,0,0,0,11
62940210,1,6,1,1,0,0,0,1,10
62940211,24,23,21,17,5,3,3,0,96
62940301,3,3,3,0,0,1,0,0,10
62940302,0,4,1,0,0,0,0,0,5
62940303,4,1,1,1,0,0,0,0,7
62940401,48,55,40,57,18,6,4,5,233
62940402,87,89,57,60,23,11,1,3,331
62940403,81,123,93,52,27,9,2,2,389
62940404,31,52,28,33,14,2,1,1,162
62940405,10,7,7,9,4,1,0,0,38
62940406,7,13,11,12,7,2,0,0,52
62940407,2,5,1,0,1,0,0,0,9
62940408,54,74,67,68,26,9,3,4,305
62940501,4,7,5,5,2,1,3,0,27
62940502,1,2,0,2,0,0,0,0,5
62940503,1,2,1,1,0,0,0,0,5
62940504,0,3,1,0,0,0,0,0,4
62940505,2,1,2,4,1,3,0,0,13
62940506,5,8,6,4,3,0,0,0,26
62940601,52,80,56,56,12,5,1,1,263
62940602,42,39,28,22,10,4,1,0,146
62940603,62,67,36,33,12,4,0,2,216
62940604,32,29,23,25,12,5,4,1,131
62940605,1,1,0,2,0,0,0,0,4
62940606,4,3,5,3,2,0,0,0,17
62940607,3,3,4,2,3,0,0,0,15
62940608,12,16,16,12,9,5,1,0,71
62940609,26,32,28,22,8,7,0,0,123
62940610,33,41,20,17,15,4,1,2,133
62940701,3,4,0,0,0,0,0,0,7
62940702,4,2,3,2,1,0,0,0,12
62940703,3,1,1,2,0,0,0,0,7
62940704,0,3,2,1,0,2,0,0,8
62940705,3,1,3,1,1,0,0,0,9
62940706,0,0,0,0,0,0,0,0,0
62940801,16,17,13,12,2,3,0,1,64
62940802,51,54,46,46,7,2,0,0,206
62940803,52,59,34,32,14,5,2,1,199
62940804,40,35,23,16,7,4,0,1,126
62940805,40,47,26,19,8,3,0,0,143
62940806,51,42,32,25,6,6,0,0,162
62940807,29,62,48,46,20,7,6,0,218
62940808,53,65,52,41,23,7,4,3,248
62940809,11,9,12,12,6,5,0,1,56
62940810,18,22,23,20,14,4,4,3,108
62940811,0,1,1,0,1,0,0,0,3
62940812,0,0,1,2,0,0,0,0,3
62940813,0,0,1,0,0,0,0,0,1
62940814,1,3,0,1,1,1,0,0,7
62940815,2,7,2,1,0,0,0,0,12
63010101,54,44,35,28,14,13,4,3,195
63010201,13,14,9,4,6,1,1,0,48
63010301,15,11,10,5,2,1,0,0,44
63010401,12,14,18,9,7,0,0,0,60
63010501,1,1,0,0,2,1,0,0,5
63010502,6,19,7,13,5,4,0,1,55
63010503,6,5,6,6,3,2,0,1,29
63010504,39,43,57,45,19,9,5,2,219
63010505,46,55,51,24,20,15,4,7,222
63010506,57,55,40,36,20,9,3,2,222
63010507,39,45,39,33,17,8,3,3,187
63010508,61,63,52,49,15,3,3,0,246
63010509,61,59,53,53,20,7,2,4,259
63010510,57,67,43,50,13,9,2,1,242
63010511,101,74,51,38,17,3,2,1,287
63010512,74,105,66,53,27,8,3,1,337
63010513,71,111,81,48,55,19,4,12,401
63010514,28,40,37,39,25,9,5,5,188
63010601,26,12,8,17,6,6,1,2,78
63010701,18,17,16,12,8,4,3,0,78
63010801,15,21,16,18,10,5,3,3,91
63010802,8,12,1,8,7,4,1,0,41
63010803,13,18,13,5,1,6,0,1,57
63010804,10,24,14,7,0,0,0,0,55
63010805,34,56,43,26,20,4,4,4,191
63010806,68,78,55,44,15,13,1,2,276
63010807,20,36,21,19,14,7,0,0,117
63010808,64,99,49,42,16,8,1,2,281
63010809,82,64,38,38,13,10,1,2,248
63010810,31,33,37,23,13,4,4,1,146
63010811,67,91,51,44,19,3,4,1,280
63010812,80,98,71,55,31,13,9,1,358
63010813,38,59,49,48,24,10,3,3,234
63010814,54,53,47,31,16,9,9,3,222
63010815,1,5,2,1,0,0,0,0,9
63080101,7,5,1,1,2,2,1,0,19
63080201,4,3,2,3,3,1,0,0,16
63080301,7,8,3,7,2,0,0,0,27
63080401,6,2,6,5,5,0,0,0,24
63080501,22,25,23,13,8,5,5,0,101
63080502,19,20,15,20,5,5,0,1,85
63080601,40,45,12,19,12,1,1,1,131
63080602,36,39,21,20,13,7,3,4,143
63080603,7,9,4,3,3,3,1,1,31
63080604,2,1,0,1,0,0,0,0,4
63080701,9,9,4,3,0,2,0,1,28
63080801,3,2,5,1,1,0,0,0,12
63080901,11,10,6,6,2,0,0,0,35
63081001,21,6,7,3,0,2,0,0,39
63081002,82,58,49,38,29,21,5,1,283
63081003,7,8,5,2,0,5,0,0,27
63150101,50,54,44,43,27,8,3,5,234
63150102,89,90,91,57,40,11,5,3,386
63150103,28,39,39,21,22,18,5,8,180
63150104,91,82,76,31,22,10,3,0,315
63150105,87,92,57,52,18,9,4,2,321
63150106,64,79,70,49,29,14,1,5,311
63150107,21,53,37,45,21,10,6,7,200
63150108,38,39,40,42,34,24,4,6,227
63150109,77,98,74,67,32,12,2,6,368
63150110,96,113,67,53,26,16,4,1,376
63150111,102,101,96,85,42,11,7,9,453
63150112,50,61,51,61,36,28,7,10,304
63150113,56,86,56,58,35,28,8,6,333
63150114,60,67,72,85,42,22,14,10,372
63150115,36,55,42,61,30,21,10,6,261
63150116,35,39,47,38,17,16,5,2,199
63150117,27,32,34,35,25,26,4,11,194
63150118,41,59,63,59,42,16,6,3,289
63150201,14,18,9,6,4,3,1,1,56
63150301,44,53,48,53,25,16,5,17,261
63150302,22,21,15,14,14,9,5,5,105
63150303,35,24,25,24,16,13,2,4,143
63150401,32,25,8,11,5,3,0,0,84
63150501,22,25,13,9,4,4,1,0,78
63150502,33,28,20,23,13,3,0,2,122
63150601,38,27,18,21,11,4,0,3,122
63150701,12,16,5,3,2,0,0,0,38
63220101,0,1,0,1,0,0,0,0,2
63220102,1,1,1,0,0,0,0,0,3
63220103,4,2,1,2,2,0,0,0,11
63220201,6,2,2,3,1,1,0,1,16
63220202,1,3,0,0,2,0,0,0,6
63220203,0,1,1,2,0,0,0,0,4
63220204,0,4,1,0,2,0,0,0,7
63220301,10,20,22,26,13,5,1,0,97
63220302,7,5,2,4,0,1,0,0,19
63220303,2,1,0,0,0,1,0,0,4
63220304,2,6,1,6,2,1,0,0,18
63220305,1,2,4,4,0,2,0,0,13
63220306,1,5,1,1,1,1,0,1,11
63220307,31,43,17,20,11,0,2,1,125
63220401,0,3,1,1,1,0,0,0,6
63220402,1,2,1,2,0,0,0,0,6
63220403,5,2,1,1,1,0,0,0,10
63220404,3,2,1,0,0,0,0,0,6
63220405,2,1,1,0,1,0,0,0,5
63220501,3,5,2,0,0,0,0,0,10
63220502,6,4,0,0,0,0,0,0,10
63220503,4,2,2,0,1,0,0,0,9
63220504,2,0,1,1,0,0,0,0,4
63220505,2,4,1,2,2,0,0,0,11
63220601,87,85,92,60,31,18,9,6,388
63220602,74,93,49,37,14,4,0,1,272
63220603,71,56,33,21,7,2,1,0,191
63220604,44,64,43,25,13,7,1,0,197
63220605,72,58,40,17,16,4,3,2,212
63220606,41,33,30,20,8,6,2,0,140
63220607,37,43,45,33,19,8,4,5,194
63220608,7,7,5,4,2,2,0,1,28
63220609,1,1,1,0,2,0,0,0,5
63220610,1,0,0,0,0,0,0,0,1
63220611,8,9,12,11,8,2,0,3,53
63220612,38,63,50,44,24,18,4,3,244
63220613,17,34,39,34,13,1,2,2,142
63220614,30,42,33,40,22,4,4,2,177
63220615,30,51,27,13,13,7,2,3,146
63220616,34,51,43,34,16,2,5,3,188
63220617,28,51,74,52,26,15,6,3,255
63220701,26,13,11,7,5,6,0,0,68
63220702,5,5,2,2,1,0,1,0,16
63220703,5,2,0,7,1,1,1,0,17
63220704,1,2,2,0,1,0,0,0,6
63220705,4,5,1,0,0,0,0,0,10
63220801,3,1,1,2,0,1,0,0,8
63220802,3,1,1,1,0,1,1,0,8
63220803,9,2,2,0,2,0,1,0,16
63220901,3,4,3,4,2,1,0,0,17
63220902,1,1,3,3,1,1,0,0,10
63220903,3,1,1,0,0,0,0,0,5
63221001,28,33,24,16,6,3,2,0,112
63221002,9,5,3,4,2,1,0,1,25
63221003,3,3,0,3,0,0,0,0,9
63221004,4,10,4,4,0,2,0,0,24
63221005,6,4,4,6,1,1,0,0,22
63221006,2,2,2,2,1,0,0,0,9
63221007,16,7,8,9,1,1,2,0,44
63221008,9,1,1,4,0,1,0,0,16
63221101,3,2,1,3,1,1,0,0,11
63221102,5,2,2,1,0,2,0,0,12
63221103,2,4,1,2,1,0,0,0,10
63221201,4,2,1,0,2,1,0,0,10
63221202,1,0,1,2,0,0,0,0,4
63221203,2,5,0,0,0,0,0,0,7
63221301,1,0,3,0,2,0,0,0,6
63221302,3,2,2,1,1,0,0,0,9
63221303,0,7,3,0,1,1,0,0,12
63221304,2,1,4,0,0,0,1,0,8
63290101,3,5,4,1,1,0,1,0,15
63290102,7,11,5,3,3,5,1,1,36
63290103,5,8,4,5,0,2,0,0,24
63290104,7,5,8,0,2,1,0,0,23
63290201,5,15,17,12,4,5,2,0,60
63290202,3,4,1,4,2,2,0,2,18
63290203,3,2,5,10,5,4,1,0,30
63290301,5,8,4,2,7,2,4,1,33
63290302,7,10,5,10,5,4,1,2,44
63290303,6,9,10,20,8,7,1,3,64
63290304,44,45,47,57,33,16,2,3,247
63290305,46,57,59,59,31,28,10,14,304
63290306,22,47,53,37,22,17,9,10,217
63290307,25,27,27,34,19,10,4,7,153
63290308,53,76,56,55,46,17,9,6,318
63290309,38,64,56,52,22,10,4,5,251
63290310,55,78,63,58,25,15,6,7,307
63290311,79,77,59,61,35,8,6,3,328
63290312,99,86,64,47,25,8,2,1,332
63290313,39,61,34,32,19,3,1,1,190
63290314,32,39,44,39,22,12,2,2,192
63290315,37,60,70,64,41,17,3,2,294
63290316,28,56,59,66,26,11,9,9,264
63290317,29,24,28,32,16,8,3,7,147
63290401,4,4,7,6,3,4,1,3,32
63290402,21,9,14,12,10,4,1,1,72
63290403,14,21,16,12,10,3,1,3,80
63290501,17,39,9,19,7,2,1,1,95
63290502,39,18,15,11,8,7,1,2,101
63290503,6,8,10,3,4,4,0,1,36
63290504,4,3,5,8,3,1,0,1,25
63290505,20,27,25,14,9,4,7,6,112
63290506,26,38,28,28,18,10,6,2,156
63290601,5,3,6,5,1,4,0,1,25
63290602,2,4,0,5,4,1,0,0,16
63360101,9,10,4,5,3,3,0,1,35
63360201,26,46,37,31,20,9,3,3,175
63360202,23,38,34,29,17,3,1,4,149
63360203,8,18,17,25,13,2,4,2,89
63360204,3,4,1,2,2,1,0,1,14
63360205,16,38,22,28,10,9,1,2,126
63360301,10,5,4,3,1,3,1,0,27
63360401,7,5,1,3,0,0,0,0,16
63360501,24,33,19,24,10,3,3,0,116
63360601,5,1,4,4,3,1,0,1,19
63360701,12,19,10,9,6,3,3,0,62
63360801,14,13,7,5,6,0,0,0,45
63360901,13,10,4,3,2,1,0,0,33
63361001,14,24,25,28,7,13,5,7,123
63361002,32,37,25,26,14,7,3,3,147
63430101,65,54,44,36,20,9,3,3,234
63430102,7,6,7,3,4,1,0,0,28
63430103,12,12,14,14,7,5,1,1,66
63430104,5,2,6,5,2,1,0,0,21
63430105,4,8,1,4,3,2,3,0,25
63430201,12,11,4,7,7,2,0,1,44
63430301,8,9,5,2,3,2,1,0,30
63430302,4,3,3,2,2,2,0,0,16
63430303,3,8,3,4,1,0,0,0,19
63430401,5,3,6,10,3,0,0,0,27
63430402,6,6,7,3,5,2,1,0,30
63430501,2,4,5,1,1,2,1,0,16
63430502,5,5,4,4,2,0,0,0,20
63430503,7,9,7,4,2,3,0,0,32
63430601,48,51,19,38,13,8,4,2,183
63430602,29,31,7,12,12,3,2,1,97
63430603,2,6,6,6,2,1,1,1,25
63430604,2,2,2,4,0,0,1,0,11
63430605,4,5,1,2,4,1,0,0,17
63430606,1,0,1,0,2,0,0,0,4
63430701,22,22,18,10,8,14,6,1,101
63430702,27,32,36,37,27,14,4,2,179
63430703,66,64,56,48,24,13,2,4,277
63430704,32,36,23,24,11,7,2,1,136
63430705,37,69,54,39,22,10,4,1,236
63430706,59,66,47,43,24,13,3,8,263
63430707,63,69,41,33,28,13,2,4,253
63430708,38,34,29,34,14,10,3,2,164
63430709,85,92,55,44,15,15,2,1,309
63430710,73,109,51,58,29,12,3,5,340
63430711,40,51,41,36,23,10,9,5,215
63430712,40,40,35,31,21,8,5,2,182
63430713,37,38,27,17,22,4,2,1,148
63430801,8,1,3,2,1,1,0,0,16
63430802,5,2,5,2,1,2,1,0,18
63510101,2,2,3,1,3,0,0,1,12
63510102,28,33,27,23,15,7,2,0,135
63510103,26,43,24,24,12,6,4,1,140
63510104,1,6,3,1,0,0,0,0,11
63510201,10,3,8,13,14,0,2,0,50
63510202,5,1,4,6,3,3,0,0,22
63510301,9,3,3,1,2,0,0,0,18
63510302,0,2,2,2,1,0,0,0,7
63510303,0,1,2,1,0,0,0,0,4
63510304,4,3,3,2,0,0,1,0,13
63510401,45,43,39,36,25,10,5,2,205
63510402,2,8,0,0,2,0,0,1,13
63510403,5,3,3,1,2,3,0,1,18
63510404,4,4,4,3,0,1,1,0,17
63510405,3,2,2,2,2,3,0,1,15
63510406,69,84,65,36,28,6,2,0,290
63510501,2,3,5,0,3,1,0,1,15
63510502,0,1,3,1,0,0,0,1,6
63510601,31,41,35,18,16,8,3,5,157
63510602,21,28,22,15,10,3,1,1,101
63510603,64,99,61,50,23,7,5,3,312
63510604,93,110,76,41,30,17,1,3,371
63510605,29,44,65,64,27,17,3,4,253
63510606,87,110,70,44,33,7,5,1,357
63510607,97,117,51,48,21,4,0,2,340
63510608,23,25,15,15,8,6,2,3,97
63510609,1,0,1,0,0,0,0,0,2
63510610,3,1,0,0,0,0,0,0,4
63510611,3,1,3,1,0,0,0,1,9
63510612,1,0,0,1,0,2,0,0,4
63510613,3,5,1,4,1,1,0,0,15
63510614,3,3,0,2,2,1,0,0,11
63510615,35,38,61,63,39,23,7,9,275
63510701,1,4,6,4,0,1,0,0,16
63510702,0,3,3,4,2,1,0,0,13
63510703,1,6,0,2,0,0,0,0,9
63510801,4,4,1,5,4,3,0,0,21
63510802,1,6,2,2,0,0,0,0,11
63510803,6,6,7,3,2,0,1,1,26
63510901,107,110,71,69,33,16,3,3,412
63510902,1,3,2,1,1,0,0,0,8
63510903,9,10,9,10,4,1,1,1,45
63511001,2,1,1,3,0,0,0,0,7
63511002,3,1,2,2,0,1,0,0,9
63511003,2,4,3,2,1,0,0,0,12
63570101,33,56,56,53,31,26,4,1,260
63570102,38,95,76,63,35,10,6,3,326
63570103,50,71,82,70,58,12,8,8,359
63570104,54,80,84,103,37,13,3,1,375
63570105,37,108,78,62,44,11,4,0,344
63570106,33,71,68,47,17,6,1,4,247
63570107,38,74,65,57,9,11,0,1,255
63570108,30,81,73,104,34,15,3,1,341
63570109,21,51,51,76,38,12,2,4,255
63570201,38,62,70,65,23,20,8,1,287
63570202,26,59,57,62,43,8,2,1,258
63570203,26,65,64,68,30,8,4,2,267
63570204,37,87,84,84,30,11,8,2,343
63570205,29,58,77,69,30,6,0,1,270
63570206,31,68,61,81,26,8,1,0,276
63570207,25,51,53,54,20,5,4,1,213
63570208,23,49,48,51,14,6,0,0,191
63570209,29,71,68,67,33,9,1,3,281
63570210,36,49,56,61,26,12,2,2,244
63570301,25,42,37,29,5,7,2,0,147
63570302,18,53,38,35,18,5,2,2,171
63570303,30,42,21,21,12,2,0,1,129
63570304,31,42,47,42,29,8,5,5,209
63570305,29,55,50,51,27,10,5,0,227
63570306,46,73,72,83,37,11,3,2,327
63570307,52,86,66,52,22,3,0,1,282
63570308,61,89,70,82,30,8,1,2,343
63570309,40,78,87,115,30,10,3,0,363
63570310,39,62,61,85,39,2,2,0,290
63570311,35,91,87,81,42,16,2,1,355
63570401,42,54,66,54,12,2,0,1,231
63570402,40,63,31,21,11,2,3,0,171
63570403,39,48,34,32,7,0,0,1,161
63570404,21,56,36,27,16,3,1,0,160
63570405,24,49,32,31,14,3,1,0,154
63570406,21,61,42,40,17,5,1,0,187
63570407,53,69,63,55,18,5,3,0,266
63570408,36,100,66,65,25,8,4,0,304
63570409,25,70,46,61,15,9,1,1,228
63570410,49,79,44,37,8,5,1,0,223
63570501,49,99,70,109,30,12,0,1,370
63570502,40,82,76,86,43,11,1,1,340
63570503,39,88,45,52,21,6,0,0,251
63570504,40,85,47,42,26,2,2,0,244
63570505,36,56,37,37,15,7,2,1,191
63570506,41,67,45,55,20,7,2,0,237
63570507,23,50,48,44,15,2,1,0,183
63570508,28,60,37,46,18,5,2,0,196
63570509,49,101,73,77,26,8,3,1,338
63570510,41,89,70,66,30,9,1,0,306
63570511,37,60,38,25,8,2,0,1,171
63570512,40,62,37,22,24,6,0,0,191
63570513,23,49,42,26,2,4,1,0,147
63570514,23,34,19,32,4,3,1,0,116
63570601,48,82,54,71,29,8,10,5,307
63570602,48,64,57,38,31,17,0,6,261
63570603,35,74,50,52,21,13,2,0,247
63570604,61,87,92,74,39,20,5,3,381
63570605,37,67,71,44,25,9,3,4,260
63570606,41,74,44,42,21,4,7,3,236
63570607,63,97,98,55,17,2,0,1,333
63570608,64,85,68,83,29,7,4,0,340
63570609,51,95,83,104,26,7,3,4,373
63570610,48,81,71,63,30,18,1,1,313
63570611,47,92,56,66,22,7,0,0,290
63570701,72,74,56,48,23,12,1,1,287
63570702,54,75,81,91,31,9,1,4,346
63570703,24,58,60,76,28,13,1,1,261
63570704,18,62,63,104,44,14,2,0,307
63570705,47,77,83,99,45,16,4,8,379
63570706,46,94,64,73,43,17,3,3,343
63570707,49,68,59,53,34,13,2,4,282
63570708,51,57,55,53,30,17,3,2,268
63570709,59,103,86,99,48,18,5,6,424
63570710,53,73,68,56,32,19,2,5,308
63570711,30,61,44,44,28,17,9,8,241
63570801,64,78,65,69,51,29,6,8,370
63570802,44,58,54,61,37,17,8,2,281
63570803,26,50,44,42,22,15,2,3,204
63570804,27,60,65,59,25,10,2,1,249
63570805,65,74,69,51,37,15,5,4,320
63570806,34,77,52,56,27,15,2,3,266
63570807,46,78,78,72,24,16,3,3,320
63570808,48,74,51,59,23,5,1,1,262
63570809,54,96,99,61,27,9,2,2,350
63570810,70,89,96,75,28,9,0,3,370
63570811,55,121,66,72,41,11,2,3,371
63570812,60,89,86,59,31,20,7,4,356
63570813,32,61,43,50,19,7,0,1,213
63570814,24,42,38,22,10,10,4,0,150
63570901,55,88,92,99,52,24,9,7,426
63570902,40,57,56,54,43,40,12,16,318
63570903,35,54,55,63,41,18,8,10,284
63570904,40,73,75,74,47,26,5,9,349
63570905,51,72,73,69,44,28,6,5,348
63570906,43,72,83,72,43,39,12,12,376
63570907,47,54,58,67,47,34,7,13,327
63570908,52,63,58,52,44,32,5,13,319
63570909,40,53,65,61,41,27,10,7,304
63570910,31,84,78,77,65,21,10,13,379
63570911,42,101,74,77,46,16,6,5,367
63570912,60,83,110,78,56,20,8,7,422
63570913,39,69,54,67,51,22,5,1,308
63571001,24,58,55,53,33,4,1,0,228
63571002,27,56,56,44,20,9,2,0,214
63571003,44,89,90,102,38,15,4,0,382
63571004,30,44,63,85,44,19,5,8,298
63571005,34,61,76,66,43,34,14,9,337
63571006,54,87,86,84,43,31,7,2,394
63571007,29,32,62,54,56,29,8,16,286
63571008,38,74,67,87,64,33,18,25,406
63571009,44,43,37,51,31,18,10,9,243
63571010,30,55,53,34,30,14,3,6,225
63571011,63,78,75,52,41,17,2,2,330
63571012,43,86,64,49,31,15,6,8,302
63571013,25,43,50,38,22,17,10,12,217
63571014,22,55,47,61,40,20,10,11,266
63571015,23,47,51,49,31,25,5,4,235
63571101,29,44,51,38,29,7,4,11,213
63571102,51,64,60,70,45,24,9,13,336
63571103,23,53,62,43,34,18,13,6,252
63571104,37,70,75,94,59,38,12,19,404
63571105,46,60,68,61,41,30,10,11,327
63571106,47,41,63,78,39,44,12,9,333
63571107,33,45,74,67,42,30,10,13,314
63571108,19,44,50,55,19,16,2,5,210
63571109,58,91,104,82,41,26,9,6,417
63571110,44,64,53,47,37,14,5,5,269
63571111,49,65,66,63,30,12,1,3,289
63571112,38,69,57,92,46,29,3,8,342
63571201,42,78,63,66,35,22,10,6,322
63571202,42,47,40,26,24,10,6,1,196
63571203,54,64,58,70,35,14,2,1,298
63571204,62,70,53,52,17,9,7,4,274
63571205,77,106,85,66,30,12,4,1,381
63571206,39,47,44,39,24,10,5,0,208
63571207,43,67,73,64,39,33,3,5,327
63571208,41,58,79,78,44,42,19,14,375
63571209,37,62,67,82,52,24,6,8,338
63571210,27,42,54,82,54,43,12,24,338
63571211,27,43,64,77,62,55,27,17,372
63571212,35,48,58,68,43,31,11,11,305
63571213,43,50,52,59,35,31,0,9,279
63571214,68,79,69,53,14,8,0,4,295
63571215,35,66,72,86,50,41,17,13,380
63571301,44,75,52,54,40,11,4,1,281
63571302,61,109,71,40,17,9,0,2,309
63571303,95,95,93,85,27,15,3,2,415
63571304,89,120,98,86,48,19,6,6,472
63571305,37,65,57,52,28,7,3,6,255
63571306,52,102,93,80,46,27,6,9,415
63571307,49,95,81,74,33,16,6,10,364
63571308,36,60,73,55,32,16,3,7,282
63571309,40,44,43,27,16,8,4,3,185
63571401,78,121,75,61,27,8,3,2,375
63571402,74,89,75,51,19,18,1,1,328
63571403,69,108,91,94,33,19,3,5,422
63571404,54,95,80,54,21,18,1,3,326
63571405,49,61,48,36,13,9,1,2,219
63571406,83,90,61,39,26,3,0,0,302
63571407,84,115,75,60,31,14,2,2,383
63571408,97,119,57,58,15,11,1,1,359
63571409,80,84,63,60,22,6,4,0,319
63571501,72,107,81,59,22,8,0,2,351
63571502,38,65,46,35,21,3,0,0,208
63571503,59,80,57,47,22,6,0,1,272
63571504,64,107,71,58,34,11,3,4,352
63571505,66,94,90,66,23,12,3,2,356
63571506,44,74,48,46,20,6,3,4,245
63571507,188,204,168,102,25,9,3,2,701
63571508,85,121,73,58,16,5,3,0,361
63571509,77,79,63,52,17,3,2,1,294
63571510,64,109,56,48,14,9,1,2,303
63571511,44,57,28,21,9,4,0,0,163
63571601,62,78,58,42,17,8,3,1,269
63571602,64,88,48,34,22,4,3,1,264
63571603,90,92,52,40,8,5,1,0,288
63571604,94,101,73,31,11,9,1,1,321
63571605,32,55,48,36,17,6,4,3,201
63571606,55,74,38,31,12,5,0,2,217
63571607,58,57,35,27,8,3,0,0,188
63571608,55,72,32,41,13,3,2,0,218
63571609,44,57,18,27,7,2,0,0,155
63571610,61,44,34,22,4,1,0,0,166
63571611,50,57,39,14,9,1,0,0,170
63571612,43,52,36,23,3,1,0,0,158
63571613,49,69,43,27,11,4,2,0,205
63571701,54,74,36,62,27,1,5,7,266
63571702,35,40,19,11,4,0,0,0,109
63571703,52,60,28,27,12,0,1,3,183
63571704,34,47,30,52,20,8,4,4,199
63571705,75,87,66,82,38,22,3,6,379
63571706,37,61,30,44,16,1,3,3,195
63571707,31,60,34,32,11,1,1,2,172
63571708,46,66,32,63,28,1,4,9,249
63571709,49,73,37,46,16,1,1,3,226
63571710,39,56,37,34,15,0,0,4,185
63571801,72,99,48,43,14,4,1,1,282
63571802,50,62,42,24,9,4,0,0,191
63571803,40,48,20,17,11,4,0,0,140
63571804,55,61,43,43,17,3,2,0,224
63571805,78,96,65,45,21,12,2,2,321
63571806,45,85,51,49,19,5,1,0,255
63571807,47,79,56,36,22,7,0,0,247
63571808,60,108,68,41,25,3,4,1,310
63571809,39,91,39,38,18,7,2,0,234
63571810,57,78,35,23,11,3,1,1,209
63571901,75,101,44,45,13,9,0,1,288
63571902,55,54,31,14,9,3,0,0,166
63571903,48,56,26,19,5,1,0,0,155
63571904,34,26,15,5,1,0,1,0,82
63571905,66,69,9,14,3,1,0,0,162
63571906,51,40,18,10,7,0,0,1,127
63571907,75,77,37,29,12,3,1,0,234
63571908,74,82,32,14,6,1,0,0,209
63571909,51,38,16,14,3,0,1,0,123
63571910,45,39,14,9,3,0,0,0,110
63571911,55,53,24,10,4,0,0,0,146
63572001,69,62,27,17,0,2,0,1,178
63572002,127,123,50,25,4,0,0,0,329
63572003,89,52,21,4,4,2,1,1,174
63572004,63,59,20,9,0,0,0,0,151
63572005,47,44,10,2,1,0,0,0,104
63572006,46,48,12,5,1,0,0,0,112
63572007,64,61,16,7,2,0,1,0,151
63572008,12,23,5,3,1,0,0,0,44
63572009,39,30,12,8,2,0,0,1,92
63572101,56,46,32,15,7,1,0,0,157
63572102,95,88,41,33,9,4,1,1,272
63572103,78,70,41,15,4,3,2,1,214
63572104,32,47,27,20,4,0,0,1,131
63572105,96,109,49,36,8,5,1,0,304
63572106,79,50,47,14,5,0,1,0,196
63572107,98,60,17,11,4,3,2,1,196
63572108,79,79,39,16,3,0,0,0,216
63572201,65,71,33,21,3,1,0,0,194
63572202,26,49,21,12,2,0,0,0,110
63572203,71,69,36,10,5,2,0,0,193
63572204,61,64,19,13,8,0,0,0,165
63572205,92,59,17,10,1,0,1,0,180
63572206,102,75,37,24,3,1,0,0,242
63572207,89,71,22,8,3,0,0,0,193
63572208,99,86,23,9,4,2,0,1,224
63572209,115,76,32,17,5,1,0,1,247
63572210,65,64,26,16,2,0,0,0,173
63572211,74,57,23,10,3,0,1,0,168
63572212,95,60,19,12,0,0,0,0,186
63572213,53,54,20,5,3,1,0,0,136
63572214,110,65,20,6,1,1,1,0,204
63572301,51,60,27,23,2,2,0,0,165
63572302,66,81,32,18,2,0,0,0,199
63572303,34,48,15,6,5,1,1,0,110
63572304,75,65,19,7,0,0,0,0,166
63572305,32,42,12,6,1,0,0,0,93
63572306,77,74,13,10,2,0,0,0,176
63572307,49,42,12,6,1,0,0,0,110
63572308,27,21,9,1,0,0,0,0,58
63572401,27,30,6,2,3,0,0,0,68
63572402,29,17,4,2,0,0,0,0,52
63572403,78,62,9,5,1,1,0,0,156
63572404,63,60,17,1,3,0,0,0,144
63572405,119,77,30,8,2,2,0,0,238
63572501,129,89,17,10,2,1,1,0,249
63572502,107,87,28,18,1,0,0,0,241
63572503,65,57,11,4,0,0,1,0,138
63572601,113,94,26,5,4,1,0,0,243
63572602,165,108,28,16,6,0,0,0,323
63572603,131,93,20,14,6,0,0,0,264
63572604,152,85,24,15,0,0,0,0,276
63572701,80,55,23,15,4,1,0,0,178
63572702,89,67,17,7,1,1,0,0,182
63572703,118,88,21,12,1,0,0,0,240
63572704,74,65,15,8,1,0,0,0,163
63572705,126,84,21,7,1,0,0,0,239
63572801,112,94,30,8,2,0,0,0,246
63572802,64,46,10,5,5,2,1,0,133
63572803,68,58,22,8,3,0,0,0,159
63572804,61,42,21,6,2,1,0,0,133
63572805,106,67,15,7,5,1,0,0,201
63572806,83,65,16,9,3,0,0,1,177
63572901,74,47,17,8,1,2,0,0,149
63572902,45,35,15,10,4,0,1,0,110
63572903,54,57,14,10,1,1,0,0,137
63572904,103,72,18,11,1,1,0,0,206
63572905,28,15,4,3,1,0,0,0,51
63572906,141,96,37,6,0,0,0,0,280
63573001,94,56,15,6,1,0,0,0,172
63573002,55,52,33,15,5,0,1,0,161
63573003,23,36,11,4,2,1,0,0,77
63573004,80,64,21,12,4,1,0,0,182
63573005,74,52,18,7,4,3,1,0,159
63573006,112,77,32,17,8,0,1,0,247
63573007,54,58,12,4,2,0,0,0,130
63573008,52,39,14,5,1,0,0,0,111
63573009,106,68,25,11,3,0,0,0,213
63573010,78,55,16,8,2,1,0,0,160
63573011,117,63,18,5,1,0,0,1,205
63573101,156,73,30,11,2,0,0,0,272
63573102,90,68,30,15,8,2,0,0,213
63573103,87,59,24,6,2,0,1,0,179
63573104,59,35,12,4,1,0,0,0,111
63573105,100,68,22,14,3,1,0,0,208
63573106,98,70,13,8,0,0,0,0,189
63573107,168,88,35,8,3,0,0,0,302
63573108,115,92,27,10,7,1,1,0,253
63573109,150,83,15,7,1,2,0,0,258
63573201,81,81,43,24,12,2,0,0,243
63573202,93,83,38,35,8,3,0,0,260
63573203,85,83,38,25,12,1,1,0,245
63573204,131,105,48,19,7,1,0,0,311
63573205,74,48,10,7,0,0,0,0,139
63573206,104,71,35,4,4,1,0,0,219
63573207,101,69,31,18,4,3,0,0,226
63573208,43,50,13,9,2,0,0,0,117
63573209,89,80,41,29,9,4,0,0,252
63573210,66,74,35,20,5,0,0,0,200
63573301,64,106,49,38,10,3,0,0,270
63573302,92,121,66,40,13,4,2,0,338
63573303,71,106,60,47,13,5,2,1,305
63573304,124,88,54,25,11,3,0,1,306
63573305,96,82,52,29,11,1,0,0,271
63573306,87,82,30,21,6,0,0,0,226
63573307,106,103,38,22,7,1,0,0,277
63573308,70,86,50,26,4,4,0,0,240
63573309,45,65,44,17,6,2,1,0,180
63573310,39,53,17,19,8,1,0,0,137
63573311,71,47,22,21,8,1,0,0,170
63573401,63,66,24,19,4,0,0,0,176
63573402,80,58,33,19,6,1,0,0,197
63573403,64,57,23,7,0,0,0,0,151
63573404,187,129,34,11,4,0,0,0,365
63573405,55,66,34,13,4,3,1,0,176
63573406,76,48,23,9,6,0,0,0,162
63573407,59,70,32,18,7,2,1,0,189
63573408,39,35,15,5,2,0,0,2,98
63573501,116,88,30,17,4,0,1,0,256
63573502,127,132,40,13,2,0,0,0,314
63573503,75,62,11,6,1,1,0,0,156
63573504,82,70,23,18,3,0,0,0,196
63573505,105,108,32,18,6,0,0,0,269
63573506,95,74,34,10,4,0,0,0,217
63573507,108,76,26,15,6,0,0,0,231
63573508,150,88,25,9,1,0,0,0,273
63573509,117,80,26,13,3,0,0,0,239
63573510,70,43,14,4,1,0,0,0,132
63573601,101,94,29,14,8,1,0,0,247
63573602,111,91,37,18,3,1,0,0,261
63573603,74,65,21,9,3,1,0,0,173
63573604,120,92,26,12,3,0,0,0,253
63573605,34,14,5,3,1,0,0,0,57
63573701,103,78,21,8,1,1,1,0,213
63573702,128,67,20,5,1,0,0,0,221
63573703,89,71,29,12,5,0,0,0,206
63573704,72,47,15,7,0,2,0,0,143
63573705,91,84,24,8,4,1,0,1,213
63573706,69,70,23,4,4,0,0,0,170
63573707,83,48,19,7,1,1,0,0,159
63573708,55,40,19,12,1,0,0,0,127
63573801,123,83,28,4,0,0,0,0,238
63573802,79,74,14,10,2,0,0,0,179
63573803,107,67,23,13,2,0,0,0,212
63573804,52,41,10,5,3,0,0,0,111
63573901,113,66,19,6,2,0,0,0,206
63573902,74,62,20,6,0,0,0,0,162
63573903,75,61,19,6,6,1,0,0,168
63573904,136,89,40,22,1,2,0,0,290
63573905,74,43,14,6,1,0,0,0,138
63573906,53,36,1,2,1,0,0,0,93
63573907,81,72,24,20,7,3,2,0,209
63573908,86,52,17,15,1,2,0,0,173
63573909,55,31,11,2,2,0,0,0,101
63574001,8,8,4,2,2,0,0,0,24
63574002,103,72,28,25,10,5,2,1,246
63574003,69,61,17,7,2,4,0,0,160
63574004,78,84,31,12,1,1,0,0,207
63574005,72,42,20,9,0,0,0,0,143
63574006,77,60,19,2,2,1,0,0,161
63574007,130,82,37,15,2,1,1,0,268
63574008,96,69,21,7,1,0,0,0,194
63574101,70,85,50,63,17,9,4,1,299
63574102,87,90,44,32,11,3,0,0,267
63574103,98,102,35,22,2,2,0,0,261
63574104,86,86,22,11,2,0,0,0,207
63574105,123,60,18,7,0,0,0,0,208
63574106,18,27,8,8,1,0,0,0,62
63574107,38,47,16,10,4,0,0,0,115
63574201,80,58,14,10,1,0,0,0,163
63574202,44,52,14,13,3,1,1,0,128
63574203,36,35,12,8,1,0,0,0,92
63574204,32,24,7,5,0,0,0,0,68
63574205,75,42,9,9,0,1,0,1,137
63574206,83,61,18,4,3,1,0,0,170
63574207,15,39,19,8,8,4,0,0,93
63574301,25,36,8,9,1,0,1,0,80
63574302,34,32,14,4,4,1,0,0,89
63574303,31,44,12,17,2,1,0,0,107
63574304,45,50,34,23,7,6,1,0,166
63574305,27,16,5,5,2,0,0,0,55
63574306,28,34,13,16,7,5,1,0,104
63574307,22,42,31,13,17,10,0,0,135
63574308,19,16,3,8,1,0,0,0,47
63574309,38,38,14,8,4,1,0,0,103
63574310,35,35,9,11,4,2,0,0,96
63574311,31,28,12,7,3,0,0,0,81
63574312,37,36,13,4,2,0,0,0,92
63574401,5,9,5,6,1,0,1,0,27
63574402,11,18,21,7,10,5,1,1,74
63574403,44,65,47,50,18,7,4,0,235
63574404,27,63,54,58,24,6,1,2,235
63574405,37,74,38,34,20,6,0,1,210
63574406,31,48,16,15,0,1,1,0,112
63574407,34,45,30,25,14,3,0,0,151
63574408,19,37,26,24,13,5,1,1,126
63574409,30,26,18,5,4,1,0,0,84
63574501,68,58,24,15,3,1,1,1,171
63574502,65,53,32,26,8,0,0,0,184
63574503,69,70,40,27,11,5,0,0,222
63574504,52,59,47,41,18,9,1,0,227
63574505,36,55,33,20,5,1,1,0,151
63574506,121,94,48,34,15,2,0,1,315
63574507,76,76,52,55,15,7,1,1,283
63574508,82,90,51,32,12,2,0,0,269
63574509,50,95,72,69,35,11,2,2,336
63574510,32,77,58,58,34,12,7,0,278
63574511,38,41,26,13,5,3,0,0,126
63574512,38,51,25,12,4,4,0,0,134
63574513,33,24,9,4,3,1,0,0,74
63574514,44,26,15,9,3,0,0,0,97
63574515,58,57,25,17,5,0,0,0,162
63574516,77,81,51,37,14,3,2,3,268
63574601,49,65,31,26,7,0,0,0,178
63574602,65,73,32,19,7,1,0,0,197
63574603,72,81,40,37,4,3,1,0,238
63574604,33,53,34,26,1,2,0,0,149
63574605,88,93,55,31,10,5,0,0,282
63574606,83,94,76,38,14,3,1,0,309
63574607,71,70,30,17,6,3,0,0,197
63574608,76,63,37,18,8,0,0,0,202
63574609,47,94,67,47,14,4,0,1,274
63574610,75,87,57,31,9,1,0,0,260
63574611,32,71,63,52,15,8,2,1,244
63574612,42,75,50,45,21,14,0,2,249
63574613,45,69,43,25,7,4,1,1,195
63574701,107,96,55,40,15,4,0,0,317
63574702,65,93,57,38,22,2,1,1,279
63574703,86,94,64,45,23,4,1,0,317
63574704,59,85,58,39,14,5,1,0,261
63574705,98,127,65,35,21,2,0,0,348
63574706,60,51,45,20,7,2,0,0,185
63574707,52,61,28,25,6,0,1,0,173
63574708,80,100,60,29,14,3,0,1,287
63574709,92,95,57,36,17,3,0,0,300
63574710,92,121,51,44,16,2,0,1,327
63574801,104,97,70,46,33,11,1,1,363
63574802,63,102,70,52,24,5,7,2,325
63574803,74,93,53,45,18,6,4,4,297
63574804,38,35,27,24,11,9,0,3,147
63574805,44,77,42,23,9,6,2,1,204
63574806,40,42,33,35,10,5,1,0,166
63574807,49,66,30,41,9,3,1,0,199
63574808,46,68,42,22,14,4,0,1,197
63574809,35,57,32,32,11,4,1,0,172
63574810,81,93,86,40,12,5,2,2,321
63574811,74,103,58,44,14,3,3,0,299
63574812,59,64,35,14,12,2,1,1,188
63574813,45,72,51,22,13,5,2,0,210
63574814,54,69,68,32,8,3,2,1,237
63574815,53,70,51,30,7,3,0,0,214
63574901,54,80,42,38,10,4,1,5,234
63574902,68,80,76,61,21,4,1,0,311
63574903,53,76,39,38,12,3,0,1,222
63574904,65,73,38,33,18,2,3,0,232
63574905,67,99,50,42,20,6,3,0,287
63574906,66,77,47,38,12,2,3,0,245
63574907,86,100,43,41,8,8,2,3,291
63574908,65,91,38,28,13,8,1,2,246
63575001,54,78,49,46,20,7,1,2,257
63575002,61,97,57,57,26,10,2,0,310
63575003,47,103,64,54,26,4,2,1,301
63575004,75,100,64,61,28,12,2,1,343
63575005,78,87,71,65,30,13,3,2,349
63575006,82,96,73,57,27,9,3,1,348
63575007,61,90,69,69,33,29,6,10,367
63575008,69,133,106,107,67,34,9,9,534
63575009,86,149,117,119,85,50,10,8,624
63575010,45,66,45,28,17,6,0,1,208
63575011,32,45,40,19,12,6,1,0,155
63575012,75,103,68,48,27,16,9,6,352
63575013,38,49,49,28,10,13,2,3,192
63575014,41,66,42,27,14,4,4,3,201
63575101,40,56,57,55,19,7,2,1,237
63575102,57,89,50,53,27,6,0,2,284
63575103,63,105,92,50,29,15,1,3,358
63575104,51,80,64,50,29,8,1,2,285
63575105,46,62,92,73,31,17,10,4,335
63575106,50,64,53,51,31,23,12,12,296
63575107,51,79,72,74,30,32,9,13,360
63575108,48,65,52,52,28,17,11,15,288
63575109,70,106,92,80,46,14,4,6,418
63575201,36,73,76,90,68,46,18,25,432
63575202,49,86,67,86,62,28,10,10,398
63575203,67,83,83,68,40,26,6,6,379
63575204,53,87,79,81,45,27,5,6,383
63575205,55,61,57,54,33,14,6,3,283
63575206,26,63,40,56,34,20,3,1,243
63575207,70,91,77,50,46,32,11,5,382
63575208,41,64,56,51,35,11,5,7,270
63575209,15,37,48,59,37,30,8,9,243
63575210,65,79,104,90,63,41,22,14,478
63575211,34,52,85,78,50,38,11,13,361
63575212,35,70,75,66,32,25,9,12,324
63575213,33,77,72,58,44,36,7,13,340
63575214,45,65,69,91,46,31,21,13,381
63575215,52,77,90,82,64,41,16,21,443
63575216,54,67,99,79,64,45,16,23,447
63575301,51,83,81,71,28,15,3,0,332
63575302,45,94,77,69,35,15,6,2,343
63575303,47,109,81,80,31,16,8,6,378
63575304,66,87,54,52,25,10,1,3,298
63575305,54,56,50,52,31,14,5,2,264
63575306,38,52,54,69,25,11,3,7,259
63575307,65,80,80,81,50,15,7,7,385
63575308,50,76,64,80,35,23,9,9,346
63575309,51,87,93,86,48,33,10,5,413
63575310,51,76,74,88,43,26,2,8,368
63575311,53,69,62,70,25,29,12,9,329
63575312,68,75,74,64,41,30,11,3,366
63575313,30,49,56,55,35,20,3,3,251
63575314,29,52,41,56,30,14,3,9,234
63575315,41,53,52,62,34,26,17,13,298
63575316,31,41,45,50,47,20,11,11,256
63575401,56,84,59,52,29,16,1,4,301
63575402,44,101,64,62,36,12,3,3,325
63575403,66,88,84,62,35,20,6,8,369
63575404,79,122,83,54,31,13,7,12,401
63575405,46,81,61,55,27,8,1,1,280
63575406,40,74,48,45,31,3,5,1,247
63575407,43,63,42,40,27,12,4,10,241
63575408,37,82,41,44,13,8,3,4,232
63575501,41,56,46,32,18,4,1,1,199
63575502,73,80,62,38,13,4,0,2,272
63575503,85,107,80,49,29,10,2,3,365
63575504,114,132,81,59,32,18,1,1,438
63575505,23,57,48,40,10,4,3,0,185
63575506,33,69,46,78,25,5,1,0,257
63575507,32,59,51,55,23,6,0,1,227
63575508,57,136,87,101,44,11,1,1,438
63575601,79,109,69,47,23,7,5,1,340
63575602,77,106,72,63,22,7,2,3,352
63575603,81,105,56,43,18,5,3,1,312
63575604,73,129,74,70,19,7,0,1,373
63575605,64,100,55,45,16,8,0,0,288
63575606,50,98,67,41,17,7,3,1,284
63575607,68,112,70,68,15,12,0,1,346
63575608,59,99,71,56,23,10,2,2,322
63575609,69,82,55,51,19,8,1,1,286
63575610,44,47,33,25,10,0,1,0,160
63575611,91,127,82,55,29,7,4,2,397
63575612,69,91,58,49,9,6,1,4,287
63575701,88,128,87,95,46,19,6,4,473
63575702,70,111,69,55,33,7,1,0,346
63575703,60,86,66,39,21,5,3,0,280
63575704,85,133,79,75,29,11,3,2,417
63575705,43,52,53,46,16,6,1,0,217
63575706,72,106,71,58,23,8,4,1,343
63575707,38,70,56,38,15,3,2,1,223
63575708,51,64,45,28,12,5,2,1,208
63575709,69,112,90,68,22,10,2,3,376
63575710,38,81,48,42,19,7,1,1,237
63575801,69,82,50,48,16,5,1,1,272
63575802,58,97,53,47,12,5,2,3,277
63575803,81,89,49,33,18,8,2,0,280
63575804,68,99,55,48,20,7,0,1,298
63575805,83,88,74,69,23,7,1,5,350
63575806,80,111,71,55,29,6,1,2,355
63575807,44,105,61,50,21,8,1,3,293
63575808,74,138,79,83,41,11,5,6,437
63575901,104,134,63,32,16,4,0,0,353
63575902,57,114,60,46,20,3,1,0,301
63575903,61,87,51,27,18,8,0,0,252
63575904,65,90,60,54,14,7,1,0,291
63575905,60,82,63,53,19,7,1,1,286
63575906,58,135,89,87,35,6,3,1,414
63575907,47,72,58,57,35,25,8,9,311
63575908,63,105,65,52,16,5,3,0,309
63575909,44,46,33,31,23,3,0,1,181
63575910,39,66,35,44,6,1,1,0,192
63575911,73,93,63,54,16,11,5,3,318
63576001,91,90,53,57,17,11,2,0,321
63576002,58,58,56,30,15,7,1,1,226
63576003,65,87,63,54,16,4,3,0,292
63576004,47,57,53,27,16,4,1,0,205
63576005,50,92,54,52,22,9,1,0,280
63576006,62,100,85,60,17,9,1,3,337
63576007,65,85,69,70,14,9,2,1,315
63576008,41,77,57,40,14,9,0,2,240
63576009,38,61,46,37,15,10,2,3,212
63576010,48,51,55,43,28,13,3,5,246
63576011,38,54,39,50,29,13,5,2,230
63576101,29,85,67,81,35,11,2,0,310
63576102,82,109,89,67,30,10,1,0,388
63576103,20,73,29,25,9,4,2,0,162
63576104,36,59,60,39,20,7,1,1,223
63576105,17,83,58,70,42,13,1,0,284
63576106,46,93,64,116,36,15,2,1,373
63576107,33,32,32,34,16,7,2,4,160
63576108,1,1,3,3,2,1,0,0,11
63576109,30,57,53,46,19,5,0,0,210
63576110,70,92,64,57,27,8,3,1,322
63576111,34,64,40,33,17,9,3,2,202
63576112,1,7,18,27,22,8,0,1,84
63576113,44,76,60,40,14,3,1,0,238
63576201,65,70,79,70,32,8,6,4,334
63576202,23,58,37,39,20,7,3,1,188
63576203,26,45,42,28,20,5,2,1,169
63576204,51,83,69,53,24,9,3,0,292
63576205,52,84,62,45,16,11,5,1,276
63576206,56,67,69,47,14,10,1,3,267
63576207,40,57,46,49,18,13,5,1,229
63576208,41,42,43,38,11,5,3,0,183
63576209,50,83,47,53,21,4,3,0,261
63576210,32,23,21,18,3,5,0,0,102
63576211,54,60,43,30,19,8,1,1,216
63576301,0,2,0,1,1,0,0,0,4
63576302,11,25,7,9,2,2,0,0,56
63576303,15,24,17,9,2,1,3,0,71
63576304,9,47,28,24,11,3,1,1,124
63576305,25,45,29,22,9,0,2,1,133
63576306,15,12,13,13,6,0,0,0,59
63576307,12,20,16,4,3,0,0,2,57
63576308,21,29,15,10,5,3,0,0,83
63576309,15,18,15,6,1,0,0,0,55
63576401,30,73,74,111,44,18,1,1,352
63576402,31,58,88,107,48,20,0,6,358
63576403,20,41,51,47,27,9,2,4,201
63576404,22,42,51,59,35,7,5,4,225
63576405,22,48,47,58,20,7,2,0,204
63576406,13,39,33,26,22,6,2,2,143
63576407,28,31,46,34,18,10,1,2,170
63576408,18,49,26,33,10,3,1,0,140
63576409,15,29,16,9,9,3,0,0,81
63576410,9,25,7,16,6,2,1,0,66
63576411,27,46,22,10,9,3,1,0,118
63576501,30,45,41,30,13,14,2,3,178
63576502,44,54,38,44,23,16,5,2,226
63576503,0,1,2,0,0,0,0,0,3
63576504,50,77,84,77,33,10,3,0,334
63576505,32,53,45,51,25,10,0,0,216
63576506,23,52,45,46,19,6,1,1,193
63576507,28,59,55,67,26,12,3,2,252
63576508,40,79,65,83,40,12,4,0,323
63576509,27,78,54,63,30,6,3,1,262
63576510,28,50,42,47,12,5,2,1,187
63576511,35,54,36,56,10,6,2,0,199
63576512,36,57,38,40,21,7,2,1,202
63576513,16,19,11,13,8,1,1,1,70
63576514,12,39,20,17,7,1,1,1,98
63576601,47,67,64,48,30,22,3,4,285
63576602,52,70,59,67,24,9,5,3,289
63576603,72,104,84,61,52,20,10,5,408
63576604,57,94,75,71,32,18,3,2,352
63576605,41,69,64,48,27,11,2,1,263
63576606,31,56,56,56,22,19,8,5,253
63576607,36,68,59,54,32,14,6,5,274
63576608,29,58,42,41,28,12,2,1,213
63576701,30,45,37,34,30,7,1,2,186
63576702,46,50,47,49,29,16,1,4,242
63576703,41,74,77,68,37,11,7,7,322
63576704,34,74,68,54,32,19,15,6,302
63576705,63,65,59,62,44,18,7,6,324
63576706,40,65,50,38,26,12,6,4,241
63576707,54,76,94,87,53,17,15,6,402
63576708,41,58,48,46,28,20,5,6,252
63576709,41,67,53,50,44,25,5,6,291
63576710,26,65,60,83,41,32,10,9,326
63576711,41,85,71,63,49,35,16,19,379
63576712,38,68,67,62,52,28,10,7,332
63576713,27,37,36,48,33,21,3,8,213
63576714,15,47,49,50,24,13,4,4,206
63576715,42,68,65,76,50,38,12,14,365
63576801,65,114,105,94,35,14,3,7,437
63576802,51,84,83,77,52,24,10,1,382
63576803,44,55,53,39,34,13,8,5,251
63576804,43,61,38,34,14,6,1,3,200
63576805,32,49,35,33,17,9,7,1,183
63576806,33,51,58,66,22,16,3,4,253
63576807,38,70,61,59,28,10,8,1,275
63576808,38,61,42,49,26,13,2,3,234
63576809,45,62,70,57,25,12,3,6,280
63576810,44,67,69,70,33,28,7,7,325
63576901,27,52,59,44,32,13,6,7,240
63576902,31,43,40,55,32,15,6,3,225
63576903,30,35,41,42,23,12,7,4,194
63576904,34,59,52,44,29,24,5,3,250
63576905,27,60,65,49,29,8,5,5,248
63576906,55,59,60,49,24,18,8,11,284
63576907,44,80,68,87,41,29,12,11,372
63576908,50,60,58,53,30,18,11,9,289
63576909,36,59,65,51,41,20,12,5,289
63576910,41,61,52,68,48,26,15,15,326
63576911,27,40,41,37,21,16,6,6,194
63577001,39,56,60,45,39,10,5,7,261
63577002,55,89,77,74,35,9,2,0,341
63577003,76,124,107,81,36,12,5,6,447
63577004,66,118,93,83,35,17,5,2,419
63577005,36,62,41,33,22,5,3,2,204
63577006,30,80,53,48,24,11,5,2,253
63577007,55,115,75,64,49,14,4,4,380
63577008,68,114,77,66,36,8,4,2,375
63577009,38,61,43,35,31,16,3,5,232
63577010,49,57,41,39,27,16,10,2,241
63577011,51,59,45,37,36,18,4,11,261
63577012,31,38,45,41,26,13,8,5,207
63577013,38,51,52,58,31,20,12,5,267
63577014,34,60,54,52,38,28,3,17,286
63577101,38,53,52,39,20,14,7,11,234
63577102,58,82,71,48,24,16,3,4,306
63577103,65,110,99,71,33,13,3,3,397
63577104,67,126,83,72,43,11,3,3,408
63577105,38,63,66,54,26,11,8,3,269
63577106,43,80,81,86,53,26,11,14,394
63577107,46,83,83,73,19,15,2,0,321
63577108,77,129,92,71,35,11,8,1,424
63577109,54,84,102,107,42,26,2,4,421
63577110,38,59,67,59,22,33,12,11,301
63577111,46,58,78,84,63,34,11,17,391
63577201,29,45,49,62,42,30,11,21,289
63577202,47,54,64,45,46,37,14,20,327
63577203,25,46,43,46,24,44,13,15,256
63577204,59,69,75,59,58,24,12,14,370
63577205,56,73,76,78,41,24,10,11,369
63577206,33,68,44,69,39,25,6,9,293
63577207,51,61,80,64,44,22,10,9,341
63577208,29,45,56,37,28,14,1,1,211
63577209,42,73,77,75,51,29,12,12,371
63577210,41,99,104,80,54,28,9,11,426
63577211,43,68,77,67,48,31,4,10,348
63577301,4,13,10,11,9,12,3,5,67
63577302,39,72,78,66,56,33,10,15,369
63577303,11,4,2,1,1,0,0,0,19
63577304,10,13,14,9,7,5,1,4,63
63577305,51,53,73,75,49,24,15,9,349
63577306,17,63,71,75,66,30,11,14,347
63577307,12,11,14,13,4,8,9,0,71
63577308,17,19,28,24,27,17,4,9,145
63577309,20,32,29,34,21,17,1,6,160
63577310,0,2,0,1,0,0,0,0,3
63577311,23,25,30,18,9,3,4,2,114
63577312,11,22,19,16,2,3,0,1,74
63577401,57,89,81,58,36,12,3,0,336
63577402,26,57,68,69,39,25,14,20,318
63577403,36,52,44,44,28,19,3,2,228
63577404,35,32,55,62,36,26,11,22,279
63577405,23,41,41,40,43,18,9,9,224
63577406,44,51,72,81,70,40,18,13,389
63577407,24,42,56,57,26,10,5,4,224
63577408,26,40,56,65,33,22,6,9,257
63577409,23,44,33,45,19,9,2,3,178
63577410,22,37,43,49,24,4,1,2,182
63577411,14,35,26,31,15,5,2,3,131
63577412,20,39,41,30,23,6,3,1,163
63577413,38,51,41,45,22,13,0,1,211
63577414,75,64,52,68,41,16,12,2,330
63577415,20,41,36,50,16,10,1,1,175
63577416,19,29,27,54,23,5,0,1,158
63577417,19,53,40,54,21,6,0,0,193
63577418,29,47,33,38,19,7,2,2,177
63577501,28,50,23,32,8,7,0,1,149
63577502,13,22,17,10,6,3,0,0,71
63577503,8,6,8,0,4,1,0,0,27
63577504,15,31,21,33,11,3,1,0,115
63577505,12,24,17,5,3,3,0,0,64
63577506,18,33,23,31,15,5,3,0,128
63577507,25,59,39,40,26,5,1,1,196
63577508,24,43,20,24,17,10,0,0,138
63577509,18,25,17,11,8,0,2,1,82
63577510,12,16,19,18,5,2,1,0,73
63577511,18,31,26,26,7,3,1,0,112
63577512,19,37,41,35,17,6,4,3,162
63577513,29,43,29,21,17,6,4,2,151
63577514,11,27,29,14,5,5,1,0,92
63577515,15,17,20,12,8,1,0,1,74
63577516,11,16,12,13,1,2,2,1,58
63577601,16,23,17,13,18,7,3,1,98
63577602,28,31,27,22,28,5,6,6,153
63577603,11,14,19,7,2,2,1,0,56
63577604,30,21,23,16,8,5,0,0,103
63577605,23,32,14,11,8,4,1,0,93
63577606,6,18,11,6,3,1,0,0,45
63577607,21,29,16,17,5,2,2,2,94
63577608,32,42,26,19,10,2,0,0,131
63577609,20,41,27,22,14,9,2,3,138
63577610,42,70,47,33,36,8,2,4,242
63577611,17,20,17,27,16,8,1,4,110
63577612,18,22,17,19,10,1,1,1,89
63577613,14,29,11,15,9,2,0,0,80
63577614,13,18,6,7,3,0,1,1,49
63577615,12,29,17,11,6,2,1,1,79
63577616,12,18,14,14,8,8,2,3,79
63577617,14,24,14,8,3,1,1,2,67
63577701,23,33,46,32,32,15,6,8,195
63577702,20,34,32,44,29,17,3,8,187
63577703,10,13,10,18,5,3,1,2,62
63577704,7,12,7,13,0,4,0,0,43
63577705,14,14,9,8,4,0,1,2,52
63577706,1,7,5,4,2,1,1,0,21
63577707,18,16,15,5,3,2,0,0,59
63577708,10,14,7,5,3,1,0,2,42
63577709,39,32,24,19,8,6,2,0,130
63577710,15,30,10,15,3,2,0,1,76
63577711,14,22,9,9,5,1,1,0,61
63577712,10,17,12,11,3,4,1,0,58
63577713,13,16,5,11,7,5,2,1,60
63577714,16,22,11,8,2,4,0,0,63
63577715,11,16,6,6,3,4,1,1,48
63577716,25,14,8,11,7,1,0,0,66
63577717,9,10,6,8,0,0,0,1,34
63577718,10,14,4,6,3,3,0,0,40
63577801,1,2,4,3,1,1,0,0,12
63577802,9,32,38,33,20,18,4,8,162
63577803,12,22,24,22,15,8,3,5,111
63577804,31,56,63,57,35,23,17,7,289
63577805,27,49,53,56,48,25,9,7,274
63577806,14,7,8,11,5,2,3,2,52
63577807,28,24,14,19,13,7,5,2,112
63577808,30,43,45,37,30,12,1,2,200
63577809,28,33,27,71,30,22,11,11,233
63577810,18,38,55,71,59,35,12,8,296
63577811,20,45,65,83,52,56,17,17,355
63577812,68,51,79,78,79,34,18,21,428
63577813,29,53,57,61,28,22,8,3,261
63577814,38,47,70,66,54,40,8,19,342
63577815,25,27,41,45,27,16,6,7,194
63577816,23,29,42,32,42,24,6,9,207
63577901,0,1,1,0,0,0,0,0,2
63577902,26,71,66,79,33,7,2,0,284
63577903,19,21,11,13,13,6,0,1,84
63577904,39,44,37,48,23,25,8,7,231
63577905,26,36,34,54,26,28,12,9,225
63577906,22,33,41,46,29,23,13,12,219
63577907,21,22,33,43,38,22,9,11,199
63577908,41,60,58,63,36,32,14,7,311
63577909,64,79,72,65,57,24,9,7,377
63577910,30,31,39,40,33,29,7,19,228
63577911,19,42,36,26,28,9,3,2,165
63577912,42,49,35,39,33,12,7,6,223
63577913,49,69,83,84,30,33,11,10,369
63577914,61,90,89,87,53,29,7,11,427
63577915,80,83,112,123,76,48,21,17,560
63577916,11,9,14,17,10,1,1,1,64
63577917,9,2,5,8,10,5,2,2,43
63578001,44,65,75,69,58,19,8,15,353
63578002,36,48,50,55,32,11,7,10,249
63578003,38,56,59,59,38,24,12,5,291
63578004,38,48,46,77,47,24,7,9,296
63578005,75,72,76,94,31,32,13,13,406
63578006,45,57,71,73,46,22,3,9,326
63578007,17,32,43,37,24,14,4,4,175
63578008,20,45,38,36,23,11,5,2,180
63578009,21,20,25,30,8,13,2,10,129
63578010,19,22,23,16,12,8,7,4,111
63578011,28,34,29,24,16,8,2,2,143
63578012,18,21,31,11,11,6,1,1,100
63578013,20,30,27,31,23,14,6,5,156
63578014,28,31,21,31,14,6,2,4,137
63578015,0,0,2,0,1,0,0,0,3
63578016,44,44,38,51,29,10,7,7,230
63578017,21,42,20,25,16,9,3,4,140
63578018,10,32,13,17,18,5,5,2,102
63578101,26,13,13,18,11,9,2,3,95
63578102,8,4,3,1,1,0,0,1,18
63578103,4,1,1,3,1,0,0,0,10
63578104,9,24,17,7,6,11,1,3,78
63578105,18,12,17,11,5,3,2,2,70
63578106,29,30,31,27,10,8,3,1,139
63578107,25,31,21,18,15,4,3,7,124
63578108,34,35,28,24,20,6,4,2,153
63578109,21,44,30,30,21,8,3,5,162
63578110,22,41,44,39,22,6,1,1,176
63578111,24,39,46,38,18,6,0,0,171
63578112,27,39,37,36,19,5,1,4,168
63578113,19,34,34,24,24,9,4,6,154
63578114,42,61,82,66,34,26,16,13,340
63578201,6,13,6,5,3,2,0,0,35
63578202,8,12,8,13,4,2,0,0,47
63578203,47,51,34,49,21,14,1,10,227
63578204,21,40,35,39,23,8,6,3,175
63578205,36,40,62,68,23,20,9,8,266
63578206,31,43,54,43,18,20,5,3,217
63578207,19,21,16,14,4,4,0,0,78
63578208,16,39,18,13,4,0,0,0,90
63578209,6,28,11,15,6,1,0,0,67
63578210,18,27,7,11,6,2,0,1,72
63578211,22,48,36,31,8,3,2,1,151
63578212,18,58,30,33,11,3,0,0,153
63578213,15,32,22,22,13,10,6,3,123
63578301,16,12,20,22,8,3,4,2,87
63578302,12,33,30,31,16,12,4,3,141
63640101,42,67,70,65,46,19,12,9,330
63640102,45,64,43,42,18,13,1,1,227
63640103,64,101,86,70,30,13,4,0,368
63640104,24,44,57,64,31,17,12,13,262
63640105,49,85,58,57,28,12,8,5,302
63640106,43,71,61,54,26,12,3,5,275
63640107,22,46,39,47,34,19,6,7,220
63640108,41,41,53,49,27,21,11,14,257
63640109,35,33,41,40,47,23,11,15,245
63640110,26,50,53,52,33,17,8,13,252
63640111,46,74,49,37,37,24,3,4,274
63640112,34,32,28,47,26,11,4,5,187
63640113,20,39,43,42,32,10,8,11,205
63640114,59,96,79,86,49,26,5,11,411
63640115,48,52,42,26,16,7,3,2,196
63640116,40,74,44,28,13,6,1,1,207
63640117,35,55,33,38,15,11,3,1,191
63640118,60,55,41,28,12,6,0,0,202
63640119,77,92,76,79,39,13,1,2,379
63640201,23,34,42,35,26,8,2,6,176
63640202,35,63,78,58,46,12,5,3,300
63640203,55,85,71,79,48,16,2,6,362
63640204,35,40,54,36,22,15,13,8,223
63640205,58,62,65,74,30,10,12,7,318
63640206,37,48,51,32,28,22,6,10,234
63640207,39,57,72,68,49,29,13,8,335
63640208,23,59,44,50,34,13,2,5,230
63640209,31,33,54,53,33,18,5,6,233
63640210,42,61,62,56,42,11,4,5,283
63640211,18,33,18,16,13,13,2,3,116
63640212,16,27,19,19,11,6,1,1,100
63640213,20,32,29,30,15,11,3,3,143
63640214,19,23,25,24,20,5,0,0,116
63640301,43,36,41,31,29,19,3,7,209
63640302,35,51,49,44,41,26,7,7,260
63640303,34,38,48,39,33,20,9,9,230
63640304,29,39,35,38,33,15,6,7,202
63640305,26,32,34,40,28,12,7,8,187
63640306,42,61,67,70,39,11,8,3,301
63640307,59,66,87,84,81,43,15,13,448
63640308,40,49,50,62,59,23,6,16,305
63640309,20,28,35,25,26,12,6,4,156
63640310,25,31,23,30,22,13,9,8,161
63640311,18,23,26,30,25,10,3,1,136
63640312,16,44,67,68,37,27,7,7,273
63640313,14,21,33,20,10,3,3,2,106
63640314,0,0,0,0,0,0,0,0,0
63640315,7,17,48,43,27,12,9,4,167
63640316,0,0,0,0,0,0,0,0,0
63640317,16,18,20,21,15,2,0,2,94
63640318,52,58,61,49,30,29,9,5,293
63640401,57,82,71,79,41,24,4,17,375
63640402,41,64,61,71,44,18,20,26,345
63640403,41,44,67,89,56,24,14,15,350
63640404,19,24,25,15,17,12,3,3,118
63640405,37,58,70,71,47,29,14,11,337
63640406,28,37,30,52,18,28,2,18,213
63640407,45,35,18,30,33,20,5,4,190
63640408,29,41,50,37,33,22,10,15,237
63640409,32,29,53,50,29,22,14,11,240
63640410,38,44,60,40,30,22,9,13,256
63640411,19,23,40,24,27,19,5,6,163
63640412,36,28,39,41,28,27,6,12,217
63640413,35,35,41,29,17,24,6,13,200
63640414,12,11,8,6,5,3,0,2,47
63640501,38,64,69,58,21,29,14,16,309
63640502,1,3,6,7,2,2,1,2,24
63640503,6,5,1,1,2,0,0,0,15
63640504,12,24,23,17,15,10,1,1,103
63640601,2,3,6,0,0,1,0,0,12
63640602,2,4,8,0,0,0,0,0,14
63640603,3,5,3,10,3,0,0,0,24
63640604,4,3,2,2,4,1,2,1,19
63640701,42,62,53,54,28,14,9,1,263
63640702,47,49,69,49,27,12,5,6,264
63640703,46,46,45,46,30,17,3,1,234
63640704,27,46,68,78,62,26,15,10,332
63640705,43,58,49,58,27,18,7,10,270
63640706,79,96,59,52,14,7,2,0,309
63640707,44,70,62,39,18,9,5,4,251
63640708,47,61,57,47,28,14,2,2,258
63640709,72,94,98,73,44,12,3,1,397
63640710,55,57,37,24,10,3,0,0,186
63640711,43,50,46,42,22,4,2,1,210
63640712,73,108,95,74,38,23,5,4,420
63640713,64,49,67,49,31,12,3,2,277
63640714,43,47,69,57,24,21,6,7,274
63640715,32,46,54,36,26,20,7,6,227
63640716,20,39,28,36,24,19,7,10,183
63640717,22,21,33,25,24,24,7,3,159
63640801,20,33,32,25,16,10,1,4,141
63640802,25,23,29,26,16,11,9,9,148
63640803,23,31,47,35,28,14,8,4,190
63640804,31,24,30,30,18,10,8,6,157
63640805,37,62,59,49,41,30,3,3,284
63640806,36,29,33,39,36,16,11,8,208
63640807,28,41,52,56,38,22,12,10,259
63640808,29,36,28,41,38,15,5,7,199
63640809,35,44,55,50,35,30,7,7,263
63640810,33,66,51,65,38,17,10,10,290
63640811,12,31,26,34,21,20,6,11,161
63640812,12,27,22,33,22,21,5,10,152
63640813,31,47,49,62,32,23,9,6,259
63640814,31,35,35,38,23,20,7,7,196
63640815,29,34,40,33,29,13,5,5,188
63640816,41,40,49,34,29,16,7,5,221
63640817,31,39,43,49,31,23,6,15,237
63640818,43,50,46,53,35,25,4,6,262
63640819,42,52,39,50,38,24,15,7,267
63640820,23,28,25,33,39,23,7,17,195
63640821,19,24,37,26,23,15,9,4,157
63640822,13,39,36,39,20,10,5,16,178
63640823,53,64,56,49,39,25,9,10,305
63850101,71,58,43,43,28,4,1,3,251
63850102,4,5,2,3,0,0,0,0,14
63850103,3,2,5,2,3,0,0,0,15
63850104,0,1,0,0,0,0,0,0,1
63850105,4,4,0,1,0,0,0,0,9
63850106,35,36,40,42,15,11,4,1,184
63850107,47,64,40,45,14,8,5,2,225
63850201,28,34,22,17,7,4,2,3,117
63850202,5,2,1,2,0,2,0,0,12
63850203,6,6,4,2,2,0,0,0,20
63850204,7,1,2,0,1,0,0,0,11
63850301,3,1,0,1,1,0,0,0,6
63850302,0,3,1,1,1,2,0,0,8
63850303,5,3,1,2,1,0,1,0,13
63850401,24,15,10,6,4,3,0,1,63
63850402,3,9,4,1,1,1,0,0,19
63850403,5,3,1,1,2,0,1,0,13
63850404,0,4,1,3,0,1,1,0,10
63850405,3,0,0,0,1,1,0,0,5
63850501,1,4,1,0,0,1,0,0,7
63850601,3,7,2,4,3,0,0,0,19
63850701,81,67,69,48,31,9,8,6,319
63850702,66,71,52,55,28,12,3,2,289
63850703,45,58,47,34,12,7,1,0,204
63850704,57,74,54,57,35,12,8,5,302
63850705,84,90,62,49,17,6,2,1,311
63850706,52,68,40,31,10,5,1,0,207
63850707,78,111,55,50,25,4,2,2,327
63850708,89,95,64,35,14,8,3,1,309
63850709,57,72,51,47,22,12,5,4,270
63850710,47,51,58,57,23,18,5,6,265
63850711,42,68,41,30,20,6,1,1,209
63850712,14,8,9,4,4,4,1,3,47
63850713,47,66,45,47,16,14,1,5,241
63850714,68,76,55,41,28,9,5,2,284
63850715,56,77,65,42,27,3,1,1,272
63850716,50,63,36,42,17,4,3,0,215
63850717,68,77,35,24,9,5,0,0,218
63850718,9,16,3,10,9,3,2,1,53
63850801,4,10,7,6,3,2,1,0,33
63850802,5,5,3,2,2,1,0,0,18
63850901,10,8,1,4,4,3,0,0,30
63850902,8,6,5,2,1,2,1,0,25
63851001,59,89,69,52,23,11,5,8,316
63851002,59,90,108,90,68,28,12,10,465
63851101,2,6,4,2,0,1,1,0,16
63851102,4,4,4,1,5,1,0,0,19
63920101,34,46,48,45,26,22,11,9,241
63920102,91,116,87,70,38,18,11,8,439
63920103,63,75,39,21,16,2,2,2,220
63920104,57,69,39,26,12,5,1,0,209
63920105,108,121,64,44,16,3,1,1,358
63920106,114,131,62,51,16,8,1,2,385
63920107,66,91,62,57,24,5,4,3,312
63920108,61,109,67,56,17,7,1,2,320
63920109,74,75,77,89,34,13,2,3,367
63920110,65,63,70,61,32,11,2,4,308
63920111,51,57,49,53,23,13,1,1,248
63920112,61,97,69,40,19,12,4,1,303
63920113,45,76,77,51,35,14,12,8,318
63920114,49,64,63,65,33,13,11,6,304
63920115,42,58,56,45,39,12,7,3,262
63920116,57,63,32,36,8,5,1,2,204
63920201,4,4,5,3,1,2,0,0,19
63920202,3,5,3,1,1,5,2,0,20
63920203,6,2,4,0,2,0,0,0,14
63920204,1,2,2,0,1,0,0,0,6
63920301,58,86,48,37,15,10,0,2,256
63920302,0,2,2,4,2,0,0,0,10
63920303,3,9,3,2,0,1,0,0,18
63920304,0,2,0,1,2,1,0,0,6
63920305,4,9,4,2,0,1,1,0,21
63920306,4,5,5,7,4,3,1,0,29
63920401,34,39,19,15,9,4,3,1,124
63920402,2,3,4,1,2,0,0,0,12
63920403,2,15,3,1,0,1,0,0,22
63920404,0,3,1,1,1,0,0,0,6
63920405,0,3,1,3,3,1,0,0,11
63920501,0,3,1,1,1,0,0,0,6
63920502,10,6,4,4,2,2,0,0,28
63920503,2,2,1,6,0,0,0,0,11
63920504,2,3,1,2,1,0,0,0,9
63920505,0,1,0,0,0,0,0,0,1
63920601,26,27,23,11,6,1,1,1,96
63920602,7,2,4,6,1,1,1,1,23
63920603,3,0,1,0,2,0,1,0,7
63920604,3,5,5,4,6,3,1,0,27
63920605,6,20,14,4,2,5,2,1,54
63920701,5,3,1,3,0,0,0,0,12
63920702,52,59,37,31,12,8,1,4,204
63920703,10,16,11,12,3,6,0,0,58
63920704,1,5,4,2,2,3,0,0,17
63920705,23,31,25,21,4,4,2,1,111
63920706,33,28,29,15,11,2,0,2,120
63920707,32,27,28,14,10,2,0,0,113
63920708,22,45,41,27,11,3,0,1,150
63920709,3,3,5,3,4,5,0,0,23
63920710,8,8,4,2,1,1,0,0,24
63920801,58,65,54,36,23,14,4,4,258
63920802,8,6,7,4,3,2,0,1,31
63920803,9,9,9,5,6,2,1,1,42
63920804,7,3,5,0,0,1,1,0,17
63920805,11,10,5,1,0,0,0,0,27
63920806,74,84,68,64,49,21,12,3,375
63920901,65,81,62,55,31,9,5,2,310
63920902,13,12,16,17,14,3,1,1,77
63920903,28,27,21,13,8,3,2,0,102
63920904,8,9,10,1,2,4,1,0,35
63920905,3,8,2,4,3,0,0,0,20
63920906,25,35,22,19,17,5,3,4,130
63920907,31,40,41,34,16,10,4,1,177
63921001,1,7,6,2,1,1,0,1,19
63921002,1,1,4,2,2,0,1,0,11
63921003,1,2,1,0,1,1,0,0,6
63921004,7,2,3,4,3,0,0,0,19
63921005,14,8,8,8,5,0,2,1,46
63921006,4,2,0,1,1,0,0,0,8
63921101,3,0,3,2,0,1,0,0,9
63921102,8,2,3,2,3,1,1,0,20
63921103,1,0,0,0,0,1,0,0,2
63921201,27,33,44,59,40,32,16,33,284
63921202,56,57,42,63,30,22,8,12,290
63921203,38,56,63,66,49,16,5,7,300
63921204,8,9,6,11,6,1,0,1,42
63921205,7,3,2,1,3,0,0,0,16
63921206,39,43,53,63,22,16,5,6,247
63921207,17,15,28,25,12,9,2,1,109
63921208,4,3,5,4,1,1,0,1,19
63921209,3,6,3,4,2,1,0,0,19
63921301,7,3,2,4,4,3,0,1,24
63921302,6,4,8,4,1,1,1,1,26
63921303,7,6,6,5,2,0,0,0,26
63921401,4,3,3,3,0,3,2,0,18
63921402,2,4,2,0,1,1,0,0,10
63921403,0,2,0,0,0,0,0,0,2
63921404,4,1,2,1,1,0,0,1,10
63921501,51,51,49,33,29,6,3,1,223
63921502,52,45,40,44,25,8,1,3,218
63921503,14,16,9,15,2,1,0,1,58
63921504,7,1,4,2,3,5,0,1,23
63921505,4,4,1,2,1,1,0,0,13
63921506,34,34,31,27,12,7,0,2,147
63921507,2,3,2,2,2,0,0,0,11
63990101,77,91,45,43,15,8,2,0,281
63990102,52,76,63,28,6,4,2,1,232
63990103,40,48,32,15,2,2,1,0,140
63990104,6,7,3,3,3,1,0,0,23
63990105,25,47,47,67,32,15,5,0,238
63990106,61,92,56,50,21,7,2,2,291
63990107,17,42,25,26,11,4,2,3,130
63990108,43,63,26,28,13,3,1,1,178
63990109,35,58,29,33,14,8,1,4,182
63990201,1,5,3,1,1,0,0,0,11
63990202,5,16,6,4,3,1,2,1,38
63990301,12,9,6,9,7,0,0,0,43
63990302,11,15,15,10,1,3,1,3,59
63990303,15,32,30,31,16,9,1,0,134
63990304,60,76,37,30,13,6,1,3,226
63990401,2,6,4,4,4,1,0,0,21
63990402,2,6,5,2,2,1,0,0,18
63990501,84,139,76,66,24,18,7,3,417
63990502,39,41,33,22,9,7,3,2,156
63990503,17,13,7,7,2,0,0,0,46
63990504,10,17,16,10,9,3,1,2,68
63990601,10,14,10,10,7,0,0,0,51
63990602,8,7,9,8,5,2,0,0,39
63990701,5,3,1,2,0,0,0,0,11
63990702,24,23,18,21,6,1,0,0,93
63990703,57,70,60,48,24,7,6,3,275
63990704,57,92,57,32,20,8,4,2,272
63990705,56,61,38,31,19,6,4,2,217
63990706,53,74,51,25,12,5,1,1,222
63990801,5,4,5,2,4,0,0,0,20
63990802,5,14,3,3,1,1,0,0,27
63990803,3,9,4,2,2,0,0,0,20
63990804,12,5,5,1,2,0,0,0,25
63990805,9,6,1,3,0,1,0,0,20
64060101,0,2,0,0,0,1,0,0,3
64060102,1,1,0,0,0,0,0,0,2
64060103,7,2,3,1,1,2,0,0,16
64060104,1,3,1,1,0,1,0,0,7
64060105,2,1,5,1,0,0,0,0,9
64060106,0,1,3,3,0,0,1,0,8
64060107,0,1,0,0,0,0,0,0,1
64060201,40,59,55,67,31,13,7,8,280
64060202,83,112,51,47,20,6,2,0,321
64060203,68,97,67,56,15,3,0,1,307
64060204,53,89,72,56,47,19,8,4,348
64060205,87,124,63,44,21,5,4,1,349
64060206,84,97,57,57,25,5,2,2,329
64060207,39,49,46,39,28,16,7,11,235
64060208,6,7,3,3,2,0,1,1,23
64060209,3,1,1,0,0,0,0,0,5
64060210,10,13,20,21,20,10,6,2,102
64060211,3,6,4,2,2,2,1,0,20
64060212,2,2,1,0,0,1,0,0,6
64060213,6,6,3,2,0,0,0,1,18
64060214,60,62,44,22,21,9,2,3,223
64060215,60,105,58,40,25,5,2,3,298
64060216,58,55,28,32,26,8,3,4,214
64060301,2,2,3,3,0,0,0,0,10
64060302,6,13,8,3,11,4,2,0,47
64060303,4,5,2,0,1,0,0,0,12
64060304,9,4,5,5,0,0,0,1,24
64060305,5,3,3,2,0,0,1,2,16
64060306,3,4,1,2,3,1,0,0,14
64060307,0,0,1,1,2,1,0,0,5
64060308,12,7,6,5,4,2,0,1,37
64060309,0,4,1,1,0,0,0,0,6
64130101,38,61,51,62,33,17,8,9,279
64130102,51,67,64,56,30,20,3,2,293
64130103,39,75,63,72,29,10,3,4,295
64130104,56,113,73,56,33,23,9,9,372
64130105,38,68,64,63,28,9,7,5,282
64130106,63,88,83,68,42,20,12,4,380
64130107,59,83,87,58,19,11,10,4,331
64130108,47,78,82,56,24,8,3,1,299
64130109,62,86,60,47,21,7,0,2,285
64130110,73,94,90,43,30,13,1,0,344
64130201,45,78,94,82,57,30,10,12,408
64130202,40,60,63,71,37,15,4,1,291
64130203,54,74,64,67,37,14,4,8,322
64130204,25,44,67,57,44,23,4,9,273
64130205,47,63,52,76,42,30,7,12,329
64130206,42,59,53,56,43,17,8,16,294
64130207,74,112,77,52,29,12,5,7,368
64130208,70,94,66,45,27,5,9,0,316
64130209,65,97,59,55,21,13,1,0,311
64130210,91,96,65,52,11,3,1,3,322
64130211,101,91,39,44,15,2,4,2,298
64130212,67,106,61,36,17,12,1,1,301
64130213,24,49,62,62,34,18,4,5,258
64130301,65,23,20,20,7,3,0,1,139
64130302,72,90,47,24,19,3,0,1,256
64130303,117,109,43,31,9,2,0,2,313
64130304,55,67,49,28,10,5,1,0,215
64130305,74,72,52,24,14,3,0,1,240
64130306,82,83,48,44,12,1,3,1,274
64130307,67,96,95,59,30,9,4,3,363
64130308,20,39,48,57,26,16,4,7,217
64130309,56,63,70,54,30,26,5,10,314
64130310,58,71,53,56,23,19,4,8,292
64130311,53,68,57,51,27,5,2,4,267
64130401,68,97,39,35,18,6,1,1,265
64130402,69,81,38,22,13,2,0,0,225
64130403,99,104,52,51,10,8,0,0,324
64130404,115,113,73,65,22,10,5,0,403
64130405,74,103,48,45,15,3,0,0,288
64130406,105,96,51,31,6,1,0,2,292
64130407,74,79,46,38,12,5,1,1,256
64130408,94,137,84,82,27,11,2,2,439
64130409,89,133,81,58,15,7,2,1,386
64130410,47,61,39,31,9,4,2,0,193
64130411,70,95,86,70,19,7,3,1,351
64130412,45,69,43,62,14,13,1,1,248
64130413,57,114,79,88,28,10,1,3,380
64130501,135,126,75,34,20,8,1,1,400
64130502,77,97,60,34,20,8,1,1,298
64130503,85,101,69,47,22,5,0,0,329
64130504,91,109,58,37,15,7,1,0,318
64130505,69,54,22,11,2,1,0,0,159
64130506,107,76,44,29,8,2,0,0,266
64130507,104,113,65,65,28,6,2,1,384
64130508,78,104,42,29,14,3,1,0,271
64130509,75,112,66,45,19,8,2,0,327
64130510,45,58,46,27,25,8,0,1,210
64130511,98,103,55,50,19,3,1,1,330
64130512,77,114,67,56,20,4,1,0,339
64130513,40,50,30,16,7,1,3,1,148
64130601,36,54,46,27,25,7,1,1,197
64130602,52,81,62,56,10,13,3,0,277
64130603,84,88,69,59,25,11,0,2,338
64130604,89,118,74,56,25,9,2,0,373
64130605,84,112,63,45,21,13,1,1,340
64130606,81,98,65,43,18,2,0,0,307
64130607,74,126,79,60,26,8,3,2,378
64130608,45,64,53,46,22,15,0,5,250
64130609,50,79,72,72,35,17,5,2,332
64130610,28,61,45,56,28,12,4,5,239
64130611,49,82,53,61,32,11,5,2,295
64130612,38,47,61,49,25,19,4,3,246
64130703,4,3,10,9,7,4,0,0,37
64130704,1,7,5,9,6,2,2,0,32
64130901,4,9,10,7,4,4,2,2,42
64130902,2,1,4,1,0,1,0,0,9
64131101,2,10,12,6,8,2,2,5,47
64131106,7,7,6,10,4,3,2,1,40
64131301,15,31,29,18,15,5,4,1,118
64131302,37,59,81,81,37,26,4,7,332
64131303,26,30,36,32,27,12,4,5,172
64131304,22,56,73,68,41,18,4,4,286
64131305,21,26,32,29,25,17,3,5,158
64131306,4,7,10,7,4,2,1,0,35
64131307,45,74,78,81,46,19,10,5,358
64131308,18,27,28,31,15,11,4,6,140
64131309,28,41,49,46,18,21,4,10,217
64131401,5,8,6,4,6,3,1,3,36
64131402,3,11,9,6,2,3,1,1,36
64131403,12,23,20,13,7,7,1,2,85
64131404,3,2,6,9,2,2,0,0,24
64131405,0,0,0,0,1,0,0,0,1
64131406,17,26,23,36,24,12,4,5,147
64131407,33,53,84,86,43,35,15,22,371
64131408,6,18,38,36,33,19,12,16,178
64131409,8,26,26,35,21,10,2,1,129
64131501,24,24,19,19,8,5,5,4,108
64131502,1,11,3,7,3,1,1,0,27
64131503,6,5,2,7,1,1,0,0,22
64131504,1,0,0,0,1,0,0,0,2
64131505,8,10,12,8,2,0,0,0,40
64131506,2,0,2,2,0,1,0,0,7
64131507,17,18,12,14,5,1,1,0,68
64131508,4,14,8,5,3,0,0,0,34
64131509,8,9,12,2,2,1,0,0,34
64131601,2,2,1,2,1,0,0,0,8
64131801,11,20,20,20,13,10,6,6,106
64131802,6,8,6,6,6,5,1,1,39
64131803,2,5,2,3,2,0,0,0,14
64131804,1,1,0,0,1,0,0,0,3
64131805,2,0,0,1,0,1,0,0,4
64131806,3,5,4,4,1,0,0,0,17
64131901,3,3,1,2,4,2,0,0,15
64131902,27,32,39,30,16,10,5,6,165
64131903,7,6,7,9,6,1,2,2,40
64131904,5,13,11,10,5,2,0,0,46
64131905,3,9,7,11,9,2,0,3,44
64131906,12,7,3,9,4,0,0,0,35
64132101,76,91,104,88,38,23,8,8,436
64132102,43,82,60,53,32,27,3,5,305
64132103,51,73,45,38,19,1,1,0,228
64132104,105,131,93,66,31,15,6,5,452
64132105,70,87,57,38,24,7,3,1,287
64132106,53,63,43,30,10,8,2,1,210
64132107,53,89,49,46,19,11,0,0,267
64132108,79,102,101,81,41,18,10,6,438
64132109,94,114,92,90,55,13,8,7,473
64132110,84,115,99,64,21,8,1,0,392
64132201,15,22,26,27,14,7,5,2,118
64132202,27,19,18,25,8,8,5,7,117
64132203,3,13,8,13,4,1,0,0,42
64132204,3,18,11,9,6,1,1,1,50
64132205,19,44,32,29,25,15,2,12,178
64132206,20,28,21,24,7,5,1,2,108
64132207,11,10,20,17,7,3,0,0,68
64132208,15,29,26,23,12,3,0,2,110
64132209,28,27,31,18,16,6,1,1,128
64132210,20,39,29,45,20,4,0,0,157
64132211,41,53,48,40,18,3,1,0,204
64132212,11,31,18,28,7,2,0,0,97
64200101,2,1,1,1,2,0,0,0,7
64200102,17,31,27,34,20,14,6,6,155
64200103,21,30,21,18,7,7,3,2,109
64200104,29,40,34,49,34,20,9,7,222
64200105,24,31,17,13,5,2,1,0,93
64200106,19,26,20,10,5,1,1,1,83
64200107,15,13,14,8,7,1,1,0,59
64200108,16,23,18,13,7,3,1,0,81
64200109,24,40,29,20,13,5,1,2,134
64200110,26,38,42,31,23,10,4,7,181
64200111,29,48,24,11,7,0,1,1,121
64200112,12,20,13,8,3,1,1,0,58
64200113,15,30,8,8,1,0,1,0,63
64200114,20,17,13,13,4,0,1,0,68
64200115,25,24,9,9,1,1,0,0,69
64200116,34,45,47,23,13,6,0,3,171
64200201,8,11,5,4,1,0,0,0,29
64200202,10,16,9,1,0,1,0,0,37
64200203,9,16,8,2,1,0,0,0,36
64200204,14,14,4,9,4,2,0,0,47
64200205,14,6,1,2,0,0,0,0,23
64200206,8,7,6,2,1,0,2,0,26
64200207,25,13,13,4,0,0,0,0,55
64200208,16,40,14,8,8,2,0,0,88
64200209,15,31,9,7,2,1,2,0,67
64200210,16,18,13,7,3,1,0,1,59
64200211,19,21,9,11,3,0,0,0,63
64200212,30,28,20,16,14,4,1,0,113
64200213,31,41,44,40,19,15,2,5,197
64200214,20,30,26,12,7,1,0,0,96
64200215,48,35,17,18,7,4,2,1,132
64200216,49,47,48,32,28,15,1,7,227
64200301,22,22,9,12,8,2,1,0,76
64200302,18,28,10,17,4,1,0,0,78
64200303,22,16,16,6,2,1,0,0,63
64200304,17,34,17,17,8,6,4,1,104
64200305,23,26,19,16,11,6,2,0,103
64200306,21,31,17,9,4,1,1,2,86
64200307,19,25,26,13,7,5,1,1,97
64200308,28,45,23,21,16,5,0,3,141
64200309,15,15,12,17,13,6,5,3,86
64200310,23,14,8,11,5,7,1,3,72
64200311,19,39,28,26,16,4,2,1,135
64200312,25,25,16,16,6,2,0,2,92
64200313,13,15,3,3,4,0,0,2,40
64200314,11,20,9,4,5,0,0,0,49
64200315,6,4,3,2,3,2,0,0,20
64200316,6,18,1,4,5,1,0,0,35
64200317,21,24,5,5,1,2,0,0,58
64200318,9,16,3,4,2,2,1,2,39
64200319,15,18,8,12,1,3,1,0,58
64200320,17,30,25,21,16,13,3,7,132
64200401,18,20,7,4,3,1,0,0,53
64200402,26,18,10,7,4,2,1,3,71
64200403,26,28,26,22,13,7,4,7,133
64200404,15,21,18,18,9,10,3,6,100
64200405,15,25,16,13,4,3,2,1,79
64200406,25,21,23,13,12,3,2,3,102
64200407,22,33,18,23,11,4,2,1,114
64200408,21,17,11,4,3,1,0,0,57
64200409,16,13,8,2,3,3,0,1,46
64200410,28,30,18,29,4,7,1,0,117
64200411,15,29,18,22,10,6,0,1,101
64200412,30,20,20,12,4,9,5,3,103
64200413,13,20,12,7,4,3,2,0,61
64200414,21,19,14,14,8,0,1,0,77
64200415,15,31,11,5,4,4,0,2,72
64200416,20,25,15,8,2,0,0,0,70
64200417,10,14,5,7,1,1,0,0,38
64200418,12,11,9,5,4,1,0,0,42
64200419,18,32,11,11,4,1,1,0,78
64200501,1,1,0,1,0,0,1,0,4
64200502,18,11,2,3,2,1,0,0,37
64200503,40,43,36,32,11,3,2,0,167
64200504,49,50,28,22,9,3,0,0,161
64200505,26,35,37,20,14,5,1,2,140
64200506,46,70,51,37,17,5,2,0,228
64200507,25,45,30,37,29,6,2,0,174
64200508,27,51,50,45,20,10,5,4,212
64200509,45,51,60,52,32,21,3,10,274
64200510,15,30,22,16,9,4,0,2,98
64200511,27,24,16,11,2,1,1,1,83
64200512,13,33,14,12,5,2,0,0,79
64200601,23,30,12,8,3,3,0,0,79
64200602,7,5,5,2,0,0,0,0,19
64200603,22,36,5,5,0,0,1,0,69
64200604,16,18,8,9,3,0,3,0,57
64200605,19,19,6,3,1,1,0,1,50
64200606,7,3,3,1,1,0,0,0,15
64200607,20,6,6,6,2,2,0,0,42
64200608,20,31,17,4,3,1,1,0,77
64200609,16,24,14,7,3,0,0,2,66
64200610,20,14,8,5,2,0,1,0,50
64200611,4,1,2,0,0,1,0,0,8
64200612,15,7,2,4,1,0,0,0,29
64200701,26,14,8,4,2,1,0,0,55
64200702,7,16,2,5,0,0,0,0,30
64200703,5,5,1,2,0,0,0,0,13
64200704,12,12,9,6,1,0,0,0,40
64200705,12,24,9,6,3,0,0,0,54
64200706,19,33,12,17,5,2,0,0,88
64200707,19,22,15,9,2,1,0,0,68
64200708,18,19,13,1,2,0,0,0,53
64200709,7,11,5,1,0,0,0,0,24
64200710,10,18,9,3,1,0,0,0,41
64200711,11,18,5,2,4,0,0,1,41
64200801,51,54,63,49,16,16,8,10,267
64200802,45,52,58,49,29,19,3,7,262
64200803,24,36,24,20,10,7,4,0,125
64200804,26,37,21,16,10,7,3,0,120
64200805,56,35,24,18,14,2,1,0,150
64200806,16,36,16,11,4,7,1,1,92
64200807,30,38,16,17,6,4,0,0,111
64200808,19,25,14,16,7,5,0,0,86
64200809,17,24,5,5,2,0,0,1,54
64200901,47,69,68,64,42,24,7,11,332
64200902,25,27,35,29,19,17,7,4,163
64200903,29,51,43,27,23,16,7,4,200
64200904,21,24,29,14,9,2,0,2,101
64200905,19,28,13,8,6,2,0,0,76
64200906,13,18,12,9,5,3,0,0,60
64200907,20,32,12,15,4,1,0,2,86
64200908,12,21,18,18,6,5,0,2,82
64200909,7,23,7,7,5,0,0,1,50
64200910,10,14,10,10,0,3,1,0,48
64200911,15,23,12,4,5,1,2,2,64
64200912,3,12,3,4,1,0,0,0,23
64201001,14,19,24,20,14,12,4,3,110
64201002,14,17,10,7,3,0,1,0,52
64201003,11,11,5,1,0,1,0,0,29
64201004,27,21,8,10,3,1,2,0,72
64201005,26,34,20,20,11,5,5,1,122
64201006,27,30,19,15,11,4,1,4,111
64201007,42,33,26,14,4,8,2,1,130
64201008,13,19,8,6,2,3,0,0,51
64201009,13,22,8,11,5,0,0,0,59
64201010,21,24,20,14,11,4,0,2,96
64201011,23,35,27,16,12,5,1,1,120
64201012,8,21,12,4,2,7,0,4,58
64201013,21,40,19,14,7,6,2,1,110
64201101,10,21,8,18,4,4,2,0,67
64201102,13,16,5,8,4,1,0,0,47
64201103,13,14,7,7,1,1,0,0,43
64201104,14,19,16,10,5,2,1,0,67
64201105,8,21,9,10,2,5,3,1,59
64201106,18,12,23,17,8,7,2,2,89
64201107,12,21,5,9,4,2,2,2,57
64201108,8,16,8,4,2,1,0,0,39
64201109,8,20,7,3,1,0,0,0,39
64201110,27,35,21,15,15,5,1,2,121
64201111,21,17,18,8,4,3,2,1,74
64201112,13,20,14,14,21,8,3,5,98
64201113,16,20,16,13,6,6,1,2,80
64201114,25,26,11,9,2,0,1,0,74
64201115,20,23,10,9,6,1,1,1,71
64201116,27,31,20,21,9,4,2,1,115
64201117,19,31,31,25,12,10,3,4,135
64201201,19,36,23,20,4,8,6,1,117
64201202,1,6,2,0,4,0,1,0,14
64201203,30,36,16,8,5,5,1,0,101
64201204,8,19,5,5,4,2,2,0,45
64201205,16,28,9,5,6,5,0,0,69
64201206,16,18,10,10,4,3,1,0,62
64201207,17,14,7,6,1,0,0,0,45
64201208,20,41,11,12,5,1,0,0,90
64201209,0,0,0,0,0,0,0,0,0
64201210,5,10,2,0,2,0,0,0,19
64201211,17,22,7,8,4,0,1,2,61
64201212,11,15,6,8,3,1,2,0,46
64201213,7,19,7,10,3,2,1,0,49
64201214,9,21,18,26,17,8,6,5,110
64201301,4,11,3,5,1,0,0,0,24
64201302,12,18,6,4,3,1,0,0,44
64201303,12,9,13,4,3,3,0,0,44
64201304,7,1,4,2,2,0,0,0,16
64201305,9,16,2,3,1,0,0,0,31
64201306,16,19,13,6,3,2,0,0,59
64201307,16,32,12,12,7,3,2,2,86
64201308,10,16,5,3,3,0,2,0,39
64201309,14,12,7,7,2,3,2,0,47
64201310,22,28,10,11,5,0,0,1,77
64201311,14,25,11,11,7,4,2,0,74
64201401,15,19,11,7,3,1,0,1,57
64201402,13,14,3,3,3,0,0,0,36
64201403,16,29,20,24,12,7,0,0,108
64201404,34,37,46,25,12,7,3,4,168
64201405,7,16,6,6,2,1,0,0,38
64201406,5,13,2,3,0,1,1,0,25
64201407,7,10,3,1,2,0,0,0,23
64201408,9,9,6,5,1,1,0,0,31
64201409,9,14,4,5,0,1,0,0,33
64201410,8,11,0,5,1,0,0,0,25
64201501,4,4,1,2,1,0,0,0,12
64201502,9,11,4,0,0,0,0,0,24
64201503,7,16,3,2,1,0,1,0,30
64201504,4,7,4,1,0,1,0,0,17
64201505,10,9,3,4,0,0,0,0,26
64201506,7,23,15,7,2,1,1,0,56
64201507,12,11,3,4,1,1,0,0,32
64201508,35,42,26,30,14,6,2,1,156
64201509,16,29,27,18,4,2,3,1,100
64201510,17,43,37,41,17,8,1,0,164
64201601,6,9,5,2,0,0,0,0,22
64201602,0,12,3,3,1,0,0,0,19
64201603,10,10,4,5,0,1,0,0,30
64201604,2,9,2,1,0,0,0,1,15
64201605,6,7,0,0,1,0,0,0,14
64201606,5,7,2,2,1,1,0,0,18
64201607,5,6,2,3,0,0,0,0,16
64201608,3,12,4,5,1,0,0,0,25
64201609,10,16,1,5,3,1,0,0,36
64201610,9,13,9,2,4,0,0,0,37
64201611,22,35,41,26,24,16,5,2,171
64201612,35,51,48,44,20,12,0,0,210
64201701,19,27,12,12,4,2,0,0,76
64201702,2,0,2,1,0,0,0,0,5
64201703,8,11,3,3,0,0,0,0,25
64201704,9,10,8,5,1,0,0,0,33
64201705,6,15,7,5,1,0,0,0,34
64201706,8,14,3,1,1,0,0,0,27
64201707,13,14,12,3,0,1,1,0,44
64201708,23,30,35,18,12,8,2,3,131
64201709,34,43,38,33,16,17,8,7,196
64201710,18,26,22,23,16,8,4,0,117
64201801,3,8,2,1,0,2,0,0,16
64201802,4,7,3,1,0,0,0,0,15
64201803,14,9,6,3,1,0,0,0,33
64201804,5,11,4,3,0,0,0,0,23
64201805,8,4,7,1,2,1,0,0,23
64201806,4,10,2,4,1,0,0,0,21
64201807,9,7,4,3,0,0,0,0,23
64201808,25,31,24,19,10,3,2,0,114
64201809,10,10,6,7,4,1,0,0,38
64201810,9,7,4,2,1,0,0,0,23
64201811,5,4,1,0,0,0,0,0,10
64201812,41,36,32,34,18,10,2,1,174
64201901,7,2,1,0,0,0,0,0,10
64201902,6,4,5,1,1,0,0,0,17
64201903,31,19,18,18,9,4,0,1,100
64201904,27,36,22,19,16,9,1,3,133
64201905,31,39,32,24,16,11,3,2,158
64201906,29,53,37,29,16,8,3,3,178
64201907,27,43,27,23,12,7,6,3,148
64201908,27,26,12,7,3,3,0,1,79
64201909,18,19,13,7,4,0,0,0,61
64201910,37,42,28,16,7,2,1,3,136
64201911,26,25,20,16,8,8,1,3,107
64201912,17,20,7,5,2,3,0,0,54
64202001,27,59,44,52,18,4,2,1,207
64202002,23,51,18,25,9,2,1,1,130
64202003,19,31,15,16,7,3,1,1,93
64202004,12,18,9,4,1,0,0,0,44
64202005,15,17,4,7,1,0,0,0,44
64202006,21,12,10,7,1,0,0,0,51
64202007,16,9,4,1,2,0,0,0,32
64202008,9,11,0,4,1,0,0,0,25
64202009,23,16,9,4,1,0,0,0,53
64202010,24,22,12,6,4,2,0,0,70
64202011,11,12,13,6,2,2,0,0,46
64202012,15,27,7,9,0,0,0,0,58
64202013,26,22,15,16,6,0,0,1,86
64202101,29,20,15,10,5,1,0,0,80
64202102,19,19,13,14,2,1,0,0,68
64202103,34,45,24,28,13,5,0,0,149
64202104,42,30,22,28,14,5,3,1,145
64202105,34,41,18,28,16,2,0,1,140
64202106,55,80,39,36,16,10,3,2,241
64202107,40,48,55,39,24,15,0,5,226
64202108,49,75,67,56,38,11,3,11,310
64202109,56,66,84,76,48,29,12,12,383
64202110,44,34,46,38,16,17,2,3,200
64202111,37,27,38,34,34,17,7,3,197
64202112,45,62,48,48,37,26,6,7,279
64202201,18,23,34,32,30,18,4,9,168
64202202,38,47,38,42,34,19,12,7,237
64202203,16,45,31,23,11,8,6,6,146
64202204,10,23,15,12,3,2,0,0,65
64202205,22,25,14,14,3,1,2,0,81
64202206,28,34,21,15,16,3,1,3,121
64202207,20,20,14,5,2,2,1,1,65
64202208,15,21,11,11,4,3,0,4,69
64202209,18,22,21,27,18,13,2,8,129
64202210,20,22,6,7,6,1,0,1,63
64202211,14,23,6,9,2,2,2,1,59
64202212,15,18,9,8,3,2,0,0,55
64202213,13,26,7,11,4,2,0,1,64
64202214,7,4,4,8,1,0,1,1,26
64410101,68,86,59,43,25,8,4,6,299
64410102,94,82,57,41,21,7,0,1,303
64410103,51,63,55,33,18,7,4,2,233
64410104,57,74,47,51,19,7,1,2,258
64410105,72,79,41,29,6,1,0,0,228
64410106,64,74,32,20,11,4,2,1,208
64410107,69,86,37,23,17,7,5,0,244
64410108,48,59,38,30,10,4,0,0,189
64410109,81,86,62,49,16,8,2,1,305
64410110,113,108,51,43,16,6,0,3,340
64410111,61,65,33,21,12,1,0,2,195
64410112,119,93,53,26,9,7,0,2,309
64410113,37,62,41,27,10,4,0,0,181
64410201,107,55,27,16,2,3,1,1,212
64410202,111,82,21,14,4,0,0,1,233
64410203,109,97,45,23,3,2,2,0,281
64410204,81,69,32,14,7,3,1,1,208
64410205,104,93,28,13,3,1,0,0,242
64410206,123,114,39,17,8,1,1,2,305
64410207,226,125,34,21,5,0,0,1,412
64410208,13,17,10,4,0,1,0,0,45
64410209,161,107,63,44,14,2,1,0,392
64410210,134,115,64,37,23,8,0,1,382
64410211,63,66,32,37,8,14,1,2,223
64410301,48,66,43,28,21,6,2,0,214
64410302,101,122,84,66,28,13,0,1,415
64410303,74,49,30,20,9,5,1,1,189
64410304,80,81,36,37,8,4,1,0,247
64410305,82,82,42,32,15,4,0,1,258
64410306,91,118,49,26,9,3,0,1,297
64410307,117,135,49,40,17,6,1,0,365
64410308,72,70,50,28,15,2,1,1,239
64410401,120,124,63,46,17,7,0,0,377
64410402,119,105,61,40,17,9,1,2,354
64410403,97,124,65,64,14,4,3,1,372
64410404,56,55,39,33,7,1,0,0,191
64410405,67,59,29,22,11,8,1,2,199
64410406,85,98,32,28,7,2,0,0,252
64410407,109,116,46,31,10,1,0,0,313
64410408,117,104,39,21,10,3,0,0,294
64410409,112,102,48,17,9,2,0,0,290
64410410,119,94,33,19,6,1,0,0,272
64410411,139,128,47,31,5,2,0,1,353
64410412,95,101,43,34,10,3,0,0,286
64410413,66,74,40,23,2,3,0,0,208
64410414,106,82,29,14,7,3,4,0,245
64410501,105,104,50,29,10,3,0,2,303
64410502,84,97,58,20,12,3,1,1,276
64410503,67,85,27,28,6,9,1,1,224
64410504,103,77,38,20,9,4,0,0,251
64410505,78,67,16,9,4,1,1,0,176
64410506,88,67,32,21,7,4,0,0,219
64410507,48,54,21,15,5,2,0,0,145
64410508,78,77,23,18,12,2,0,0,210
64410509,54,46,34,18,2,3,0,0,157
64410601,104,96,36,7,2,3,0,0,248
64410602,100,55,11,5,1,0,0,0,172
64410603,113,86,18,8,2,0,0,0,227
64410604,90,65,20,9,4,1,0,1,190
64410605,137,94,21,13,5,0,0,1,271
64410606,94,69,24,14,2,1,0,0,204
64410607,81,82,32,18,3,3,0,0,219
64410608,92,64,20,8,5,1,0,0,190
64410609,118,113,41,19,5,2,0,0,298
64410701,67,49,23,8,0,0,0,0,147
64410702,79,71,19,14,8,0,0,0,191
64410703,106,111,42,20,7,0,0,1,287
64410704,82,91,28,18,3,2,1,0,225
64410705,169,111,21,13,5,2,0,0,321
64410706,56,84,28,8,2,3,0,0,181
64410707,139,86,28,12,3,1,0,0,269
64410708,86,46,22,14,4,0,0,0,172
64410709,98,91,35,16,6,0,0,0,246
64410801,151,111,36,13,2,3,0,0,316
64410802,143,72,30,10,0,1,0,0,256
64410803,67,30,16,4,1,0,0,1,119
64410804,59,42,22,13,5,0,0,0,141
64410805,75,50,22,7,3,0,0,0,157
64410806,15,12,7,7,1,0,0,0,42
64410807,90,62,16,7,3,1,0,1,180
64410808,99,89,33,9,1,0,0,0,231
64410809,129,77,27,10,1,1,0,0,245
64410901,59,50,26,11,3,2,2,0,153
64410902,125,99,45,16,4,2,1,1,293
64410903,71,66,34,14,13,1,1,1,201
64410904,122,117,43,20,2,1,1,2,308
64410905,81,94,32,15,8,1,0,0,231
64410906,102,93,44,17,5,4,0,1,266
64410907,95,85,42,17,6,2,0,0,247
64410908,85,88,19,9,5,4,2,0,212
64410909,124,82,22,11,2,2,0,0,243
64410910,29,23,9,9,1,0,0,0,71
64410911,87,90,22,6,4,0,1,0,210
64410912,141,87,38,14,4,0,0,0,284
64410913,113,86,16,14,3,2,0,0,234
64410914,71,77,24,15,5,3,0,0,195
64411001,78,101,86,86,32,10,3,4,400
64411002,43,56,54,43,8,4,2,0,210
64411003,44,69,45,43,16,4,1,0,222
64411004,61,73,40,25,9,1,0,0,209
64411005,51,57,37,22,9,1,0,2,179
64411006,84,100,57,48,16,5,1,1,312
64411007,58,79,33,24,9,4,0,0,207
64411008,64,71,43,37,11,3,2,3,234
64411009,103,130,65,52,15,3,2,1,371
64411010,53,66,34,26,10,4,1,1,195
64411011,46,56,49,26,13,2,0,1,193
64411012,96,99,32,17,1,2,1,0,248
64411013,71,80,52,23,12,1,1,2,242
64411014,76,59,32,16,6,1,0,1,191
64411015,79,67,17,11,2,0,0,1,177
64411101,64,62,33,25,8,1,2,0,195
64411102,93,87,54,31,5,4,0,1,275
64411103,56,65,34,20,13,2,0,3,193
64411104,44,63,30,23,7,4,2,0,173
64411105,58,84,41,36,8,1,0,0,228
64411106,57,59,32,23,5,3,1,0,180
64411107,48,65,33,18,8,1,0,0,173
64411108,67,64,35,19,5,1,1,0,192
64411109,72,67,35,18,5,3,0,0,200
64411110,76,55,29,13,9,1,0,0,183
64411111,104,105,40,29,15,3,1,1,298
64411112,121,118,56,56,15,4,1,2,373
64411113,105,112,55,30,18,3,0,0,323
64411114,89,104,57,29,13,1,0,0,293
64411115,75,65,34,23,3,2,0,0,202
64411116,75,70,37,12,8,1,0,0,203
64411201,97,90,19,4,4,1,0,0,215
64411202,129,84,20,12,1,2,0,0,248
64411203,53,59,23,9,5,0,0,0,149
64411204,96,76,24,14,3,0,2,2,217
64411205,119,116,47,18,7,1,0,0,308
64411206,69,70,33,11,4,2,0,0,189
64411207,101,84,24,18,4,0,1,2,234
64411208,75,33,12,8,2,1,0,0,131
64411209,80,52,24,5,2,0,0,0,163
64411210,57,28,15,5,1,0,0,0,106
64411211,130,85,32,11,5,1,0,1,265
64411212,80,56,15,5,3,0,1,1,161
64411213,81,82,30,4,2,0,1,0,200
64411214,64,70,19,9,5,1,1,0,169
64411215,60,63,20,13,0,1,0,0,157
64411216,108,33,27,7,2,0,0,0,177
64411301,88,66,19,13,5,0,1,0,192
64411302,113,96,37,17,3,2,0,0,268
64411303,44,40,12,4,0,0,0,0,100
64411304,111,100,49,16,3,1,1,0,281
64411305,59,61,10,9,1,2,0,0,142
64411306,49,58,23,14,2,2,0,1,149
64411307,78,86,28,16,6,1,0,0,215
64411308,73,85,19,15,5,3,0,0,200
64411309,123,84,34,11,2,3,0,0,257
64411401,94,47,17,10,5,0,0,0,173
64411402,66,63,18,6,0,0,0,2,155
64411403,92,64,23,5,5,1,0,0,190
64411404,112,96,34,17,2,1,0,0,262
64411405,135,113,32,15,1,4,0,1,301
64411406,56,66,22,9,3,2,1,0,159
64411407,95,71,32,13,4,0,0,0,215
64411408,91,89,27,18,6,0,0,0,231
64411409,83,66,29,11,2,0,0,0,191
64411501,132,102,40,14,0,2,0,0,290
64411502,121,97,42,14,6,3,0,0,283
64411503,95,76,32,14,9,1,1,0,228
64411504,93,79,41,20,6,2,0,0,241
64411505,126,92,36,13,4,3,0,2,276
64411506,80,87,27,15,1,1,0,1,212
64411507,90,94,31,10,7,1,0,1,234
64411508,96,84,16,4,1,1,0,0,202
64411509,149,117,36,14,10,3,0,0,329
64411510,79,97,55,23,12,4,0,0,270
64411511,106,86,32,14,8,1,0,0,247
64411512,80,62,33,14,4,2,0,0,195
64411601,113,98,65,39,12,1,1,0,329
64411602,66,64,33,21,15,5,1,1,206
64411603,78,65,38,23,8,2,0,0,214
64411604,66,83,33,25,6,3,0,0,216
64411605,47,48,38,32,12,3,1,0,181
64411606,91,112,67,50,20,11,0,0,351
64411607,97,104,71,49,22,12,1,0,356
64411608,42,72,38,25,16,5,2,0,200
64411609,51,71,33,36,25,3,1,0,220
64411610,111,125,71,55,24,9,1,2,398
64411611,115,118,61,40,16,6,0,0,356
64411612,81,94,43,30,13,5,1,1,268
64411613,48,57,33,19,6,2,0,1,166
64411614,108,110,69,29,11,5,0,0,332
64411615,32,36,9,7,2,2,0,1,89
64411701,65,59,32,22,9,4,1,0,192
64411702,62,62,45,30,7,7,0,0,213
64411703,70,76,47,43,18,8,1,1,264
64411704,45,65,35,40,12,5,0,1,203
64411705,73,110,48,53,19,8,1,2,314
64411706,52,58,41,24,10,4,0,1,190
64411707,51,54,43,27,12,5,1,0,193
64411708,75,92,40,27,10,0,1,0,245
64411709,62,66,29,25,11,1,0,2,196
64411710,34,61,32,34,13,3,2,0,179
64411711,50,65,41,32,10,4,2,1,205
64411712,70,95,57,43,25,6,1,1,298
64411713,46,63,50,26,16,6,2,2,211
64411801,72,56,20,11,0,1,0,0,160
64411802,116,68,22,12,4,1,0,0,223
64411803,85,45,25,12,3,1,1,0,172
64411804,58,68,28,17,5,1,1,1,179
64411805,88,91,26,26,10,2,1,0,244
64411806,43,54,31,25,10,3,0,2,168
64411807,92,75,35,23,12,2,1,0,240
64411808,107,99,47,25,7,5,0,0,290
64411809,80,68,21,26,7,2,0,0,204
64411810,109,66,40,26,8,5,1,1,256
64411811,144,147,54,30,14,3,0,0,392
64411812,73,73,30,21,10,3,0,0,210
64411813,73,65,36,23,6,0,0,0,203
64411901,89,116,42,19,4,4,1,0,275
64411902,106,96,65,31,17,2,0,0,317
64411903,72,78,42,27,5,4,1,1,230
64411904,86,67,43,21,7,2,0,0,226
64411905,71,44,22,14,3,3,0,0,157
64411906,68,99,36,31,11,4,1,1,251
64411907,87,73,29,25,4,4,0,0,222
64411908,50,65,25,19,10,1,0,0,170
64411909,75,74,29,20,5,0,1,0,204
64411910,67,67,23,16,8,2,0,1,184
64411911,82,77,43,28,6,5,0,0,241
64412001,96,124,49,38,12,3,0,0,322
64412002,78,67,42,27,10,1,1,0,226
64412003,105,92,34,24,7,4,0,2,268
64412004,56,61,32,13,3,1,0,0,166
64412005,83,72,35,16,4,4,0,0,214
64412006,59,69,35,27,13,3,2,1,209
64412007,61,71,24,21,7,0,1,0,185
64412008,87,77,39,20,5,0,0,0,228
64412009,99,93,39,23,5,2,0,1,262
64412010,61,65,31,12,9,0,0,0,178
64412011,63,52,11,10,3,1,0,0,140
64412012,65,37,19,8,1,1,0,0,131
64412013,66,52,23,3,4,0,0,0,148
64412014,34,17,3,1,2,0,0,0,57
64412015,62,69,21,7,2,2,0,0,163
64412016,75,47,18,9,1,0,1,0,151
64412017,47,41,30,17,7,4,1,0,147
64412101,52,68,31,27,10,4,1,0,193
64412102,71,71,40,23,8,2,2,1,218
64412103,109,131,63,55,16,8,1,0,383
64412104,101,127,73,49,14,7,0,0,371
64412105,61,120,57,51,23,6,0,0,318
64412106,58,62,39,24,12,2,0,0,197
64412107,62,59,41,24,9,3,1,0,199
64412108,62,74,31,17,8,4,0,0,196
64412109,66,69,33,21,11,2,1,1,204
64412110,64,71,49,32,5,3,0,1,225
64412111,50,73,28,26,8,3,1,0,189
64412112,58,68,35,29,9,1,4,0,204
64412113,109,121,55,45,13,6,1,2,352
64412114,61,57,44,21,14,4,1,1,203
64412115,103,112,56,51,17,8,3,0,350
64412201,73,91,52,38,6,3,0,0,263
64412202,72,74,63,44,20,11,1,3,288
64412203,103,113,77,48,12,9,0,0,362
64412204,102,135,70,47,16,8,0,0,378
64412205,67,82,71,51,22,6,1,0,300
64412206,60,69,58,32,11,1,0,2,233
64412207,43,69,39,42,15,5,1,2,216
64412208,51,74,52,49,15,7,3,2,253
64412209,54,71,58,48,16,5,1,1,254
64412301,80,78,51,33,9,4,1,0,256
64412302,54,57,37,25,8,5,0,0,186
64412303,68,74,41,31,19,0,1,0,234
64412304,55,58,36,28,10,2,2,0,191
64412305,54,73,53,29,15,6,1,0,231
64412306,64,85,28,32,14,3,1,0,227
64412307,53,74,59,39,17,9,2,1,254
64412308,63,81,47,32,14,1,0,0,238
64412309,46,62,23,20,11,2,0,1,165
64412401,70,67,34,18,10,4,1,0,204
64412402,48,60,45,37,13,2,0,3,208
64412403,33,50,47,39,14,1,1,1,186
64412404,56,62,39,35,14,5,1,0,212
64412405,96,119,95,67,28,4,0,2,411
64412406,107,107,62,38,6,4,1,0,325
64412407,65,47,34,28,12,2,2,0,190
64412408,59,71,26,23,9,2,1,2,193
64412409,83,87,61,29,13,3,0,0,276
64412410,59,60,39,15,14,0,0,0,187
64412411,66,121,75,80,24,8,1,2,377
64412501,95,84,30,16,4,2,0,1,232
64412502,71,111,40,24,14,4,1,0,265
64412503,53,77,29,22,10,3,2,2,198
64412504,68,60,36,20,1,2,0,0,187
64412505,96,118,54,41,14,4,4,0,331
64412506,59,80,49,31,7,4,1,0,231
64412507,72,74,35,20,7,6,1,0,215
64412508,63,62,40,32,17,8,2,0,224
64412509,58,61,40,29,7,3,0,0,198
64412510,89,80,58,27,14,3,2,1,274
64412601,61,69,40,34,9,5,2,0,220
64412602,53,66,44,37,12,2,0,0,214
64412603,74,83,37,26,11,2,0,1,234
64412604,38,53,43,18,9,3,1,0,165
64412605,56,68,28,30,12,1,0,1,196
64412606,73,102,51,63,18,5,2,0,314
64412607,62,79,61,42,16,2,2,2,266
64412608,51,56,37,15,8,1,1,1,170
64412609,51,62,47,28,9,4,1,1,203
64412610,90,135,76,57,37,4,1,0,400
64412611,57,63,47,35,12,4,1,0,219
64412612,80,78,45,27,16,3,0,0,249
64412613,56,70,48,25,14,3,0,0,216
64412614,85,86,48,31,16,4,1,2,273
64412701,97,88,65,55,17,9,0,0,331
64412702,97,106,65,66,17,5,1,1,358
64412703,88,78,64,52,20,7,1,3,313
64412704,76,108,63,47,26,10,0,1,331
64412705,88,114,80,58,25,15,3,1,384
64412706,53,61,47,28,17,8,0,0,214
64412707,63,77,46,34,14,4,0,0,238
64412708,110,107,73,65,19,9,1,0,384
64412709,92,116,64,43,16,13,2,1,347
64412801,65,72,44,26,14,9,0,2,232
64412802,68,97,64,51,15,11,1,0,307
64412803,76,81,38,29,10,4,0,2,240
64412804,55,54,28,25,6,2,1,0,171
64412805,60,57,32,46,12,6,0,0,213
64412806,43,54,52,32,14,1,1,0,197
64412807,38,52,38,27,12,4,0,0,171
64412808,49,69,42,38,17,2,0,0,217
64412809,53,84,41,43,15,5,2,0,243
64412810,87,82,54,36,13,2,0,0,274
64412811,71,97,53,61,24,5,1,1,313
64412812,83,110,72,63,29,9,2,3,371
64412813,89,105,70,53,22,15,1,1,356
64412901,59,67,41,31,12,1,1,0,212
64412902,63,60,36,28,12,7,1,3,210
64412903,57,76,52,30,18,8,0,0,241
64412904,38,64,35,35,11,6,0,0,189
64412905,46,64,63,36,17,6,2,0,234
64412906,47,65,40,25,13,4,1,2,197
64412907,77,80,33,31,13,7,1,0,242
64412908,32,65,42,30,16,4,1,1,191
64412909,83,93,62,46,14,5,0,0,303
64412910,61,51,34,33,12,8,1,2,202
64412911,59,55,33,29,5,5,3,0,189
64412912,33,60,37,31,14,4,0,1,180
64412913,70,113,65,46,24,8,4,0,330
64412914,68,119,66,52,27,3,1,1,337
64413001,37,71,83,61,38,14,5,7,316
64413002,58,76,74,82,37,20,7,6,360
64413003,53,77,54,49,33,11,4,4,285
64413004,66,93,81,73,38,13,2,1,367
64413005,36,66,49,49,25,8,1,5,239
64413006,77,86,90,62,21,18,4,4,362
64413007,43,65,37,27,17,4,0,1,194
64413008,41,61,45,42,25,9,1,1,225
64413009,63,77,82,44,21,13,5,7,312
64413101,59,103,69,74,43,14,2,13,377
64413102,42,60,49,42,21,7,7,3,231
64413103,35,62,50,46,18,2,3,0,216
64413104,46,48,24,32,17,9,0,1,177
64413105,43,69,42,39,8,4,0,0,205
64413106,39,85,62,46,21,15,2,2,272
64413107,43,68,57,39,19,4,3,0,233
64413108,47,67,49,33,9,3,3,0,211
64413109,47,68,46,42,21,5,3,3,235
64413110,39,57,55,50,12,5,0,0,218
64413111,77,103,75,90,36,14,3,2,400
64413112,57,78,65,56,24,8,2,2,292
64413113,54,50,44,40,15,11,0,2,216
64413114,42,81,54,48,17,17,1,1,261
64413115,45,63,58,43,15,10,3,1,238
64413116,49,53,40,55,20,8,2,2,229
64413201,43,59,49,29,19,5,0,2,206
64413202,34,45,36,35,21,11,1,0,183
64413203,100,86,82,81,34,17,5,2,407
64413204,77,89,72,94,53,20,1,4,410
64413205,58,120,82,77,31,13,2,7,390
64413206,59,88,68,51,24,14,1,4,309
64413207,69,86,58,68,28,18,3,4,334
64413208,58,79,61,62,32,18,3,6,319
64413209,51,69,46,42,24,11,0,5,248
64413210,57,67,59,56,34,11,5,3,292
64413211,47,98,80,78,43,26,6,1,379
64413301,98,104,63,43,20,11,3,3,345
64413302,28,58,47,29,6,1,2,2,173
64413303,60,76,51,53,24,6,4,3,277
64413304,44,68,40,40,18,7,3,3,223
64413305,46,58,67,56,19,16,4,2,268
64413306,85,93,96,90,48,14,4,3,433
64413307,41,75,61,34,20,4,5,3,243
64413308,51,68,49,36,18,6,2,0,230
64413309,80,103,96,82,19,16,2,4,402
64413310,63,97,60,54,28,5,5,2,314
64413311,78,107,98,83,35,19,1,2,423
64413401,39,62,46,39,17,8,1,3,215
64413402,41,66,56,50,24,10,3,2,252
64413403,53,85,74,77,49,23,10,8,379
64413404,50,51,70,47,24,13,1,2,258
64413405,56,80,59,66,32,11,8,5,317
64413406,37,53,65,46,29,11,4,2,247
64413407,44,64,50,52,20,13,3,2,248
64413408,78,105,73,65,25,7,3,2,358
64413409,33,53,66,36,21,10,2,2,223
64413410,29,64,53,58,23,6,3,3,239
64413411,36,46,54,40,31,10,9,5,231
64413412,24,27,40,49,14,7,3,1,165
64413413,38,52,73,64,36,15,10,13,301
64413414,36,55,60,59,35,19,15,12,291
64413415,39,85,100,80,59,47,26,24,460
64413501,66,103,61,74,42,23,5,7,381
64413502,87,107,83,65,25,11,6,4,388
64413503,54,62,37,37,8,4,3,2,207
64413504,40,52,56,29,17,6,1,0,201
64413505,58,85,89,82,44,11,5,3,377
64413506,50,57,50,36,29,14,3,2,241
64413507,40,66,72,58,27,15,2,5,285
64413508,48,73,78,89,37,30,8,3,366
64413509,57,93,85,64,30,16,6,10,361
64413510,40,66,62,78,39,25,10,14,334
64413511,66,101,102,100,38,13,7,3,430
64413512,78,83,85,55,24,13,7,4,349
64413513,71,118,76,60,31,6,4,3,369
64413514,36,78,73,60,38,8,5,2,300
64413515,42,82,97,96,52,40,12,13,434
64413516,89,148,162,160,91,67,22,13,752
64413601,67,72,57,54,21,14,4,0,289
64413602,36,77,60,35,27,24,4,8,271
64413603,52,56,48,44,21,9,3,2,235
64413604,32,56,43,59,19,8,1,2,220
64413605,79,75,72,70,38,14,7,3,358
64413606,24,60,72,60,51,32,15,26,340
64413607,35,70,58,52,26,17,6,7,271
64413608,51,61,70,54,18,7,2,1,264
64413609,56,66,67,72,26,10,7,5,309
64413610,65,92,81,69,32,20,5,8,372
64413611,43,71,73,66,31,18,7,5,314
64413612,43,58,62,72,40,27,10,13,325
64413701,49,73,49,72,48,28,5,14,338
64413702,45,59,78,67,58,34,10,18,369
64413703,16,27,23,42,33,36,11,9,197
64413704,22,30,40,42,35,16,5,19,209
64413705,34,48,65,67,53,41,10,19,337
64413706,53,73,68,76,42,25,9,12,358
64413707,48,73,45,40,22,15,5,3,251
64413708,60,54,53,56,39,25,4,6,297
64413709,73,91,93,66,31,13,6,3,376
64413710,59,94,80,80,58,30,8,11,420
64413711,45,74,73,72,51,31,25,17,388
64413712,79,84,77,86,44,25,12,6,413
64413713,34,42,52,58,35,16,4,14,255
64413714,64,54,76,71,40,27,7,14,353
64413801,69,100,121,118,57,25,3,8,501
64413802,33,45,46,56,28,21,11,10,250
64413803,49,43,62,53,33,18,6,6,270
64413804,32,34,52,42,32,18,9,5,224
64413805,44,57,66,62,31,19,5,4,288
64413806,47,41,77,71,41,17,6,7,307
64413807,49,69,84,84,38,17,4,4,349
64413808,26,42,40,38,25,25,4,8,208
64413809,29,63,59,64,43,35,6,12,311
64413810,62,72,47,61,43,12,4,4,305
64413901,78,79,64,49,28,9,1,0,308
64413902,58,55,55,41,18,2,0,3,232
64413903,31,63,56,48,24,5,2,3,232
64413904,41,67,61,57,27,9,3,3,268
64413905,53,72,61,56,26,9,2,1,280
64413906,51,65,70,56,35,17,5,4,303
64413907,22,56,42,51,31,24,7,5,238
64413908,51,56,61,69,34,15,7,2,295
64413909,50,57,51,57,34,11,8,3,271
64413910,52,84,92,109,49,24,14,11,435
64414001,29,76,60,53,32,19,3,4,276
64414002,48,65,49,50,34,15,6,5,272
64414003,45,69,50,53,12,8,1,0,238
64414004,50,49,51,50,24,1,2,1,228
64414005,30,50,38,32,19,9,3,1,182
64414006,57,91,76,72,28,16,2,6,348
64414007,48,55,67,48,37,28,4,6,293
64414008,35,59,53,50,28,17,10,13,265
64414009,38,57,58,61,22,19,16,9,280
64414010,50,66,86,64,48,29,12,16,371
64414011,55,84,70,78,46,30,12,11,386
64414012,38,55,57,73,49,32,14,14,332
64414013,55,66,88,99,42,45,16,20,431
64414101,71,84,107,127,93,62,18,26,588
64414102,46,36,64,76,47,33,18,16,336
64414103,41,62,78,62,49,40,11,14,357
64414104,60,85,87,100,46,22,6,12,418
64414105,56,78,91,86,49,27,6,10,403
64414106,39,51,56,57,32,22,6,9,272
64414107,40,62,71,50,31,21,10,8,293
64414108,57,85,84,99,65,34,13,9,446
64414109,35,69,68,60,52,25,18,13,340
64414110,36,47,56,48,38,25,18,20,288
64414111,12,32,24,27,13,10,4,1,123
64414112,24,34,33,40,34,11,2,6,184
64414201,47,68,109,113,87,51,13,20,508
64414202,30,24,32,47,29,23,9,12,206
64414203,31,62,69,83,54,33,13,12,357
64414204,42,56,74,71,41,33,15,9,341
64414205,34,52,65,90,52,38,14,15,360
64414206,54,63,104,96,65,33,17,17,449
64414207,41,54,75,86,58,35,16,16,381
64414208,23,48,53,51,30,12,7,7,231
64414209,34,61,48,57,43,15,13,12,283
64414210,55,91,92,94,52,45,15,25,469
64414211,48,55,61,52,47,18,12,5,298
64414212,61,45,63,51,33,13,9,8,283
64414213,21,18,25,34,15,15,5,4,137
64414214,10,18,26,33,20,16,2,6,131
64414215,39,39,74,92,69,63,33,38,447
64414216,41,75,60,81,53,39,4,11,364
64414217,50,90,86,76,50,29,12,15,408
64414218,51,85,95,77,46,28,5,8,395
64414219,46,74,77,76,42,32,10,13,370
64414301,53,66,42,49,31,13,7,4,265
64414302,55,75,71,51,30,10,3,2,297
64414303,37,61,54,52,23,13,1,0,241
64414304,67,92,75,60,28,16,3,3,344
64414305,50,45,59,43,23,10,4,4,238
64414306,39,71,72,76,44,8,8,4,322
64414307,30,42,53,48,28,19,4,5,229
64414308,21,43,56,69,28,17,6,5,245
64414309,62,81,80,75,39,20,3,7,367
64414310,49,88,91,88,52,34,10,11,423
64414311,26,42,45,55,28,18,7,7,228
64414312,37,41,48,41,21,15,5,8,216
64414313,30,45,54,63,28,15,5,4,244
64414314,46,52,85,57,39,27,8,14,328
64414315,53,80,104,106,55,30,12,21,461
64414401,51,75,48,49,34,17,3,6,283
64414402,30,59,66,42,28,15,5,6,251
64414403,38,60,70,78,53,36,19,14,368
64414404,41,49,49,61,27,18,5,8,258
64414405,35,59,68,70,39,14,8,7,300
64414406,42,66,56,62,38,18,1,11,294
64414407,37,95,78,79,47,28,8,15,387
64414408,21,38,48,48,27,21,14,12,229
64414409,29,33,58,45,31,27,10,19,252
64414410,57,84,108,109,78,87,29,50,602
64414501,29,40,54,65,26,10,5,1,230
64414502,35,70,46,61,25,18,7,2,264
64414503,52,53,68,64,37,19,2,3,298
64414504,46,63,51,77,51,28,14,17,347
64414505,24,45,49,58,35,25,6,8,250
64414506,46,57,73,58,37,24,8,10,313
64414507,29,67,68,50,40,38,13,5,310
64414508,36,58,73,52,42,22,12,10,305
64414509,39,65,66,70,55,36,8,17,356
64414510,39,43,67,71,53,36,14,16,339
64414511,42,55,90,72,53,27,22,21,382
64414601,44,59,68,61,26,19,11,7,295
64414602,50,75,70,81,44,23,6,6,355
64414603,37,59,57,60,42,20,5,3,283
64414604,63,61,66,54,30,12,3,4,293
64414605,41,60,49,54,22,14,6,7,253
64414606,56,46,46,50,22,6,4,2,232
64414607,49,89,59,65,23,15,1,1,302
64414608,49,74,63,76,34,17,7,6,326
64414609,40,69,61,64,41,25,7,15,322
64414701,81,99,105,102,66,42,13,12,520
64414702,48,75,82,83,37,20,9,14,368
64414703,50,56,65,66,47,15,6,10,315
64414704,63,116,96,98,56,18,7,2,456
64414705,57,79,80,83,32,17,5,7,360
64414706,40,72,65,51,33,16,5,6,288
64414707,78,116,121,101,41,27,9,3,496
64414708,63,73,57,58,45,26,6,12,340
64414709,95,82,119,126,82,52,12,22,590
64414710,20,32,44,60,50,25,10,16,257
64414801,53,97,66,56,38,9,7,3,329
64414802,27,38,33,39,20,9,2,6,174
64414803,68,69,36,27,22,15,2,5,244
64414804,62,120,79,92,39,20,4,1,417
64414805,41,51,47,32,17,7,3,4,202
64414806,53,62,57,53,27,16,10,5,283
64414807,71,87,76,52,23,14,7,2,332
64414808,36,48,43,30,21,11,1,7,197
64414809,50,59,45,48,23,9,1,1,236
64414901,52,93,70,58,26,10,3,2,314
64414902,61,77,59,52,20,3,2,0,274
64414903,56,107,59,44,23,10,0,1,300
64414904,44,76,42,35,17,2,0,0,216
64414905,54,66,31,21,10,4,1,3,190
64414906,77,81,47,37,17,3,1,1,264
64414907,61,91,66,37,20,6,1,0,282
64414908,36,59,49,33,10,4,2,0,193
64414909,62,85,44,40,16,3,0,0,250
64414910,62,55,49,23,6,4,2,0,201
64415001,36,63,41,34,16,6,1,1,198
64415002,54,43,46,36,15,9,1,0,204
64415003,83,137,75,64,27,11,4,4,405
64415004,39,68,40,35,14,6,2,0,204
64415005,37,76,29,33,16,4,2,2,199
64415006,54,76,47,32,17,7,2,0,235
64415007,42,52,41,25,15,3,1,0,179
64415008,61,71,40,36,16,9,1,1,235
64415009,57,68,49,50,20,8,0,0,252
64415010,64,75,55,40,23,3,2,1,263
64415101,61,96,107,127,80,66,27,32,596
64415102,35,37,51,55,36,24,9,13,260
64415103,46,52,40,45,17,8,2,1,211
64415104,49,80,60,41,34,18,5,5,292
64415105,75,108,78,79,36,18,6,2,402
64415106,29,36,32,26,21,16,7,11,178
64415107,42,68,37,49,25,16,3,6,246
64415108,56,77,69,48,22,5,4,1,282
64415109,53,58,46,34,18,4,1,1,215
64415110,39,48,31,37,10,5,1,0,171
64415111,55,79,47,42,17,7,0,0,247
64415112,29,53,41,29,16,7,2,0,177
64415113,52,65,41,34,10,7,2,2,213
64415114,49,61,45,44,18,6,2,2,227
64415115,39,67,44,37,14,7,3,2,213
64415116,30,39,31,26,17,12,2,3,160
64415117,95,110,79,82,29,16,6,4,421
64415118,64,84,72,52,34,17,4,6,333
64415201,20,49,62,56,47,31,11,20,296
64415202,45,65,71,40,19,11,2,1,254
64415203,36,67,42,34,13,9,2,1,204
64415204,48,76,75,60,39,27,18,9,352
64415205,29,59,64,56,33,10,12,11,274
64415206,24,34,44,39,14,9,2,5,171
64415207,53,89,59,69,32,7,7,5,321
64415208,58,67,65,54,17,14,6,2,283
64415209,38,51,39,35,14,5,1,3,186
64415210,61,77,46,44,16,6,0,2,252
64415301,38,71,38,40,17,7,3,0,214
64415302,57,107,84,78,33,14,3,1,377
64415303,36,50,38,43,20,2,1,1,191
64415304,53,80,55,58,32,13,4,2,297
64415305,48,69,88,82,47,29,8,17,388
64415306,46,66,56,36,18,6,1,5,234
64415307,41,51,60,35,19,6,1,1,214
64415308,39,72,61,55,28,12,5,3,275
64415309,60,86,84,82,32,15,6,4,369
64415310,31,61,68,93,58,32,21,27,391
64415401,31,54,73,80,40,14,4,3,299
64415402,28,49,50,64,40,18,5,10,264
64415403,46,58,70,64,32,14,2,2,288
64415404,48,80,48,42,25,5,1,1,250
64415405,47,113,85,99,24,16,2,1,387
64415406,22,55,27,34,11,4,1,0,154
64415407,51,73,49,47,20,9,3,0,252
64415408,23,57,31,38,16,3,0,0,168
64415409,39,70,43,33,22,6,1,0,214
64415410,45,51,65,85,33,10,3,1,293
64415411,24,40,42,49,26,10,1,2,194
64415412,45,48,70,92,35,12,5,1,308
64415413,15,28,26,36,14,5,2,0,126
64415414,34,45,60,48,30,14,7,7,245
64415415,32,36,43,44,21,19,6,3,204
64415416,35,43,67,54,27,5,6,3,240
64415417,50,73,83,72,46,18,8,4,354
64415418,44,90,72,66,29,13,4,0,318
64415501,55,74,105,111,79,31,13,19,487
64415502,53,83,103,103,70,39,19,26,496
64415503,33,33,33,48,39,15,3,8,212
64415504,30,46,57,47,25,17,2,6,230
64415505,38,71,55,78,40,32,4,3,321
64415506,54,68,69,86,39,13,2,4,335
64415507,37,61,57,46,31,9,2,0,243
64415508,47,67,70,94,36,14,3,3,334
64415509,31,39,61,65,32,12,1,5,246
64415510,20,25,23,23,23,13,2,1,130
64415511,23,38,37,47,31,14,7,8,205
64415601,38,56,49,77,32,11,4,2,269
64415602,55,70,82,98,43,20,1,0,369
64415603,29,48,48,38,21,6,2,0,192
64415604,36,85,65,44,24,7,2,2,265
64415605,59,107,96,88,34,14,4,1,403
64415606,53,100,97,80,37,18,1,3,389
64415607,42,65,68,77,33,8,1,2,296
64415608,60,103,90,96,53,18,4,2,426
64415701,10,12,11,4,3,0,0,1,41
64415702,48,54,48,55,32,14,4,0,255
64415703,23,14,36,55,39,16,5,4,192
64415704,48,56,39,54,29,10,3,2,241
64415705,46,79,77,70,61,16,6,9,364
64415706,60,81,85,99,46,24,10,5,410
64415707,56,87,93,105,57,34,9,13,454
64415708,66,55,59,66,33,9,0,1,289
64415709,23,41,52,68,35,17,4,5,245
64415710,19,49,48,55,33,23,9,4,240
64415711,46,63,70,94,40,11,12,4,340
64415712,43,94,69,84,43,11,0,0,344
64415713,29,52,52,63,36,10,1,1,244
64415801,42,78,52,49,15,10,1,0,247
64415802,46,61,46,56,24,10,0,0,243
64415803,44,72,65,58,22,11,3,1,276
64415804,37,59,38,30,11,5,0,0,180
64415805,29,56,38,25,15,3,2,0,168
64415806,38,60,46,27,19,6,1,0,197
64415807,31,51,50,45,29,16,2,4,228
64415808,35,71,35,26,19,4,0,3,193
64415901,48,45,58,36,29,9,2,1,228
64415902,38,60,43,55,22,11,7,2,238
64415903,28,68,45,30,19,13,1,0,204
64415904,45,80,58,59,25,12,1,2,282
64415905,51,81,43,45,20,5,0,1,246
64415906,36,69,47,38,20,10,0,4,224
64415907,47,70,65,59,39,18,1,3,302
64415908,51,76,64,80,41,16,6,3,337
64415909,41,60,51,60,39,10,3,3,267
64415910,61,105,76,79,30,23,6,5,385
64416001,65,77,74,77,40,21,4,6,364
64416002,36,68,45,42,21,7,4,2,225
64416003,44,58,47,51,31,18,6,2,257
64416004,56,87,82,75,42,21,12,7,382
64416005,46,68,78,82,55,37,12,23,401
64416006,40,62,57,55,19,7,3,4,247
64416007,29,62,52,72,40,23,5,7,290
64416008,27,50,49,58,21,10,7,1,223
64416009,40,60,87,80,46,17,7,8,345
64416010,41,61,65,70,37,14,2,1,291
64416101,69,77,59,30,11,2,2,2,252
64416102,33,55,41,40,25,10,4,5,213
64416103,42,45,43,53,25,12,4,3,227
64416104,39,60,49,38,25,11,0,5,227
64416105,50,77,51,68,29,6,2,5,288
64416106,35,92,83,86,44,19,5,6,370
64416107,41,64,46,67,35,8,2,1,264
64416108,14,13,13,26,15,9,1,4,95
64416109,31,57,44,46,29,17,3,1,228
64416110,41,52,41,52,21,8,3,2,220
64416111,34,76,57,58,27,8,1,3,264
64416112,44,62,46,41,29,17,3,3,245
64416201,17,29,19,27,13,5,0,1,111
64416202,34,50,61,62,26,15,5,6,259
64416203,37,60,47,43,22,12,3,4,228
64416204,41,85,58,52,31,9,2,3,281
64416205,16,14,16,13,5,1,0,0,65
64416206,69,90,61,38,20,7,1,0,286
64416207,36,56,40,48,13,9,0,0,202
64416208,53,80,73,67,31,17,5,5,331
64416209,32,48,37,40,23,12,5,0,197
64416210,28,39,34,42,24,12,3,1,183
64416211,63,73,81,101,68,25,9,17,437
64416212,28,39,36,38,17,10,5,4,177
64416213,42,60,68,59,62,30,10,20,351
64416301,41,45,42,49,30,6,2,1,216
64416302,29,55,55,50,21,6,2,1,219
64416303,37,74,54,60,27,13,7,2,274
64416304,27,64,53,91,34,12,5,7,293
64416305,23,49,38,39,24,3,3,1,180
64416306,33,49,51,65,37,12,0,5,252
64416307,36,62,37,45,23,13,3,6,225
64416308,38,36,49,26,23,5,1,6,184
64416309,17,22,29,31,26,11,1,3,140
64416310,29,42,44,56,33,12,3,3,222
64416311,26,29,25,30,17,8,2,3,140
64416401,62,82,83,95,45,19,11,5,402
64416402,25,28,26,29,16,8,7,1,140
64416403,11,22,33,24,20,9,9,9,137
64416404,16,26,37,26,25,15,6,7,158
64416405,19,23,22,31,14,16,5,6,136
64416406,21,23,33,33,27,7,5,6,155
64416407,32,35,28,30,20,8,4,0,157
64416408,9,11,11,7,6,3,0,1,48
64416409,50,76,72,88,55,30,13,11,395
64416410,5,4,12,8,4,2,2,0,37
64416411,22,44,40,36,32,8,2,1,185
64416412,20,22,36,25,14,5,0,0,122
64416413,12,8,17,28,19,6,1,0,91
64416414,15,37,31,50,21,7,1,2,164
64416415,35,70,72,82,41,20,3,6,329
64416416,20,32,30,37,21,7,2,1,150
64416417,15,35,44,43,35,26,12,8,218
64416418,10,30,34,53,27,18,4,1,177
64416419,44,56,72,64,56,17,8,12,329
64416501,20,35,35,29,19,16,6,9,169
64416502,20,27,46,44,26,9,2,5,179
64416503,27,27,29,44,20,16,9,6,178
64416504,7,6,5,10,6,6,0,0,40
64416505,2,8,8,17,17,8,1,11,72
64416506,10,15,23,17,15,8,3,7,98
64416507,12,18,11,12,4,0,5,2,64
64416508,7,10,8,7,5,5,2,1,45
64416509,76,50,50,41,26,24,6,5,278
64416510,54,79,83,81,71,44,15,15,442
64416511,43,48,74,65,48,28,10,10,326
64416512,21,18,18,22,6,9,2,3,99
64416513,18,25,23,36,20,13,8,7,150
64416514,40,42,37,29,26,18,2,12,206
64416515,40,63,66,59,46,20,6,12,312
64416516,34,57,62,61,23,16,7,3,263
64416517,46,69,53,82,28,19,17,10,324
64416518,22,33,38,35,30,12,7,9,186
64416519,47,59,86,63,53,22,9,13,352
64416520,36,56,36,37,24,11,4,5,209
64416521,25,35,23,15,11,1,2,1,113
64416601,26,42,51,57,36,19,3,4,238
64416602,24,43,48,47,33,23,9,14,241
64416603,50,91,87,82,81,58,13,10,472
64416604,48,45,76,77,41,16,0,3,306
64416605,3,3,4,2,3,1,2,1,19
64416606,36,49,51,54,39,15,6,11,261
64416607,48,85,78,99,42,25,7,6,390
64416608,51,69,64,52,27,19,4,9,295
64416609,30,43,66,80,52,20,9,11,311
64416610,27,44,59,43,29,10,2,5,219
64416611,50,84,90,94,27,18,4,5,372
64416612,36,62,74,74,48,18,15,10,337
64416613,14,30,47,37,29,23,12,12,204
64416614,35,45,60,41,25,17,5,7,235
64416615,49,64,74,86,53,48,4,21,399
64416616,32,46,63,56,35,14,12,8,266
64416617,57,65,71,60,45,39,9,7,353
64416618,30,59,60,62,44,26,3,9,293
64416701,21,23,22,28,12,8,2,6,122
64416702,5,11,9,6,6,4,1,0,42
64416703,5,20,14,24,18,3,1,2,87
64416704,25,17,19,13,13,8,6,7,108
64416801,29,40,43,53,28,27,7,5,232
64416802,60,74,97,109,58,24,14,10,446
64416803,21,56,55,50,27,13,10,6,238
64416804,35,52,43,50,35,11,4,3,233
64416805,61,80,76,72,40,16,5,6,356
64416806,21,18,30,37,29,10,6,11,162
64416807,30,39,34,33,14,12,3,1,166
64416808,21,43,28,34,13,5,2,0,146
64416809,22,41,31,30,11,4,0,2,141
64416810,14,22,15,14,4,3,0,0,72
64416811,14,31,33,14,10,5,1,3,111
64416812,20,21,22,21,7,1,1,3,96
64416813,11,5,4,6,5,3,2,0,36
64416814,30,33,28,31,28,15,9,12,186
64416815,18,27,21,37,25,12,3,4,147
64416816,40,30,32,30,20,11,1,3,167
64416817,6,9,12,5,3,3,0,1,39
64416901,34,51,81,72,52,38,10,6,344
64416902,50,77,68,69,37,26,7,5,339
64416903,49,71,65,70,35,24,8,4,326
64416904,68,79,82,72,49,40,5,7,402
64416905,37,70,61,73,37,22,6,4,310
64416906,57,89,76,97,74,33,19,13,458
64416907,27,33,57,43,37,13,8,9,227
64416908,40,55,70,66,51,41,11,15,349
64416909,57,72,63,75,44,21,8,10,350
64416910,41,66,36,48,23,13,3,2,232
64416911,42,53,61,77,37,23,6,20,319
64416912,17,19,19,28,17,14,1,0,115
64417001,66,89,79,87,49,28,15,11,424
64417002,30,49,47,54,30,26,12,12,260
64417003,29,38,41,49,36,21,6,4,224
64417004,38,82,104,89,65,47,16,16,457
64417005,39,59,78,78,36,36,8,12,346
64417006,29,49,60,76,32,29,11,12,298
64417007,40,52,48,44,20,12,3,5,224
64417101,14,13,9,6,4,1,0,0,47
64480101,26,35,22,14,7,6,0,2,112
64480102,2,2,2,1,1,0,0,0,8
64480103,5,6,1,2,0,0,0,0,14
64480201,1,2,3,2,1,0,0,1,10
64480202,4,1,0,1,0,0,0,0,6
64480203,6,5,2,0,2,1,0,0,16
64480301,1,3,1,2,0,0,0,0,7
64480302,3,0,0,0,0,2,0,0,5
64480303,1,1,2,1,0,0,0,0,5
64480401,2,1,4,1,1,0,0,0,9
64480402,1,1,0,1,0,0,1,0,4
64480403,0,0,0,0,0,0,0,0,0
64480501,1,2,2,1,2,1,0,2,11
64480502,1,3,0,1,0,2,1,0,8
64480503,1,1,1,0,0,1,0,0,4
64480601,101,116,96,87,37,15,5,7,464
64480602,89,91,66,62,32,6,9,2,357
64480603,62,65,45,30,28,12,4,4,250
64480604,80,91,41,27,11,4,1,0,255
64480605,51,58,41,27,15,5,3,1,201
64480606,69,66,75,59,37,8,8,11,333
64480607,65,87,44,46,28,12,3,0,285
64480608,87,97,64,75,38,14,3,7,385
64480609,45,46,34,52,26,13,6,8,230
64480610,15,15,8,12,10,1,0,2,63
64480611,0,0,2,3,1,0,0,0,6
64480612,11,11,3,5,2,0,0,0,32
64480613,0,0,0,1,1,0,0,0,2
64480614,35,62,50,43,28,18,3,7,246
64480701,2,2,1,2,1,2,0,0,10
64480702,0,0,0,0,1,0,0,0,1
64480703,0,2,1,2,0,0,0,0,5
64480801,2,0,0,3,0,0,0,0,5
64480802,0,3,2,2,1,0,0,0,8
64480803,2,2,0,2,0,0,2,0,8
64480901,0,2,1,1,1,0,0,0,5
64480902,3,5,0,0,0,0,0,0,8
64480903,0,1,1,0,0,1,0,0,3
64480904,1,1,0,3,1,0,0,0,6
64481001,0,0,3,1,2,0,0,0,6
64481002,1,1,2,3,0,0,0,0,7
64481003,1,0,1,1,0,0,0,0,3
64481004,1,1,1,0,0,0,0,0,3
64481101,1,2,1,1,1,0,0,0,6
64481102,3,1,0,4,1,0,0,1,10
64481103,4,0,1,1,0,0,0,0,6
64481201,2,2,3,0,0,0,0,0,7
64481202,2,1,0,2,0,0,0,0,5
64481203,3,2,1,1,1,0,0,0,8
64481204,0,0,3,0,0,1,0,0,4
64481205,3,4,4,4,1,0,0,0,16
64481206,2,1,0,0,1,0,0,0,4
64550101,62,86,71,51,28,10,4,2,314
64550102,77,84,53,32,14,7,3,0,270
64550103,69,82,51,29,12,6,0,2,251
64550104,63,68,39,31,15,8,2,0,226
64550105,48,63,60,36,28,16,5,2,258
64550106,52,77,59,51,29,11,5,4,288
64550107,28,38,27,40,23,14,6,7,183
64550108,50,55,60,46,29,16,3,5,264
64550109,62,73,57,34,26,7,3,1,263
64550110,65,87,53,38,20,6,0,2,271
64550111,21,31,39,31,9,8,3,1,143
64550112,30,55,40,32,14,8,5,2,186
64550113,36,57,46,46,14,10,2,0,211
64550114,59,63,50,51,22,5,4,3,257
64550115,27,32,26,45,14,6,1,3,154
64550201,11,7,5,5,4,0,0,0,32
64550301,11,12,9,7,5,2,1,0,47
64550401,22,21,11,16,4,3,2,1,80
64550501,10,5,4,6,1,1,0,0,27
64550601,14,17,10,9,7,2,1,1,61
64550602,8,8,0,1,1,0,0,0,18
64550603,11,14,3,6,3,2,1,0,40
64550604,23,9,7,11,2,2,2,0,56
64550605,7,8,2,2,2,1,0,0,22
64550606,1,3,3,3,4,0,1,0,15
64550607,14,18,10,6,4,2,0,1,55
64550701,18,15,15,11,4,2,1,0,66
64550801,6,8,1,1,1,0,0,1,18
64550802,6,10,2,5,0,2,1,0,26
64550901,8,11,7,5,5,0,0,0,36
64551001,5,4,4,5,6,0,0,1,25
64551101,12,19,9,10,7,1,0,1,59
64551201,9,21,13,6,8,5,0,0,62
64551301,46,39,29,10,16,5,1,1,147
64551401,34,68,63,72,45,21,13,4,320
64551402,56,83,89,84,51,39,8,17,427
64551403,28,36,25,22,12,12,4,5,144
64551404,35,41,41,24,14,5,0,0,160
64551405,70,72,60,43,25,6,3,1,280
64551406,77,105,67,41,21,6,3,1,321
64551407,60,93,63,53,22,12,1,2,306
64551408,72,95,65,53,26,14,3,1,329
64551409,20,17,10,17,7,3,2,1,77
64551410,50,75,55,38,28,22,10,6,284
64551411,42,47,43,48,27,8,0,1,216
64551412,77,111,76,51,24,13,2,1,355
64551413,87,107,50,51,16,4,5,1,321
64551414,70,74,44,33,15,2,2,2,242
64620101,4,2,3,1,2,0,0,0,12
64620201,6,10,4,6,4,2,1,0,33
64620202,0,6,3,3,0,0,0,0,12
64620203,2,1,1,1,1,0,1,0,7
64620301,3,3,2,0,1,0,0,0,9
64620401,28,26,19,18,15,3,2,0,111
64620402,77,80,51,37,20,8,1,2,276
64620403,94,118,69,67,27,10,4,3,392
64620404,8,13,5,4,4,3,1,0,38
64620405,10,11,7,2,3,2,0,1,36
64620406,31,29,20,15,9,5,0,1,110
64620501,1,0,1,2,1,1,0,0,6
64620502,2,2,5,1,2,0,0,0,12
64620601,21,22,16,28,11,4,2,0,104
64620602,1,1,2,4,0,0,0,0,8
64620603,5,3,4,3,2,1,0,0,18
64620604,5,1,2,4,0,1,0,0,13
64620605,2,5,5,1,0,1,1,0,15
64620701,65,95,56,49,27,17,3,7,319
64620702,65,99,58,38,27,3,2,0,292
64620703,91,118,79,62,34,11,1,2,398
64620704,59,62,57,56,35,23,7,3,302
64620705,101,99,47,32,26,3,4,0,312
64620706,103,120,81,74,34,24,5,5,446
64620707,95,91,86,63,40,13,12,1,401
64620708,83,77,62,32,15,11,0,2,282
64620709,1,3,3,1,1,0,0,0,9
64620710,10,11,4,8,3,1,1,2,40
64620711,1,0,3,2,1,0,1,0,8
64620712,0,0,2,1,0,0,0,0,3
64620801,5,4,1,8,6,3,0,2,29
64620802,24,52,75,85,52,24,8,7,327
64620901,2,6,2,1,0,1,1,0,13
64621001,8,7,4,1,0,0,0,0,20
64621002,70,70,63,66,29,23,14,11,346
64621101,3,2,5,2,2,1,1,0,16
64621102,1,1,2,1,2,1,0,0,8
64621201,27,26,16,18,12,4,2,7,112
64621202,124,121,83,61,36,13,4,2,444
64621203,67,77,62,47,26,12,7,5,303
64621204,1,3,2,0,1,1,0,0,8
64621205,14,20,23,10,13,7,4,7,98
64621206,2,5,2,1,2,1,0,0,13
64621207,5,6,4,3,1,1,0,2,22
64690101,59,61,60,58,20,10,1,1,270
64690102,87,124,61,38,27,5,4,0,346
64690103,40,61,55,44,19,12,1,4,236
64690104,125,137,92,65,27,10,3,2,461
64690105,44,82,48,37,14,11,4,6,246
64690106,132,110,61,40,15,8,0,1,367
64690107,77,82,44,36,15,6,2,0,262
64690108,102,106,63,56,17,6,2,3,355
64690109,72,123,93,84,39,16,4,4,435
64690110,48,52,57,44,21,11,3,2,238
64690111,45,85,69,64,27,6,0,1,297
64690112,60,71,39,31,11,3,1,2,218
64690113,55,72,54,50,15,12,2,1,261
64690114,47,64,64,49,23,8,3,4,262
64690201,77,96,55,33,10,8,1,0,280
64690202,83,114,65,48,23,7,3,2,345
64690203,61,67,73,51,38,16,9,6,321
64690204,90,120,78,49,33,14,4,6,394
64690205,100,95,50,36,13,2,0,0,296
64690206,47,71,56,25,11,4,0,2,216
64690207,90,110,56,45,14,4,0,0,319
64690208,77,122,90,60,37,5,3,0,394
64690209,47,64,40,31,15,4,2,3,206
64690210,60,69,58,45,22,13,4,8,279
64690211,51,59,57,46,27,11,5,6,262
64690212,51,54,47,46,27,26,7,6,264
64690213,41,60,35,30,8,5,2,1,182
64690214,44,68,56,51,34,16,5,3,277
64690301,9,12,4,6,2,6,0,0,39
64690302,0,2,6,2,0,2,0,0,12
64690303,8,1,1,0,0,0,0,0,10
64690304,8,2,5,5,3,1,1,2,27
64690305,2,4,3,1,0,0,0,0,10
64690306,9,4,3,0,1,0,0,0,17
64690401,40,74,30,37,11,6,1,2,201
64690402,7,4,3,1,4,0,0,1,20
64690403,0,3,0,3,2,0,0,1,9
64690404,3,1,1,6,2,0,1,0,14
64690405,2,3,1,3,1,2,0,0,12
64690406,3,3,2,3,2,1,1,0,15
64690501,4,0,2,4,0,0,0,1,11
64690502,1,0,1,0,1,1,0,0,4
64690503,3,1,2,2,0,0,0,0,8
64690504,1,1,1,2,1,0,0,0,6
64690601,43,56,44,59,38,9,2,4,255
64690602,47,106,95,87,42,20,7,9,413
64690603,37,61,54,45,26,12,4,4,243
64690604,15,39,24,29,15,14,5,7,148
64690605,47,70,90,94,45,27,6,9,388
64690606,37,78,81,64,56,33,4,9,362
64690701,1,4,1,3,1,0,0,0,10
64690702,0,3,0,2,0,2,0,0,7
64690703,2,3,5,4,0,1,0,0,15
64690801,35,49,46,43,29,16,5,5,228
64690802,10,12,4,11,9,2,0,1,49
64690803,2,6,8,2,3,2,0,0,23
64690804,15,10,3,7,2,1,0,0,38
64690805,5,6,3,3,4,2,0,0,23
64690806,1,9,6,8,5,2,1,0,32
64690807,48,49,23,31,24,4,5,4,188
64690901,68,73,58,22,15,3,2,1,242
64690902,2,4,2,2,0,0,0,0,10
64690903,16,27,24,27,7,10,2,1,114
64690904,2,2,2,2,1,0,0,2,11
64690905,1,2,2,0,1,0,0,0,6
64690906,4,4,2,2,1,1,0,1,15
64690907,2,4,4,1,2,1,0,0,14
64690908,3,3,4,4,1,1,1,1,18
64690909,64,70,51,31,17,8,5,3,249
64691001,38,27,21,21,8,7,2,1,125
64691002,11,19,16,10,13,9,2,1,81
64691003,6,6,4,4,3,0,1,2,26
64691004,5,3,7,3,1,1,0,1,21
64691005,1,0,0,1,0,0,0,1,3
64691006,2,0,1,1,0,0,0,0,4
64691007,29,48,31,28,18,11,5,1,171
64691101,23,37,14,14,2,1,1,2,94
64691102,1,3,2,2,1,0,1,0,10
64691103,3,1,1,0,0,0,0,0,5
64691104,2,5,1,1,4,0,0,0,13
64691105,2,1,2,2,3,0,0,0,10
64691106,45,43,40,32,12,10,1,3,186
64691107,10,4,5,4,5,1,0,0,29
64691201,1,3,1,1,1,1,0,0,8
64691202,2,2,1,4,0,0,0,0,9
64691203,0,2,2,4,4,0,0,0,12
64691204,1,2,2,3,2,0,0,0,10
64691301,72,85,42,33,17,12,4,0,265
64691302,95,126,84,75,29,19,4,3,435
64691303,4,11,4,5,4,3,0,0,31
64691304,3,2,0,2,2,2,0,0,11
64691305,22,26,21,15,25,6,3,2,120
64691306,2,1,4,3,5,2,0,0,17
64691307,40,74,54,42,32,12,3,2,259
64691401,4,4,3,4,2,0,0,0,17
64691402,2,3,3,1,0,0,1,0,10
64691403,5,4,3,8,3,1,0,0,24
64691404,4,1,0,3,1,1,1,1,12
64691501,58,94,72,41,32,16,9,2,324
64691502,3,7,2,1,0,0,0,0,13
64691503,1,1,1,0,1,0,0,0,4
64691504,2,0,0,0,0,0,0,0,2
64691505,0,1,2,1,0,0,0,0,4
64691506,3,4,2,4,2,0,0,1,16
64691507,21,16,11,10,3,6,1,0,68
64691508,54,80,60,39,21,10,5,5,274
64760101,29,50,41,49,33,14,12,5,233
64760102,66,73,61,39,29,16,7,1,292
64760103,59,65,31,29,6,3,1,0,194
64760104,61,54,42,19,8,4,1,1,190
64760105,56,65,45,25,9,6,1,2,209
64760106,39,62,65,42,23,18,6,5,260
64760107,64,71,44,43,21,13,5,4,265
64760108,47,69,79,48,26,14,6,7,296
64760201,101,106,80,66,41,5,6,2,407
64760202,14,17,6,11,3,4,0,0,55
64760203,15,7,5,11,3,0,0,1,42
64760204,11,4,3,4,2,1,0,0,25
64760205,6,5,7,8,6,2,1,1,36
64760206,3,8,4,3,3,0,1,1,23
64760207,5,7,5,6,2,0,0,0,25
64760208,3,5,4,3,2,1,1,1,20
64760301,9,3,7,5,2,2,1,0,29
64760302,9,4,1,2,1,1,0,0,18
64760303,3,2,1,1,1,1,1,0,10
64760401,1,0,5,0,1,0,0,0,7
64760402,7,1,0,0,0,0,0,0,8
64760403,2,3,1,0,1,0,0,0,7
64760404,3,5,5,0,1,1,0,0,15
64760501,3,5,4,2,3,1,2,1,21
64760502,12,3,2,5,3,1,0,0,26
64760503,6,5,1,3,1,0,0,0,16
64760504,1,6,5,1,1,0,0,1,15
64760505,2,3,1,4,0,1,0,0,11
64760601,4,1,3,1,0,0,0,0,9
64760602,2,5,0,3,1,0,1,0,12
64760603,7,11,8,7,2,2,0,0,37
64760604,1,4,0,1,1,0,0,0,7
64760701,17,12,30,21,7,5,2,2,96
64760702,10,13,5,8,7,2,2,1,48
64760703,10,21,19,13,9,4,2,4,82
64760704,12,13,8,8,2,2,1,0,46
64760705,11,12,11,11,3,3,0,0,51
64760706,2,1,3,0,0,0,0,0,6
64760707,21,20,34,21,13,16,4,4,133
64760708,30,45,32,26,26,14,6,3,182
64760709,5,2,4,1,0,1,1,1,15
64760801,4,4,5,5,1,0,0,0,19
64760802,8,4,0,4,0,1,0,0,17
64760803,5,2,3,4,0,0,0,0,14
64760804,6,4,3,1,3,0,0,0,17
64760901,4,3,5,6,1,0,0,0,19
64760902,3,1,7,3,2,0,0,0,16
64760903,5,6,2,3,0,0,0,0,16
64760904,2,2,1,2,1,0,0,0,8
64760905,1,1,3,1,1,0,0,0,7
64761001,6,8,2,6,4,3,0,1,30
64761002,2,4,0,2,1,1,0,0,10
64761003,2,3,1,3,1,0,0,0,10
64761101,2,2,3,0,1,2,0,0,10
64761102,5,5,4,3,1,5,0,1,24
64761103,7,4,3,4,2,0,0,0,20
64761104,1,3,2,1,1,0,0,0,8
64761105,5,3,6,2,3,0,0,0,19
64761201,0,0,1,1,1,0,0,0,3
64761202,9,4,8,2,1,1,1,0,26
64761203,8,8,4,4,1,1,0,0,26
64761204,2,6,4,4,3,1,0,1,21
64761205,8,5,4,5,4,0,0,0,26
64761206,11,3,5,4,2,1,0,1,27
64761301,6,12,6,12,1,0,1,0,38
64761401,32,44,47,60,27,17,8,7,242
64761402,44,75,52,47,39,12,9,5,283
64761403,70,83,62,61,26,13,2,5,322
64761404,50,69,55,42,24,9,5,3,257
64761405,59,62,44,36,8,6,3,2,220
64761406,49,67,40,31,15,4,2,0,208
64761407,39,53,28,18,7,3,0,0,148
64761408,47,93,65,49,25,22,7,4,312
64830101,78,108,96,79,52,18,12,13,456
64830102,61,101,72,66,35,23,4,6,368
64830103,85,97,82,81,27,12,2,2,388
64830104,69,77,44,32,18,7,4,2,253
64830105,61,90,51,45,22,4,2,2,277
64830106,96,82,67,39,19,4,0,0,307
64830107,78,56,38,24,16,2,1,0,215
64830108,77,59,53,30,10,5,1,2,237
64830109,73,81,60,40,14,10,1,1,280
64830110,80,93,57,40,24,10,2,0,306
64830111,59,71,52,36,23,10,4,2,257
64830112,45,55,38,38,21,4,2,2,205
64830113,52,51,56,51,15,11,5,2,243
64830114,43,77,52,50,29,23,11,15,300
64830115,32,43,54,42,21,15,2,5,214
64830116,42,51,47,39,23,14,2,6,224
64830117,61,55,64,48,26,15,6,3,278
64830118,42,48,62,46,26,10,3,2,239
64830201,4,3,0,2,3,0,0,1,13
64830202,7,4,6,9,2,4,1,0,33
64830203,7,5,2,2,2,1,0,3,22
64830301,19,20,13,15,17,5,2,3,94
64830302,10,23,19,11,9,6,6,3,87
64830303,14,13,20,12,6,4,3,1,73
64830304,9,9,8,10,10,3,2,2,53
64830401,68,91,105,114,73,43,10,8,512
64830402,37,49,38,31,19,3,0,3,180
64830403,25,36,36,23,19,10,2,3,154
64830404,58,90,65,81,37,19,7,6,363
64830405,38,69,60,56,33,10,4,4,274
64830406,23,30,11,24,6,8,3,4,109
64830407,57,75,75,76,49,25,9,6,372
64830408,63,60,62,41,17,9,5,2,259
64830409,49,77,64,46,35,12,5,4,292
64830410,21,46,50,36,21,5,1,3,183
64830411,40,61,51,35,9,3,0,2,201
64830412,46,54,66,55,26,10,9,5,271
64830413,57,84,70,86,43,33,10,14,397
64830414,47,60,60,51,24,16,6,5,269
64830415,58,55,65,62,44,19,14,9,326
64830416,33,52,46,43,26,15,5,8,228
64830417,18,24,25,22,11,9,5,4,118
64830501,53,99,65,56,37,18,7,6,341
64830502,7,14,5,7,5,3,1,0,42
64830503,16,19,6,7,5,0,1,3,57
64830504,12,16,15,12,12,2,1,1,71
64830505,12,10,6,3,7,1,1,2,42
64830506,0,4,3,1,0,1,0,0,9
64830601,3,10,6,8,3,0,1,1,32
64830602,14,29,21,27,20,6,0,2,119
64830701,30,32,20,17,9,3,0,1,112
64830702,10,18,11,7,3,1,0,0,50
64830703,5,10,6,1,6,0,1,1,30
64830704,0,2,2,1,3,0,0,0,8
64830705,2,3,6,0,5,0,1,0,17
64830706,4,8,11,4,1,1,1,0,30
64830801,20,33,17,24,4,8,0,0,106
64830802,12,9,10,5,4,3,0,0,43
64830803,5,9,3,7,1,4,0,1,30
64830804,10,8,9,4,0,4,0,1,36
64830805,2,3,3,7,0,0,1,0,16
64830806,25,33,23,29,14,7,2,4,137
64830901,23,23,17,12,6,1,2,3,87
64830902,15,4,9,5,5,1,0,2,41
64830903,18,14,16,11,7,4,2,2,74
64830904,4,11,4,7,6,0,1,1,34
64830905,12,9,7,5,2,3,1,0,39
64830906,6,6,4,5,3,2,1,1,28
64830907,3,8,7,3,3,2,1,0,27
64830908,23,24,11,11,4,6,3,3,85
64831001,11,3,7,4,3,0,0,1,29
64831002,6,13,11,4,12,1,0,0,47
64970101,98,122,61,53,34,12,1,0,381
64970102,53,76,24,26,10,9,2,2,202
64970103,57,60,33,32,13,8,1,0,204
64970104,63,98,82,48,17,3,0,2,313
64970105,75,85,58,44,23,8,2,0,295
64970106,76,112,61,46,20,8,2,2,327
64970107,33,63,51,41,17,8,0,1,214
64970108,28,60,54,46,30,8,3,0,229
64970109,45,57,32,37,20,3,0,2,196
64970110,46,63,54,41,26,12,6,5,253
64970111,47,75,54,44,31,15,5,7,278
64970112,24,44,55,48,30,25,12,14,252
64970201,28,49,25,31,16,9,5,4,167
64970202,7,3,2,7,2,1,0,0,22
64970203,7,14,5,7,5,1,2,0,41
64970204,3,8,5,1,0,3,0,0,20
64970205,0,2,3,1,1,0,0,1,8
64970206,2,4,2,4,2,2,1,0,17
64970207,13,7,6,3,7,7,3,1,47
64970301,1,4,3,1,0,0,0,0,9
64970302,50,77,80,74,46,22,6,14,369
64970303,51,57,52,37,17,8,5,4,231
64970304,6,4,4,5,5,0,0,0,24
64970305,31,59,35,37,32,11,7,1,213
64970306,22,45,43,40,23,17,10,5,205
64970307,60,51,83,80,86,40,13,19,432
64970308,43,57,59,67,46,41,18,19,350
64970309,16,26,37,36,22,7,10,11,165
64970310,22,24,20,16,12,8,9,7,118
64970311,56,70,58,41,29,17,5,7,283
64970312,48,87,88,68,42,27,6,5,371
64970401,6,5,6,7,4,3,1,2,34
64970402,12,14,12,9,8,5,0,0,60
64970403,26,37,15,13,10,3,2,4,110
64970404,49,56,36,39,24,9,4,1,218
64970405,41,35,31,35,16,11,3,9,181
64970406,34,36,33,39,24,11,2,3,182
64970407,27,38,48,39,20,15,3,5,195
64970408,14,16,14,23,14,10,7,5,103
64970409,28,40,45,39,23,22,11,10,218
64970410,29,40,41,40,41,19,9,15,234
64970501,35,66,44,52,21,9,2,1,230
64970502,51,61,49,32,13,7,2,3,218
64970503,35,81,66,73,42,19,6,3,325
64970504,47,45,60,61,56,35,19,11,334
64970505,50,63,76,79,64,49,15,17,413
64970506,55,61,70,69,54,31,16,18,374
64970507,52,70,66,74,36,31,6,10,345
64970508,54,87,66,54,36,14,7,9,327
64970509,69,122,84,79,41,10,1,3,409
64970510,62,100,77,83,49,29,8,21,429
64970511,29,79,70,82,46,24,22,18,370
64970512,43,86,68,63,35,13,9,5,322
64970513,82,92,69,55,34,16,1,3,352
64970601,46,62,65,83,46,19,11,6,338
64970602,44,69,77,87,35,12,5,3,332
64970603,19,34,33,34,17,13,7,7,164
64970604,54,83,62,49,27,13,6,1,295
64970605,43,63,64,71,34,20,3,9,307
64970606,12,18,21,16,16,6,4,7,100
64970607,34,86,72,84,41,29,6,9,361
64970608,4,5,5,5,2,4,1,0,26
64970609,19,28,39,55,34,8,3,2,188
64970610,20,30,45,43,33,13,9,12,205
64970611,30,52,38,45,19,4,1,0,189
64970612,8,14,11,13,9,1,6,2,64
64970613,27,46,45,40,24,9,4,4,199
64970614,20,28,24,27,17,6,4,7,133
64970701,86,92,50,39,22,6,1,1,297
64970702,41,41,21,12,6,5,0,1,127
64970703,55,44,25,14,6,2,1,0,147
64970704,34,51,28,23,5,0,1,0,142
64970705,82,94,54,44,25,5,2,0,306
64970706,106,98,41,30,11,5,0,0,291
64970707,61,43,30,16,3,1,1,0,155
64970708,95,99,48,28,19,4,1,1,295
64970709,52,63,40,29,15,6,2,0,207
64970710,47,59,50,43,19,16,3,1,238
64970801,30,44,50,47,33,7,3,5,219
64970802,32,44,53,69,32,29,9,7,275
64970803,26,60,44,59,26,4,6,7,232
64970804,11,17,9,19,7,2,2,4,71
64970805,7,14,6,11,5,3,2,0,48
64970806,28,54,49,42,22,12,2,4,213
64970807,45,51,50,43,26,14,3,2,234
64970808,8,18,19,14,10,5,2,3,79
64970809,36,56,60,77,38,25,4,1,297
64970810,44,58,64,71,37,13,8,3,298
64970811,61,93,103,88,42,10,5,4,406
64970812,61,129,86,112,72,23,11,8,502
64970813,30,55,44,39,26,6,3,2,205
64970814,44,60,46,37,17,9,5,0,218
64970815,32,73,72,76,33,22,1,9,318
64970901,3,5,7,5,5,4,0,0,29
64971001,37,50,40,46,23,11,4,3,214
64971002,17,11,8,6,4,1,1,1,49
64971003,1,4,4,4,2,2,0,0,17
64971004,8,5,5,6,2,4,0,0,30
64971005,2,5,0,4,0,0,0,0,11
64971006,6,3,5,3,2,1,0,2,22
64971007,2,3,0,2,1,2,0,1,11
64971008,30,47,74,93,50,28,6,8,336
64971101,69,105,72,63,33,14,3,0,359
64971102,93,121,71,46,26,11,6,0,374
64971103,89,96,64,42,23,7,6,1,328
64971104,98,149,58,51,35,8,3,0,402
64971105,91,93,78,60,24,7,2,1,356
64971106,86,109,79,57,31,14,4,2,382
64971107,53,84,69,67,22,8,3,2,308
64971108,50,68,59,46,23,12,3,4,265
64971201,28,64,64,64,39,29,5,9,302
64971202,58,82,94,86,57,24,9,9,419
64971203,49,59,57,68,34,14,6,6,293
64971204,41,57,64,55,28,9,7,4,265
64971205,60,78,89,89,33,11,7,3,370
64971206,42,56,58,80,48,8,1,3,296
64971207,45,69,66,68,45,22,1,5,321
64971208,7,21,16,45,23,4,2,0,118
64971209,8,14,9,5,5,3,0,1,45
64971210,19,26,27,20,21,7,4,3,127
64971211,13,26,27,23,16,12,11,2,130
64971212,11,23,19,25,11,1,1,0,91
64971301,68,84,94,93,58,36,8,19,460
64971302,49,61,63,69,56,35,16,11,360
64971303,30,34,37,35,16,7,3,3,165
64971304,18,28,31,39,12,7,1,1,137
64971305,13,19,14,14,10,4,2,1,77
64971306,72,85,59,60,29,11,2,1,319
64971307,55,56,60,57,17,11,3,2,261
64971308,62,63,61,52,22,8,3,2,273
64971309,26,40,31,25,22,10,4,1,159
64971310,0,8,4,8,8,1,0,0,29
64971311,1,0,2,0,0,0,0,1,4
64971401,62,99,86,79,56,19,10,8,419
64971402,57,106,82,73,42,17,7,10,394
64971403,81,106,119,108,43,30,9,6,502
64971404,4,4,3,5,2,0,2,4,24
64971405,47,54,72,71,42,27,8,10,331
64971406,71,102,85,67,27,24,6,10,392
64971407,58,45,22,16,13,6,2,0,162
64971408,52,64,55,45,18,5,2,2,243
64971409,47,67,57,65,41,20,6,8,311
64971410,45,60,86,57,24,11,4,5,292
65050101,8,9,1,2,5,2,0,0,27
65050102,6,9,9,1,4,5,1,1,36
65050103,19,9,16,13,7,5,2,1,72
65050104,2,0,2,1,2,1,0,0,8
65050105,9,12,5,3,3,1,0,0,33
65050106,5,3,2,3,2,0,0,0,15
65050201,31,38,31,31,14,5,1,2,153
65050202,4,8,5,3,2,0,1,1,24
65050203,1,3,4,2,1,0,0,0,11
65050204,18,24,23,13,19,8,1,2,108
65050205,19,21,20,15,8,6,3,1,93
65050206,10,10,8,7,4,3,1,1,44
65050207,0,3,2,4,2,2,0,0,13
65050208,8,6,2,5,2,1,0,0,24
65050209,7,5,8,8,3,3,0,0,34
65050210,27,34,35,44,22,11,4,6,183
65050211,38,47,35,30,17,8,1,3,179
65050212,37,37,30,20,13,4,5,1,147
65050301,7,13,13,7,3,1,2,2,48
65050302,14,22,13,7,7,0,0,0,63
65050303,18,13,7,11,4,5,2,2,62
65050304,13,19,13,9,7,1,1,3,66
65050305,8,16,7,6,7,5,1,2,52
65050306,50,77,66,53,46,24,5,16,337
65050307,21,42,53,25,17,9,2,4,173
65050308,51,53,47,61,24,13,7,3,259
65050309,46,62,42,47,20,9,6,3,235
65050310,27,32,51,22,13,8,5,5,163
65050311,72,65,41,51,16,6,3,2,256
65050312,56,76,52,24,21,13,1,0,243
65050313,43,35,29,33,9,7,5,0,161
65050314,49,50,40,61,26,23,8,8,265
65050315,50,50,74,52,34,11,6,4,281
65050316,11,18,19,17,14,4,5,0,88
65050317,16,9,20,22,14,7,1,2,91
65050318,16,18,21,20,15,10,1,5,106
65050319,61,79,65,64,27,8,4,2,310
65050320,27,34,50,31,16,14,4,3,179
65050321,28,31,37,31,18,9,3,5,162
65050322,26,24,38,46,27,18,6,8,193
65050401,28,16,15,15,11,7,2,1,95
65050402,26,22,19,15,8,5,1,1,97
65050403,4,9,7,4,4,1,1,0,30
65050404,12,6,5,7,3,1,0,2,36
65050405,2,5,3,2,5,2,0,0,19
65050406,7,8,6,7,5,2,2,1,38
65050407,7,12,7,7,5,5,2,1,46
65110101,5,3,6,3,0,0,0,1,18
65110102,2,1,3,4,0,0,0,0,10
65110201,3,3,6,3,2,0,0,0,17
65110202,6,7,5,3,3,1,1,0,26
65110301,10,6,7,3,3,3,1,0,33
65110302,4,0,4,1,2,0,2,1,14
65110303,6,6,3,4,2,1,0,0,22
65110304,12,7,6,9,3,4,1,0,42
65110401,5,9,5,7,3,1,1,0,31
65110402,4,0,0,0,0,2,0,0,6
65110501,17,28,18,20,8,6,2,1,100
65110502,87,76,52,53,22,8,3,1,302
65110503,81,85,87,68,31,11,7,9,379
65110504,75,68,57,40,21,14,1,1,277
65110505,62,68,70,59,28,11,5,3,306
65110506,63,69,44,36,16,8,2,0,238
65110507,73,83,65,48,17,5,3,3,297
65110508,66,96,59,59,21,14,4,3,322
65110509,35,47,37,39,21,13,1,8,201
65110510,1,3,2,0,0,1,0,0,7
65110511,2,6,3,3,0,2,0,0,16
65110512,65,78,75,68,44,20,3,7,360
65110513,20,41,36,47,25,16,7,5,197
65110601,28,42,28,12,17,6,0,0,133
65110602,11,7,3,5,0,1,0,0,27
65110603,8,7,7,1,0,1,0,0,24
65110701,9,7,2,2,3,0,2,0,25
65110702,5,4,1,4,3,0,0,0,17
65180101,47,49,29,34,11,5,4,7,186
65180102,16,34,35,18,11,5,3,1,123
65180103,42,44,25,34,21,10,5,5,186
65180104,17,15,7,8,6,1,1,0,55
65180105,3,3,1,0,0,0,0,0,7
65180106,0,3,0,0,0,0,0,0,3
65180107,5,2,1,3,0,0,0,0,11
65180108,2,1,2,1,0,0,0,0,6
65180109,2,2,1,4,0,0,0,0,9
65180110,1,1,0,0,1,0,0,0,3
65180111,8,11,8,13,9,0,1,2,52
65180112,3,10,4,3,3,2,0,1,26
65180113,4,4,3,5,1,0,0,0,17
65180114,32,33,23,21,20,10,3,2,144
65180115,30,42,41,39,23,11,5,6,197
65180201,8,14,12,22,13,15,3,9,96
65180202,44,43,32,37,23,11,1,3,194
65180203,56,68,49,34,30,6,2,2,247
65180204,66,91,62,63,29,16,1,4,332
65180205,65,97,53,68,38,18,11,9,359
65180206,27,40,40,36,19,20,7,1,190
65180207,2,5,4,1,4,1,0,1,18
65180208,11,11,5,3,2,3,0,0,35
65180209,15,12,12,13,12,8,2,5,79
65180210,0,0,0,0,0,0,0,0,0
65180211,40,51,39,38,27,9,4,6,214
65180212,28,36,35,35,19,5,5,1,164
65180301,20,15,14,10,7,3,4,2,75
65180302,18,25,23,18,16,6,2,3,111
65180303,21,18,12,6,9,1,0,0,67
65180304,10,13,9,2,5,2,0,1,42
65180305,8,5,6,6,2,0,0,1,28
65180401,2,5,2,3,1,0,0,0,13
65180402,6,5,3,3,2,0,1,0,20
65180403,0,1,2,3,0,0,0,0,6
65180404,10,7,2,2,0,0,0,0,21
65180405,4,3,3,2,2,0,0,0,14
65180406,3,1,2,0,0,0,0,0,6
65180407,1,0,1,1,3,0,0,0,6
65180408,7,2,1,0,0,0,0,0,10
65180409,1,2,1,1,0,0,0,0,5
65180410,3,0,0,2,0,1,0,0,6
65180411,1,0,0,0,0,2,0,0,3
65180412,6,3,0,2,0,0,1,0,12
65180501,2,2,1,2,1,0,2,1,11
65180502,5,3,2,1,0,0,0,0,11
65180503,5,4,4,3,2,0,0,0,18
65180504,40,50,54,47,25,15,4,2,237
65180505,3,3,0,1,0,0,0,0,7
65180506,14,12,14,14,9,4,0,0,67
65180507,1,0,1,2,3,0,1,0,8
65180508,1,2,3,0,0,0,0,0,6
65180509,2,0,1,0,0,0,0,0,3
65180510,4,1,6,7,2,2,0,0,22
65180511,8,12,5,4,2,0,3,0,34
65180601,12,18,8,9,5,1,0,0,53
65180602,22,33,9,8,3,1,1,1,78
65180603,18,29,16,4,7,3,2,0,79
65180604,43,59,38,36,10,3,1,0,190
65180605,11,25,12,13,5,5,2,2,75
65180606,18,23,17,13,8,2,2,3,86
65180607,16,22,13,11,3,1,0,0,66
65180608,1,1,0,1,1,0,0,0,4
65180609,14,21,12,6,7,1,1,0,62
65180610,5,9,8,9,5,1,0,1,38
65180611,9,22,6,5,6,2,2,0,52
65180612,19,23,15,7,6,0,2,3,75
65180613,6,20,10,13,7,2,0,3,61
65180614,21,27,21,16,3,3,2,3,96
65180615,2,4,1,1,0,1,0,0,9
65180701,4,8,4,5,2,3,1,0,27
65180702,7,15,8,8,2,0,2,0,42
65180703,14,17,16,10,8,2,1,2,70
65180704,25,25,9,11,2,3,1,0,76
65180705,24,35,19,12,8,2,0,1,101
65180706,12,22,8,6,3,1,0,0,52
65180707,6,26,13,5,3,0,0,0,53
65180708,29,43,16,22,14,4,0,0,128
65180709,18,20,21,23,12,6,4,1,105
65180710,20,30,19,16,13,5,0,0,103
65180711,17,48,38,40,25,9,8,4,189
65180712,29,50,33,39,22,8,4,4,189
65180713,29,31,24,23,12,6,3,2,130
65180714,27,26,25,21,10,5,0,1,115
65180715,17,42,26,25,8,4,0,1,123
65180716,17,38,24,17,1,3,0,1,101
65180717,27,43,20,12,2,0,0,0,104
65180801,2,1,0,0,0,0,0,0,3
65180802,8,13,5,7,5,3,0,1,42
65180803,14,36,11,10,4,1,1,1,78
65180804,12,21,6,7,2,0,0,1,49
65180805,2,2,0,0,0,0,0,0,4
65180806,2,3,1,1,0,1,0,0,8
65180807,6,8,9,9,1,3,0,0,36
65180808,18,32,15,9,6,0,0,3,83
65180809,28,46,12,14,6,5,2,0,113
65180810,14,20,10,6,2,0,1,1,54
65180811,6,3,2,1,2,1,0,0,15
65180812,15,27,9,5,6,3,0,1,66
65180813,1,2,2,1,0,0,1,0,7
65180814,0,1,0,2,0,0,0,0,3
65250101,15,32,29,33,25,9,4,8,155
65250102,22,25,29,34,21,8,8,9,156
65250103,21,16,28,33,11,12,3,6,130
65250104,24,35,51,41,18,7,6,7,189
65250105,38,36,68,59,37,23,15,8,284
65250106,44,56,75,63,37,25,8,9,317
65250107,99,88,56,43,22,12,2,0,322
65250108,81,83,64,61,36,5,2,0,332
65250109,61,91,75,74,30,11,4,2,348
65250110,55,75,58,40,22,7,0,1,258
65250111,56,90,95,78,36,25,10,9,399
65250112,29,28,46,36,23,19,6,3,190
65250113,22,43,36,40,12,4,2,1,160
65250114,32,47,54,50,31,24,7,11,256
65250201,9,3,7,4,2,2,2,3,32
65250202,8,8,9,7,5,1,1,1,40
65250203,46,57,54,57,46,23,9,13,305
65250204,21,48,19,29,20,7,0,2,146
65250301,4,11,5,8,4,1,1,1,35
65250302,4,8,5,7,6,2,1,2,35
65250303,41,42,85,92,75,59,17,38,449
65250304,29,45,49,46,41,22,12,10,254
65250401,47,75,81,81,67,39,12,11,413
65250402,61,56,84,92,53,46,17,24,433
65250403,22,32,44,50,35,24,10,11,228
65250404,47,41,72,63,44,37,26,22,352
65250405,48,66,78,83,61,47,14,25,422
65250406,52,81,90,86,78,49,18,34,488
65250407,38,41,64,49,35,32,11,11,281
65250408,54,74,83,94,57,36,4,12,414
65250409,57,45,59,62,58,38,11,8,338
65250410,2,3,3,3,0,1,0,2,14
65250411,13,8,15,10,12,11,3,9,81
65250412,15,16,15,5,15,6,3,5,80
65250413,11,11,10,12,10,10,3,6,73
65250414,38,49,80,95,49,28,17,17,373
65250415,21,30,50,53,41,49,9,10,263
65250416,6,25,22,36,18,13,7,8,135
65250417,50,79,73,98,55,40,17,25,437
65250418,57,71,72,95,47,33,12,13,400
65250501,85,79,92,81,76,49,20,34,516
65250502,3,7,6,5,4,2,3,3,33
65250503,4,4,2,3,4,2,0,0,19
65250504,11,18,23,26,16,9,7,8,118
65250601,12,14,18,21,24,23,7,10,129
65250602,13,19,29,22,16,5,3,9,116
65250603,18,30,30,18,31,10,5,5,147
65250604,29,49,40,37,22,7,3,3,190
65250605,28,44,50,39,17,10,6,2,196
65250606,110,144,88,102,33,12,8,0,497
65250607,89,122,106,113,80,24,4,11,549
65250608,35,43,55,46,25,18,6,8,236
65250609,28,37,50,64,33,29,14,16,271
65250610,46,75,59,82,58,24,7,9,360
65250611,87,140,102,91,37,20,3,3,483
65250612,49,64,49,52,34,29,13,15,305
65250613,55,83,64,53,30,8,4,6,303
65250614,41,48,34,23,17,3,3,2,171
65320101,91,145,121,98,64,33,7,15,574
65320102,92,105,65,68,30,13,3,1,377
65320103,76,82,61,59,15,6,0,0,299
65320104,77,102,63,55,23,10,3,1,334
65320105,74,94,51,47,22,4,1,2,295
65320106,86,95,61,44,20,10,3,2,321
65320107,73,78,39,33,15,4,2,2,246
65320108,87,70,49,37,16,8,0,3,270
65320109,59,80,43,25,15,10,0,1,233
65320110,85,64,67,37,23,5,3,0,284
65320111,76,86,78,41,33,14,2,6,336
65320112,82,104,60,37,15,11,1,2,312
65320201,107,69,25,24,7,1,1,1,235
65320202,74,86,51,47,26,9,1,1,295
65320203,60,106,63,47,17,9,1,2,305
65320204,66,78,56,47,22,10,2,1,282
65320205,56,58,34,36,10,8,0,3,205
65320206,67,74,39,35,21,10,1,1,248
65320207,78,76,89,55,36,13,0,2,349
65320208,71,76,40,38,17,9,6,1,258
65320301,41,84,69,64,34,15,6,7,320
65320302,69,125,105,109,53,22,14,7,504
65320303,26,83,57,61,40,10,1,3,281
65320304,35,55,37,54,18,15,4,7,225
65320305,33,39,67,61,37,34,10,26,307
65320306,45,48,60,57,38,25,10,13,296
65320307,47,49,60,59,45,25,11,13,309
65320308,70,65,63,75,45,22,8,7,355
65320309,73,83,80,87,52,26,12,9,422
65320310,42,47,58,65,32,19,4,10,277
65320311,41,58,49,55,40,12,3,5,263
65320312,52,71,47,34,18,6,1,1,230
65320313,23,34,42,47,19,13,6,8,192
65320401,19,18,14,16,7,7,0,0,81
65320402,4,7,3,6,4,0,0,0,24
65320403,15,28,17,13,11,4,3,0,91
65320501,2,3,2,3,1,0,0,0,11
65320502,6,4,7,8,2,2,0,1,30
65320503,15,8,11,9,2,2,0,2,49
65320504,11,15,17,4,2,0,0,0,49
65320601,2,2,1,0,1,0,0,1,7
65320602,1,1,3,2,1,0,0,0,8
65320603,2,5,2,1,2,1,0,0,13
65320604,1,3,3,0,2,1,0,0,10
65320701,6,10,7,7,4,4,3,1,42
65320801,4,7,3,5,2,1,0,0,22
65320802,11,9,3,1,3,2,0,0,29
65320803,3,1,5,3,0,0,1,1,14
65320804,16,6,5,5,2,0,1,0,35
65320805,5,11,12,9,2,2,1,1,43
65320901,74,79,106,93,76,29,16,17,490
65320902,32,45,47,47,25,9,4,6,215
65320903,21,24,25,28,8,8,3,5,122
65320904,30,56,33,35,19,13,6,4,196
65320905,14,41,41,49,23,7,1,2,178
65320906,20,23,15,14,12,4,2,3,93
65320907,22,27,20,22,17,3,4,1,116
65320908,21,28,22,38,9,9,2,2,131
65320909,23,41,30,43,15,4,1,2,159
65320910,95,109,157,154,133,80,39,61,828
65320911,40,53,42,45,33,20,4,2,239
65320912,17,16,23,28,12,3,0,5,104
65321001,46,80,56,62,45,20,11,16,336
65321002,4,7,5,5,0,0,0,0,21
65321003,7,6,5,10,2,2,0,0,32
65321004,2,2,4,5,3,0,1,1,18
65321005,2,4,6,5,3,0,2,1,23
65321101,16,17,8,10,2,5,1,3,62
65321102,19,14,12,8,5,4,0,2,64
65321103,8,8,3,2,3,0,1,0,25
65321104,4,2,3,1,0,0,0,1,11
65321201,4,5,1,4,1,1,0,0,16
65321202,2,2,1,2,1,1,0,0,9
65321203,2,5,1,4,3,0,0,1,16
65321301,4,4,1,3,0,0,0,1,13
65321302,1,3,0,3,2,1,0,1,11
65321303,1,1,1,2,1,0,0,0,6
65321401,80,87,61,32,11,3,3,0,277
65321402,62,62,66,51,30,12,1,3,287
65321403,65,122,74,49,30,5,4,3,352
65321404,76,90,56,54,27,7,6,0,316
65321405,63,92,68,41,21,7,1,0,293
65321406,98,96,41,21,18,1,1,0,276
65321407,48,66,38,24,14,4,1,0,195
65321408,71,79,52,47,18,8,1,2,278
65321501,44,55,62,65,21,11,2,2,262
65321502,45,72,65,65,41,13,10,4,315
65321503,47,58,71,60,27,12,3,3,281
65321504,44,68,58,65,33,20,9,7,304
65321505,35,53,57,65,49,29,14,9,311
65321506,62,63,51,72,38,27,11,17,341
65321507,57,59,45,47,19,21,3,4,255
65321508,49,53,70,54,34,13,9,11,293
65321509,49,98,74,87,38,13,2,2,363
65321510,49,63,37,60,21,10,3,1,244
65321511,88,82,92,90,34,16,4,3,409
65321512,60,110,87,101,56,14,1,2,431
65470101,7,10,7,7,3,1,0,0,35
65470102,4,10,1,3,3,1,0,0,22
65470201,40,46,41,34,19,12,3,3,198
65470202,6,6,4,7,4,1,1,1,30
65470203,6,13,12,5,6,1,0,1,44
65470301,6,11,5,3,3,1,3,0,32
65470302,7,14,11,6,3,3,0,0,44
65470303,10,7,4,4,1,1,0,0,27
65470304,11,7,6,4,2,1,2,0,33
65470305,42,42,47,49,35,12,4,10,241
65470306,61,84,70,110,55,18,9,3,410
65470307,48,72,77,84,67,28,17,9,402
65470308,17,23,27,24,11,8,4,2,116
65470309,21,46,67,58,24,22,19,4,261
65470310,25,25,21,26,9,10,4,4,124
65470311,23,32,25,22,11,5,0,0,118
65470312,71,114,98,67,37,10,5,4,406
65470313,13,17,11,14,3,2,2,1,63
65470401,4,6,0,1,0,0,0,0,11
65470402,13,18,11,10,2,2,0,2,58
65470501,4,12,3,4,3,0,0,1,27
65470502,4,7,4,8,5,3,1,0,32
65470503,8,3,5,2,4,0,0,0,22
65470601,10,16,14,16,9,6,2,0,73
65470602,7,7,4,8,2,3,0,0,31
65470603,13,22,20,12,7,3,1,2,80
65470701,4,5,2,2,3,0,0,0,16
65470702,6,3,6,2,2,1,0,0,20
65470703,9,10,5,5,4,4,0,0,37
65470801,14,14,13,12,9,4,3,2,71
65470802,12,7,11,6,4,2,0,0,42
65470901,33,43,52,41,23,18,4,4,218
65470902,50,55,71,57,35,30,14,6,318
65470903,51,46,59,57,44,30,12,16,315
65470904,91,110,101,61,51,23,3,6,446
65470905,73,111,96,82,38,13,11,4,428
65470906,72,108,86,57,21,10,4,1,359
65470907,99,121,82,64,32,11,2,4,415
65470908,77,112,72,68,29,13,5,0,376
65470909,74,82,66,41,24,8,5,3,303
65470910,61,82,64,45,16,11,3,1,283
65530101,53,70,60,30,17,11,9,3,253
65530102,32,42,29,22,13,3,1,1,143
65530103,51,36,26,20,6,8,0,0,147
65530104,15,16,7,7,2,1,0,0,48
65530105,16,25,11,16,3,3,3,1,78
65530106,19,22,15,14,9,5,2,2,88
65530107,16,22,10,7,1,2,0,0,58
65530108,30,25,18,6,6,1,0,0,86
65530109,17,19,9,3,1,1,1,0,51
65530110,13,14,7,1,1,0,1,0,37
65530111,9,3,4,1,0,0,0,0,17
65530201,1,2,0,2,0,0,0,0,5
65530202,8,19,3,2,2,0,0,0,34
65530203,13,28,10,6,1,2,0,0,60
65530204,54,89,77,72,52,24,9,10,387
65530205,16,18,8,9,1,0,0,0,52
65530301,20,21,12,9,3,2,1,0,68
65530302,22,26,13,14,8,3,0,1,87
65530303,15,14,12,14,3,5,0,1,64
65530304,11,22,15,19,5,3,0,2,77
65530305,24,25,16,20,6,7,2,0,100
65530306,20,23,16,13,3,5,2,0,82
65530307,28,18,14,5,3,3,1,1,73
65530308,6,14,5,7,3,0,2,0,37
65530309,11,11,15,4,1,0,0,0,42
65530310,8,5,4,3,2,0,0,0,22
65530311,5,3,4,5,1,0,0,0,18
65530312,10,10,2,5,4,1,0,0,32
65530313,15,8,7,7,2,0,1,0,40
65530314,13,18,7,3,3,1,0,0,45
65740101,1,3,4,8,2,2,0,1,21
65740102,5,10,4,4,2,2,0,1,28
65740201,6,1,3,2,1,0,1,0,14
65740202,19,7,6,10,7,2,2,3,56
65740301,0,1,4,2,2,1,0,0,10
65740302,8,3,4,9,2,4,2,0,32
65740303,9,8,9,12,9,4,3,2,56
65740401,13,9,18,12,9,2,3,5,71
65740402,36,72,74,70,48,34,21,19,374
65740403,55,57,73,62,58,27,14,10,356
65740404,49,64,63,55,34,20,4,8,297
65740405,44,43,54,43,35,18,9,8,254
65740406,41,52,49,48,24,6,9,7,236
65740407,63,87,64,41,24,6,5,1,291
65740408,70,94,66,49,24,6,1,1,311
65740409,60,60,46,47,32,11,0,3,259
65740410,91,102,61,59,36,11,5,5,370
65740411,61,62,43,48,30,7,4,1,256
65740412,47,82,63,42,18,17,4,2,275
65740413,1,3,2,2,0,0,0,0,8
65740414,40,82,66,69,32,19,6,4,318
65740415,40,56,50,51,37,24,10,10,278
65740416,30,55,54,46,23,17,6,6,237
65740501,3,3,5,2,8,2,1,2,26
65740502,4,12,9,3,5,0,2,4,39
65740503,6,11,8,10,5,1,0,0,41
65740601,9,6,8,7,7,1,3,2,43
65740602,6,9,7,3,0,0,0,0,25
65740701,46,44,34,24,12,8,1,0,169
65740702,15,12,13,12,7,5,1,1,66
65740703,8,6,6,3,2,0,2,0,27
65740704,3,4,4,3,0,0,0,1,15
65740705,6,4,2,6,5,5,1,3,32
65740706,5,7,3,8,5,0,0,1,29
65740707,3,8,3,2,2,1,2,1,22
65740708,4,5,3,5,6,0,0,1,24
65740801,21,29,22,25,4,1,2,0,104
65740802,1,12,9,2,2,2,0,0,28
65740803,4,9,7,2,1,3,1,0,27
65740804,2,10,4,2,2,3,0,0,23
65740805,13,26,13,21,13,4,4,0,94
65740901,2,2,1,3,3,3,1,0,15
65740902,3,5,4,8,2,2,1,0,25
65740903,15,9,7,2,3,1,0,2,39
65810101,61,91,64,68,44,16,4,11,359
65810102,43,72,85,72,50,27,9,16,374
65810103,52,91,87,90,38,22,10,3,393
65810104,61,95,90,69,38,15,4,9,381
65810105,69,132,81,78,37,15,4,4,420
65810106,67,77,45,29,20,5,0,0,243
65810107,70,91,49,38,18,9,0,3,278
65810108,24,67,57,67,29,13,3,5,265
65810109,29,55,72,63,38,15,2,3,277
65810110,43,41,55,60,25,20,13,6,263
65810111,22,50,35,43,37,22,11,19,239
65810201,82,84,52,53,10,8,1,1,291
65810202,67,88,36,31,11,4,2,0,239
65810203,51,56,18,18,1,0,0,0,144
65810204,61,85,44,43,14,4,1,1,253
65810205,52,58,22,21,8,3,1,0,165
65810206,116,101,41,29,7,4,0,0,298
65810207,54,101,64,38,20,7,6,1,291
65810208,66,88,65,39,24,4,2,1,289
65810209,80,84,53,26,15,6,1,3,268
65810210,53,65,47,44,26,8,3,2,248
65810211,35,60,45,49,38,19,9,6,261
65810212,40,67,52,46,17,12,6,2,242
65810301,80,81,69,40,25,6,1,2,304
65810302,81,105,58,50,19,8,1,3,325
65810303,52,98,65,52,16,8,3,0,294
65810304,53,60,43,29,11,2,3,2,203
65810305,64,65,37,28,14,4,2,1,215
65810306,63,60,39,32,7,5,3,1,210
65810307,80,77,56,33,18,2,0,1,267
65810308,43,62,44,34,10,6,5,4,208
65810401,84,107,65,65,29,7,1,2,360
65810402,55,77,35,19,10,9,1,3,209
65810403,40,65,33,39,15,4,1,0,197
65810404,36,89,45,41,11,7,2,1,232
65810405,62,103,85,62,40,12,4,3,371
65810406,24,44,38,25,14,5,1,0,151
65810407,33,64,43,48,16,5,0,5,214
65810408,63,95,45,47,7,3,1,0,261
65810409,50,83,41,50,11,3,0,2,240
65810410,45,61,34,29,11,4,1,0,185
65810411,56,77,45,20,11,2,1,0,212
65810501,29,23,18,6,1,0,0,0,77
65810502,23,22,5,2,0,0,0,0,52
65810503,60,39,16,4,3,1,0,0,123
65810504,32,31,11,5,3,1,0,0,83
65810505,28,22,12,8,3,0,0,0,73
65810506,49,50,27,15,3,2,1,2,149
65810507,46,28,13,5,2,0,0,0,94
65810508,43,33,16,6,3,0,1,0,102
65810601,2,0,5,3,1,0,0,0,11
65810602,7,7,5,12,3,2,0,0,36
65810603,4,10,10,6,1,0,0,0,31
65810604,3,5,0,1,2,0,0,0,11
65810701,36,39,31,30,17,16,8,7,184
65810702,3,0,2,0,2,0,0,0,7
65810703,1,7,8,6,2,0,1,0,25
65810704,4,5,4,2,2,2,0,0,19
65810705,3,4,3,0,3,1,0,0,14
65810706,4,7,4,4,0,0,1,2,22
65810707,9,8,4,9,7,0,0,2,39
65810708,29,43,52,34,15,10,2,1,186
65810709,55,59,47,34,11,4,3,1,214
65810710,39,55,37,24,9,8,2,1,175
65810711,39,46,33,38,9,4,3,1,173
65810712,32,37,31,24,15,11,6,2,158
65810801,29,58,35,32,20,9,1,4,188
65810802,47,62,32,31,13,6,1,0,192
65810803,8,8,6,6,3,2,0,0,33
65810804,3,7,4,9,3,1,1,0,28
65810805,3,5,1,4,2,2,0,0,17
65810806,6,1,1,4,2,1,0,0,15
65810807,0,1,0,0,0,0,1,0,2
65810808,2,6,2,2,3,3,0,0,18
65810809,42,36,40,29,15,11,6,1,180
65810810,39,50,28,29,16,6,2,3,173
65810901,0,1,1,2,2,1,0,0,7
65810902,5,3,1,0,0,0,1,0,10
65810903,5,2,1,0,0,0,0,0,8
65810904,2,1,3,1,0,0,0,0,7
65810905,2,0,0,0,0,1,0,0,3
65810906,1,4,0,2,0,0,0,1,8
65810907,1,1,1,1,0,0,0,0,4
65810908,1,0,0,0,1,0,0,0,2
65810909,0,2,0,1,0,0,0,0,3
65810910,1,1,1,1,0,0,0,0,4
65810911,1,0,1,0,0,0,0,0,2
65810912,3,4,1,0,0,1,0,0,9
65810913,4,2,1,3,0,1,0,0,11
65811001,29,40,21,22,17,5,3,4,141
65811002,6,5,4,1,4,2,0,0,22
65811003,3,6,0,2,1,1,1,0,14
65811004,3,4,0,0,0,0,0,0,7
65811005,0,4,4,1,0,0,0,0,9
65811006,1,2,3,2,2,2,1,0,13
65811101,0,1,0,1,0,0,0,0,2
65811102,5,0,0,2,1,0,0,0,8
65811103,6,5,3,2,0,0,0,0,16
65811104,1,2,2,1,1,1,0,0,8
65811105,4,7,4,8,1,2,1,0,27
65811106,1,2,1,0,0,0,0,0,4
65811107,6,6,3,6,1,1,0,0,23
65811108,5,4,2,0,0,0,0,0,11
65811109,1,2,1,0,0,0,0,1,5
65811201,6,3,1,1,1,0,0,0,12
65811202,5,2,0,1,0,0,0,0,8
65811203,3,6,2,4,0,0,0,0,15
65811204,3,11,4,2,1,0,0,0,21
65811205,9,10,5,6,3,0,2,0,35
65811206,7,12,12,4,1,2,0,4,42
65811207,9,1,2,3,2,0,0,0,17
65811301,30,58,53,39,46,8,8,6,248
65811302,24,39,47,42,33,14,11,13,223
65811303,36,54,60,77,31,18,3,7,286
65811304,29,50,60,64,36,21,10,5,275
65811305,37,82,52,62,26,13,7,2,281
65811306,53,112,131,125,60,30,4,7,522
65811307,16,27,15,14,8,6,2,0,88
65811308,35,49,35,33,12,17,9,1,191
65811309,13,49,47,40,23,6,1,2,181
65811310,22,55,50,50,22,3,1,2,205
65811311,35,75,68,70,25,6,0,1,280
65811401,15,22,11,18,14,9,3,4,96
65811402,39,62,49,50,42,20,7,6,275
65811403,53,60,62,59,47,33,6,13,333
65811404,29,47,21,30,14,10,1,0,152
65811405,26,33,42,33,17,9,2,1,163
65811406,17,30,25,30,19,9,5,8,143
65811407,27,40,53,60,29,19,3,5,236
65811408,35,41,64,60,43,14,11,3,271
65811409,42,70,49,42,34,13,3,4,257
65811410,42,63,65,46,28,15,4,5,268
65811411,29,33,46,46,32,21,7,8,222
65811412,64,103,84,70,37,26,5,6,395
65811501,20,29,20,30,14,10,2,1,126
65811502,59,56,66,72,45,21,8,5,332
65811503,30,62,35,39,17,6,4,1,194
65811504,96,87,79,58,25,8,3,3,359
65811505,39,67,69,61,33,17,9,6,301
65811506,45,56,60,57,30,21,5,5,279
65811507,43,71,92,78,54,32,19,14,403
65811508,49,66,51,66,29,15,2,4,282
65811509,49,80,74,75,35,13,3,0,329
65811510,63,85,67,47,29,15,0,1,307
65811511,80,81,56,43,11,7,2,1,281
65811601,92,85,63,40,21,7,4,1,313
65811602,83,93,76,50,26,8,3,3,342
65811603,74,94,72,40,15,12,1,3,311
65811604,62,92,72,51,27,8,4,3,319
65811605,42,69,36,43,20,8,5,2,225
65811606,77,105,95,71,40,16,5,6,415
65811607,45,81,62,46,21,4,2,2,263
65811608,37,62,46,60,41,10,8,7,271
65811701,49,59,39,35,18,2,1,0,203
65811702,62,62,55,40,14,5,0,0,238
65811703,61,92,48,34,13,4,0,0,252
65811704,51,52,40,30,13,2,1,0,189
65811705,56,85,62,42,19,8,1,1,274
65811706,30,71,53,56,19,4,1,0,234
65811707,58,68,48,25,15,1,0,1,216
65811708,44,48,26,13,9,1,1,0,142
65811709,27,29,15,9,1,1,0,0,82
65811710,46,64,40,20,6,2,0,1,179
65811711,39,82,62,49,21,8,2,1,264
65811801,55,95,60,53,24,4,0,1,292
65811802,37,38,19,5,3,2,0,0,104
65811803,40,30,23,11,2,1,0,0,107
65811804,19,34,19,17,3,1,0,1,94
65811805,36,46,16,6,7,0,0,0,111
65811806,36,38,11,6,3,0,0,0,94
65811807,64,76,26,8,5,0,0,0,179
65811808,69,45,21,8,1,1,0,0,145
65811809,46,33,14,9,0,0,0,0,102
65811901,22,27,13,15,4,1,2,0,84
65811902,7,12,10,6,1,2,0,2,40
65811903,26,45,19,22,9,0,0,3,124
65811904,28,39,32,24,9,2,2,2,138
65811905,20,62,42,52,45,31,6,11,269
65811906,20,21,24,25,21,6,3,9,129
65811907,14,33,24,21,25,13,3,4,137
65811908,63,102,69,52,38,13,9,5,351
65811909,48,46,42,31,21,11,3,5,207
65811910,29,55,31,26,16,6,1,2,166
65811911,32,55,38,35,23,9,6,1,199
65811912,46,65,60,47,24,7,4,3,256
65880101,124,112,64,32,14,7,2,2,357
65880102,86,102,47,41,13,5,0,0,294
65880103,97,112,77,56,26,8,2,3,381
65880104,76,105,76,47,18,9,2,1,334
65880105,89,122,56,30,14,2,0,1,314
65880106,75,101,63,33,25,4,2,2,305
65880107,62,70,51,32,13,2,3,1,234
65880108,41,60,58,40,22,5,1,3,230
65880109,51,61,46,43,24,6,2,0,233
65880110,57,66,35,30,17,3,2,0,210
65880111,85,136,86,63,33,6,5,2,416
65880112,35,64,57,40,26,12,2,4,240
65880113,44,70,47,50,27,7,3,1,249
65880114,51,75,56,39,18,5,1,2,247
65880115,55,62,34,37,20,3,2,0,213
65880116,48,55,46,47,24,11,7,4,242
65880117,51,69,57,34,16,5,3,2,237
65880201,70,101,71,52,28,11,4,5,342
65880202,75,104,56,55,29,8,4,5,336
65880203,37,67,52,38,24,13,6,6,243
65880204,61,106,53,56,30,12,3,12,333
65880205,19,21,20,22,12,7,0,2,103
65880206,62,60,35,25,14,2,0,0,198
65880207,61,80,44,23,12,5,1,0,226
65880208,74,104,36,24,12,6,0,0,256
65880301,41,30,30,23,18,7,3,1,153
65880302,49,50,41,30,16,3,2,0,191
65880303,54,68,48,40,14,4,3,0,231
65880304,19,19,19,20,6,4,0,0,87
65880305,7,6,0,1,2,0,0,0,16
65880306,2,3,5,4,1,1,1,0,17
65880307,2,5,2,1,0,0,0,2,12
65880308,6,6,2,1,1,1,0,0,17
65880309,4,9,11,5,7,5,0,1,42
65880401,4,6,0,4,5,2,0,1,22
65880501,34,49,41,25,11,7,3,5,175
65880502,5,3,3,2,4,0,0,0,17
65880503,4,4,2,1,1,0,0,0,12
65880504,2,2,0,2,0,1,0,1,8
65880505,24,8,7,11,7,4,1,0,62
65880601,20,19,6,6,3,4,1,0,59
65880701,15,17,13,3,0,0,0,1,49
65880702,29,19,14,15,7,4,1,0,89
65880703,24,27,18,11,9,3,2,1,95
65880801,8,19,7,7,7,5,2,4,59
65880802,5,12,6,3,2,0,1,0,29
65880901,38,55,61,72,30,6,3,1,266
65880902,52,92,75,67,32,15,4,5,342
65880903,23,48,30,28,15,4,1,0,149
65880904,27,36,23,22,11,6,0,2,127
65880905,14,29,22,24,10,3,1,0,103
65880906,22,27,37,20,11,5,0,0,122
65880907,29,34,46,43,19,12,3,4,190
65880908,64,75,69,44,39,12,6,1,310
65880909,54,77,65,54,28,8,5,0,291
65880910,44,61,66,53,29,12,4,8,277
65880911,42,58,64,86,42,43,18,22,375
65880912,34,33,60,80,68,32,22,17,346
65880913,34,47,69,67,59,39,13,17,345
65880914,20,45,42,30,29,10,4,4,184
65880915,27,47,45,49,26,17,10,13,234
65881001,35,37,18,18,12,7,2,0,129
65881002,16,17,19,17,6,1,0,1,77
65881003,6,6,3,2,0,0,0,0,17
65881004,0,1,3,1,0,0,0,0,5
65881005,12,5,8,4,1,4,1,4,39
65881006,3,6,8,0,2,0,0,0,19
65881007,5,8,4,4,4,3,1,0,29
65881008,2,14,1,3,0,0,0,0,20
65881009,2,0,1,1,0,0,0,0,4
65881010,3,1,2,0,0,0,2,0,8
65881011,2,1,3,3,0,0,0,0,9
65881012,29,38,30,24,11,5,0,0,137
65881101,2,1,3,0,4,0,0,0,10
65881102,4,4,2,2,0,1,0,1,14
65881201,6,10,8,8,2,1,0,0,35
65881202,0,7,1,0,0,1,0,0,9
65881203,4,5,5,8,9,2,1,0,34
65881301,29,47,40,33,13,14,1,4,181
65881302,4,6,5,5,0,1,0,0,21
65881303,2,5,3,7,5,1,1,0,24
65881304,7,8,1,3,4,0,0,0,23
65881305,8,6,4,5,1,1,0,1,26
65881401,26,30,14,11,10,1,4,5,101
65881402,25,30,22,18,15,14,3,5,132
65881403,4,0,1,0,0,0,1,0,6
65881404,2,5,7,2,1,2,0,0,19
65881501,37,20,25,16,14,9,1,0,122
65881502,6,0,1,2,1,0,0,1,11
65881503,3,1,1,2,0,0,0,0,7
65881504,7,4,4,1,1,1,0,0,18
65881601,59,89,57,39,26,6,2,1,279
65881602,78,93,66,43,32,17,3,4,336
65881603,34,37,39,58,29,19,10,16,242
65881604,2,0,3,4,1,0,1,0,11
65881605,3,2,0,0,0,0,0,0,5
65881606,0,6,1,3,1,0,1,0,12
65881607,0,0,0,0,0,0,0,0,0
65881608,1,4,2,0,1,1,1,0,10
65881609,1,0,1,1,0,0,0,0,3
65881701,66,101,52,42,26,9,2,0,298
65881702,53,76,66,42,25,19,6,9,296
65881703,38,73,65,38,17,6,1,2,240
65881704,54,91,65,62,18,21,6,1,318
65881705,84,94,66,46,23,7,1,1,322
65881706,99,109,44,42,22,8,2,0,326
65881707,68,85,48,23,9,3,0,1,237
65881708,50,55,48,35,9,8,2,4,211
65950101,35,57,47,67,43,19,12,11,291
65950102,30,49,67,63,20,11,2,2,244
65950103,51,93,102,82,41,21,6,4,400
65950104,65,85,69,72,34,22,11,9,367
65950105,89,107,77,54,24,7,0,1,359
65950106,45,97,50,49,22,7,2,0,272
65950107,58,82,66,57,29,4,4,2,302
65950108,78,118,66,70,24,13,3,1,373
65950109,39,63,54,47,36,15,2,4,260
65950110,80,98,78,58,36,13,4,4,371
65950201,77,95,42,34,18,11,0,1,278
65950202,75,105,59,38,26,7,3,2,315
65950203,83,89,62,38,11,4,2,0,289
65950204,120,110,46,33,11,3,0,1,324
65950205,88,76,30,21,3,4,1,1,224
65950206,105,98,40,35,9,3,1,0,291
65950207,87,102,61,42,11,2,0,0,305
65950208,91,118,75,42,22,9,4,1,362
65950209,56,66,39,39,10,4,1,1,216
65950210,88,150,80,61,28,11,4,2,424
65950211,61,67,46,30,8,3,1,1,217
65950212,75,92,36,31,15,4,1,1,255
65950213,66,70,26,26,6,3,0,0,197
65950214,49,65,44,29,14,3,1,0,205
65950215,56,67,36,31,5,5,0,1,201
65950301,42,63,51,44,22,3,0,1,226
65950302,81,112,41,50,12,6,1,0,303
65950303,112,93,47,31,12,3,2,0,300
65950304,112,109,44,37,11,4,0,0,317
65950305,62,87,60,35,11,5,1,0,261
65950306,88,96,67,26,10,4,1,3,295
65950307,72,100,46,25,10,4,1,0,258
65950308,88,79,48,24,15,0,1,0,255
65950309,61,75,44,34,13,5,1,1,234
65950310,71,122,93,62,28,7,3,0,386
65950311,73,103,82,53,21,5,3,1,341
65950312,94,78,46,27,8,1,1,1,256
65950313,36,85,39,43,16,2,0,0,221
65950401,43,51,41,53,23,11,4,1,227
65950402,96,130,92,55,14,12,1,0,400
65950403,54,85,62,60,23,11,1,2,298
65950404,42,78,84,74,36,14,4,6,338
65950405,59,95,64,66,27,17,5,10,343
65950406,27,51,59,38,22,11,7,6,221
65950407,56,72,46,55,13,15,3,1,261
65950408,47,79,59,41,21,5,0,1,253
65950409,64,93,60,68,24,12,3,9,333
65950410,38,66,56,58,39,12,3,4,276
65950411,46,57,55,47,22,9,2,5,243
65950412,71,109,78,64,29,10,4,3,368
65950413,50,109,67,75,26,8,6,5,346
65950501,21,14,12,10,1,1,0,1,60
65950601,24,30,11,13,1,4,0,0,83
65950602,7,7,1,1,3,1,0,2,22
65950603,27,31,22,15,7,3,1,3,109
65950701,17,14,10,9,8,5,1,0,64
65950801,48,41,40,25,11,6,0,2,173
65950802,7,15,13,10,5,6,0,2,58
65950901,22,19,7,12,3,1,1,0,65
65951001,12,15,11,10,3,2,1,0,54
65951101,14,13,9,6,2,1,0,0,45
65951201,7,6,9,6,5,0,0,1,34
65951301,14,10,12,11,1,4,1,0,53
65951401,29,23,17,16,12,2,1,0,100
65951501,11,22,7,3,2,3,1,1,50
65951601,8,38,51,68,38,28,12,19,262
65951602,48,63,80,89,42,19,6,10,357
65951603,49,77,74,83,52,30,9,17,391
65951604,17,13,16,21,7,7,3,6,90
65951605,4,8,14,7,5,0,0,0,38
65951606,45,54,48,49,28,13,4,0,241
65951607,34,41,58,52,28,19,10,20,262
65951608,52,76,106,121,69,29,7,8,468
65951609,42,82,36,40,23,12,2,0,237
65951610,30,68,40,32,19,4,0,1,194
65951611,32,59,43,38,20,11,3,0,206
65951612,34,72,45,45,19,6,1,2,224
65951613,35,54,38,31,22,5,2,2,189
65951701,9,16,4,9,4,4,0,0,46
65951801,5,0,0,0,1,0,0,0,6
65951802,3,2,2,2,0,0,0,0,9
65951803,3,10,1,4,1,1,0,1,21
65951804,0,1,0,0,2,0,0,0,3
65951901,27,22,43,29,12,12,5,7,157
65951902,34,49,42,34,21,9,2,5,196
65951903,35,45,62,84,46,27,8,10,317
65951904,26,41,26,24,6,7,1,3,134
65951905,24,20,17,20,11,2,1,0,95
65951906,20,21,22,17,5,6,0,3,94
65951907,20,31,20,19,8,4,1,2,105
65951908,52,59,44,25,15,6,1,3,205
65951909,34,36,29,20,6,5,1,1,132
65951910,25,48,37,40,29,5,5,0,189
65951911,53,80,58,70,32,14,6,0,313
65951912,24,39,41,40,21,6,3,1,175
65951913,12,12,10,6,3,2,1,1,47
65951914,95,113,55,46,23,10,7,1,350
65952001,44,78,57,49,13,9,4,2,256
65952002,2,5,3,2,1,0,0,0,13
65952101,27,30,38,42,22,10,4,2,175
65952102,32,67,36,40,26,11,1,2,215
65952103,31,51,35,27,11,4,2,0,161
65952104,30,79,42,37,25,5,4,2,224
65952105,44,77,69,62,20,7,2,4,285
65952106,0,1,0,0,0,0,0,0,1
65952107,10,20,9,11,8,2,0,0,60
65952201,16,18,10,8,13,2,1,3,71
65952301,29,21,23,12,5,5,1,1,97
65952401,68,86,73,37,12,7,1,1,285
65952402,92,101,56,36,15,5,1,1,307
65952403,87,88,57,41,10,4,1,1,289
65952404,71,102,56,28,18,5,3,0,283
65952405,69,88,54,40,17,5,2,2,277
65952406,63,91,57,42,18,4,0,1,276
65952407,61,125,75,56,22,11,1,1,352
65952408,70,93,94,82,46,25,11,6,427
65952409,63,84,67,46,31,8,1,1,301
65952410,30,62,46,54,34,17,6,7,256
65952411,39,40,44,42,17,24,7,9,222
65952412,51,71,52,52,24,10,4,8,272
65952501,69,108,79,64,20,14,3,10,367
65952502,76,75,52,37,17,4,1,0,262
65952503,101,109,65,45,31,8,1,4,364
65952504,80,132,81,52,24,5,4,1,379
65952505,70,85,59,53,20,3,4,0,294
65952506,47,74,66,43,28,8,5,3,274
65952507,39,73,64,42,24,7,3,0,252
65952508,58,96,61,43,28,7,5,1,299
65952509,70,69,49,42,14,7,2,2,255
65952510,37,63,73,60,19,8,6,1,267
65952511,42,72,63,69,40,13,0,3,302
65952512,25,55,37,54,17,17,2,6,213
65952513,26,40,44,44,25,21,9,6,215
65952601,28,29,15,18,13,1,1,2,107
65952602,23,69,71,94,65,45,22,32,421
65952603,29,45,44,40,23,31,8,19,239
65952604,42,39,44,57,32,12,6,7,239
65952605,44,95,65,64,39,25,12,17,361
65952606,18,41,34,54,18,5,2,0,172
65952607,44,68,66,92,37,11,4,4,326
65952608,35,63,55,68,49,26,10,17,323
65952609,37,59,46,45,31,20,2,7,247
65952610,38,50,60,79,44,24,14,16,325
65952611,58,87,74,70,42,24,11,5,371
65952612,69,91,65,80,45,24,8,9,391
65952613,40,51,42,47,33,13,6,2,234
65952614,26,46,38,34,15,7,5,4,175
65952701,32,54,68,119,39,15,4,2,333
65952702,38,82,109,112,63,26,11,3,444
65952703,27,43,36,40,19,18,5,10,198
65952704,24,41,62,46,30,13,9,7,232
65952705,5,6,1,4,2,0,0,1,19
65952706,11,21,7,8,7,6,0,0,60
65952707,37,45,52,39,25,7,1,8,214
65952708,8,14,30,28,8,5,3,2,98
65952709,33,59,50,44,33,15,3,5,242
65952710,31,64,40,31,22,5,0,0,193
65952711,55,63,50,51,18,4,1,0,242
65952712,36,54,41,36,12,3,2,2,186
66020101,67,11,14,4,2,1,0,0,99
66020201,30,34,20,21,25,11,5,6,152
66020202,10,10,18,5,2,3,2,2,52
66020203,20,15,8,17,7,2,3,1,73
66020204,9,9,2,3,0,0,0,0,23
66020205,14,9,5,3,3,2,0,2,38
66020206,10,0,6,2,1,0,0,0,19
66020207,15,5,5,4,3,1,1,0,34
66020301,81,108,107,69,34,10,3,8,420
66020302,44,39,40,34,20,17,6,7,207
66020303,9,3,0,1,0,0,1,0,14
66020304,21,36,32,37,33,11,5,4,179
66020305,5,4,1,2,0,0,0,0,12
66020306,11,8,8,3,2,0,0,0,32
66020307,2,4,0,1,1,0,0,0,8
66020308,86,99,74,89,42,27,10,10,437
66020309,51,61,43,48,25,12,7,1,248
66020401,12,5,0,2,1,0,0,0,20
66020501,7,2,1,0,1,0,0,0,11
66020601,7,2,3,0,0,0,0,0,12
66020701,5,5,0,0,0,0,0,0,10
66020801,58,76,46,35,9,9,4,3,240
66020802,65,81,52,38,13,10,3,3,265
66020803,33,39,19,18,6,2,0,0,117
66020804,30,43,26,14,8,2,1,1,125
66020805,32,28,16,11,5,5,0,0,97
66020806,3,5,4,1,1,1,0,0,15
66020901,5,15,6,5,2,1,0,0,34
66020902,17,6,3,2,0,0,0,0,28
66020903,4,4,2,1,0,0,0,0,11
66021001,8,5,0,0,0,0,0,0,13
66021002,3,2,0,1,0,0,0,0,6
66021101,35,39,56,66,50,22,13,17,298
66021102,35,40,38,46,27,9,8,4,207
66021103,71,94,78,58,40,24,7,6,378
66021104,72,93,66,49,24,12,7,2,325
66021105,61,69,49,25,13,5,1,1,224
66021106,48,88,35,47,12,10,3,4,247
66021107,55,64,55,47,21,7,7,5,261
66021108,87,129,73,68,28,18,15,11,429
66021109,79,99,100,82,43,26,4,4,437
66021110,5,3,0,2,0,0,0,0,10
66021111,106,106,53,57,21,9,3,0,355
66021112,60,79,65,48,15,12,0,0,279
66021113,51,77,58,69,23,7,2,2,289
66021201,17,11,8,4,1,0,0,2,43
66021301,31,20,8,5,2,3,0,0,69
66021401,16,7,6,4,3,2,0,0,38
66021402,14,12,5,5,3,1,0,0,40
66021403,10,16,6,11,5,0,1,1,50
66021404,15,9,11,4,2,0,0,0,41
66021405,9,15,6,3,4,5,1,0,43
66021406,7,13,7,8,4,4,0,1,44
66021501,1,0,0,0,0,0,0,0,1
66021601,22,34,29,49,25,14,10,13,196
66021602,37,32,32,21,23,18,6,6,175
66021603,65,57,74,87,58,38,14,18,411
66021604,42,48,53,27,30,20,5,4,229
66021605,62,78,54,60,16,8,2,1,281
66021606,69,74,64,53,29,5,2,4,300
66021607,82,82,46,40,19,9,1,0,279
66021608,85,77,52,32,7,1,1,0,255
66021609,70,77,72,53,31,14,8,9,334
66021610,75,100,60,48,23,4,2,2,314
66021611,42,43,36,39,31,29,6,8,234
66021612,5,8,0,1,2,0,0,0,16
66090101,55,80,80,88,64,24,9,8,408
66090102,79,129,78,59,35,15,4,3,402
66090103,82,86,62,63,29,6,2,0,330
66090104,66,90,50,41,16,6,3,0,272
66090105,96,98,47,29,7,8,0,0,285
66090106,51,62,44,29,20,4,4,3,217
66090107,67,84,68,50,22,18,9,3,321
66090108,36,52,48,44,16,11,5,3,215
66090109,45,58,61,64,32,16,13,8,297
66090110,54,82,59,58,35,14,10,10,322
66090201,90,123,64,38,17,9,5,1,347
66090202,82,89,44,39,12,8,0,0,274
66090203,66,72,31,20,8,6,1,0,204
66090204,91,85,41,31,14,5,5,0,272
66090205,89,106,54,54,17,7,1,1,329
66090206,75,96,108,63,41,18,8,9,418
66090207,38,45,51,43,24,6,0,2,209
66090208,99,116,88,76,49,17,3,2,450
66090209,103,121,79,57,23,14,4,4,405
66090210,75,77,54,22,18,6,2,1,255
66090211,73,79,78,53,33,13,5,5,339
66090212,55,80,60,57,33,18,4,11,318
66090213,74,85,97,91,46,26,7,7,433
66090214,42,61,62,52,23,10,5,2,257
66090215,29,52,54,46,21,12,4,0,218
66090301,0,2,2,0,1,0,0,0,5
66090302,1,1,1,1,0,0,0,0,4
66090303,0,1,2,1,0,0,1,0,5
66090304,4,4,0,2,1,3,1,0,15
66090401,17,23,19,16,10,0,2,3,90
66090402,2,0,1,4,2,0,0,1,10
66090403,4,4,4,1,1,0,0,0,14
66090404,13,12,3,8,5,1,2,0,44
66090501,1,2,1,4,2,0,0,0,10
66090502,4,4,6,6,4,2,2,1,29
66090503,9,8,9,5,4,0,1,1,37
66090601,5,6,8,2,2,2,3,0,28
66090602,3,1,2,0,0,0,0,0,6
66090603,7,2,4,1,0,0,0,0,14
66090604,1,5,0,0,0,0,0,0,6
66090605,7,9,6,1,1,0,0,0,24
66090606,5,7,2,4,2,4,0,1,25
66090607,18,21,17,17,9,5,0,0,87
66090608,22,24,13,8,9,4,0,0,80
66090609,1,5,1,6,1,1,2,0,17
66090610,10,7,7,17,5,4,4,4,58
66090611,7,2,1,1,2,1,1,0,15
66090612,1,0,1,0,0,0,0,0,2
66090613,12,21,13,13,6,6,0,0,71
66090701,0,1,2,1,0,0,0,0,4
66090702,0,2,0,1,1,0,0,0,4
66090703,2,2,1,1,0,0,0,0,6
66090704,1,3,1,0,0,0,0,0,5
66090705,8,3,5,0,2,2,0,2,22
66090801,0,1,0,0,0,1,0,0,2
66090802,1,0,1,0,1,0,0,0,3
66090803,0,1,0,0,0,0,0,0,1
66090804,2,1,1,0,0,1,0,0,5
66090901,7,8,1,5,2,1,0,0,24
66090902,60,66,52,32,20,8,2,2,242
66090903,55,60,47,28,16,9,2,2,219
66090904,49,43,42,30,8,5,1,0,178
66090905,39,36,23,25,18,6,1,4,152
66090906,5,6,4,1,1,0,0,0,17
66091001,36,48,30,30,14,11,4,5,178
66091002,30,47,25,19,12,5,0,0,138
66091003,4,4,0,1,1,0,0,0,10
66091004,3,4,2,1,0,1,0,0,11
66091005,11,4,6,4,3,0,1,0,29
66091006,2,1,1,1,0,0,0,0,5
66091007,24,33,25,25,17,9,6,1,140
66091101,2,4,1,2,1,2,0,1,13
66091102,2,4,2,8,1,1,0,0,18
66091201,5,5,1,2,0,0,1,0,14
66091202,1,4,5,1,3,0,0,1,15
66091301,17,25,10,10,7,4,0,1,74
66091302,1,5,1,2,1,1,0,0,11
66091303,1,2,0,0,0,1,0,0,4
66091304,3,9,2,6,2,3,0,0,25
66091305,0,4,1,1,2,0,1,0,9
66091306,6,10,2,2,2,2,0,0,24
66091401,3,1,5,2,2,0,0,0,13
66091402,8,2,3,2,5,0,0,0,20
66091501,13,27,13,14,3,3,0,0,73
66091502,1,2,1,2,0,0,1,0,7
66091503,1,1,0,1,0,0,0,0,3
66091601,1,2,2,1,1,0,0,0,7
66091602,0,2,3,1,2,2,0,0,10
66091603,4,2,5,3,2,0,0,0,16
66091604,0,0,0,0,0,0,0,0,0
66091701,80,103,56,55,24,5,1,1,325
66091702,61,84,46,51,20,14,2,6,284
66091703,8,7,4,4,2,1,0,0,26
66091704,0,6,4,2,0,1,0,0,13
66091705,1,0,0,0,0,1,0,0,2
66091706,1,1,2,0,1,0,0,0,5
66091707,4,5,5,3,5,0,0,1,23
66091708,3,2,3,1,2,1,1,0,13
66091709,2,2,2,0,1,0,0,1,8
66091801,0,1,6,3,2,0,0,0,12
66091802,2,1,0,0,0,0,0,0,3
66091901,44,81,84,84,75,29,19,9,425
66091902,51,46,49,35,19,6,3,1,210
66091903,119,121,64,54,27,11,4,2,402
66091904,76,79,48,26,11,5,1,5,251
66091905,56,78,32,24,10,2,1,0,203
66091906,110,104,56,44,15,7,1,1,338
66091907,82,115,76,61,20,10,3,5,372
66091908,70,87,85,90,29,17,8,5,391
66091909,31,60,55,49,32,14,7,7,255
66160101,6,10,4,4,0,0,0,1,25
66160102,4,6,8,1,2,2,1,0,24
66160103,12,4,5,5,3,3,0,1,33
66160104,34,14,4,5,2,2,2,1,64
66160105,9,5,6,1,1,3,0,1,26
66160106,0,0,1,0,0,0,0,0,1
66160107,9,7,9,7,3,1,4,0,40
66160108,6,7,3,0,1,1,1,0,19
66160109,2,3,3,3,0,0,0,0,11
66160110,7,5,7,6,2,1,0,0,28
66160201,3,2,3,2,0,0,0,0,10
66160202,3,2,2,1,0,0,0,0,8
66160301,40,51,65,38,19,13,3,1,230
66160302,60,92,47,41,26,16,2,5,289
66160303,64,82,41,34,21,8,3,3,256
66160304,43,53,69,54,22,12,1,0,254
66160305,36,62,37,51,23,10,4,4,227
66160306,50,53,34,20,11,7,0,0,175
66160307,45,69,31,20,16,4,2,1,188
66160308,7,12,10,6,6,1,0,0,42
66160309,40,45,26,23,10,3,0,3,150
66230101,38,60,63,45,27,9,5,10,257
66230102,82,104,83,61,31,11,4,3,379
66230103,83,112,77,79,23,14,8,4,400
66230104,90,107,71,59,24,9,2,2,364
66230105,64,105,68,55,22,10,4,3,331
66230106,93,106,73,55,18,10,3,7,365
66230107,83,105,64,44,37,15,3,3,354
66230108,77,131,66,63,33,13,2,4,389
66230109,55,71,64,45,34,7,4,2,282
66230110,35,25,32,30,19,17,5,6,169
66230111,48,59,64,48,24,6,1,0,250
66230112,44,62,61,41,20,8,4,2,242
66230201,52,85,55,37,21,4,2,2,258
66230202,64,80,49,32,18,2,0,2,247
66230203,85,101,48,43,19,11,2,0,309
66230204,103,98,51,42,14,3,0,2,313
66230205,59,74,51,34,10,4,0,0,232
66230206,81,105,36,45,19,5,3,1,295
66230207,61,87,45,40,21,10,4,1,269
66230208,92,89,47,41,18,3,1,0,291
66230209,64,113,71,51,19,5,1,2,326
66230301,36,65,31,32,11,7,0,2,184
66230302,88,98,88,64,23,14,6,2,383
66230303,65,90,43,33,8,1,0,0,240
66230304,92,65,29,21,7,0,0,1,215
66230305,63,83,49,36,14,9,0,1,255
66230306,110,94,38,31,9,2,2,1,287
66230307,108,79,38,22,5,3,1,1,257
66230308,64,89,37,27,14,3,1,1,236
66230309,60,57,45,43,13,5,0,0,223
66230310,102,98,54,23,9,3,1,1,291
66230311,56,69,44,35,18,6,2,1,231
66230401,97,103,82,34,22,5,1,1,345
66230402,88,98,68,42,18,5,0,1,320
66230403,74,105,62,40,16,2,1,1,301
66230404,61,82,53,42,11,7,2,1,259
66230405,79,87,65,53,35,9,3,1,332
66230406,82,117,86,80,26,7,3,3,404
66230407,85,104,67,44,26,2,2,2,332
66230408,69,103,77,82,38,16,3,4,392
66230409,49,54,60,58,37,26,7,11,302
66230410,40,67,71,50,29,15,3,7,282
66230501,85,70,96,50,15,11,9,1,337
66230502,59,54,72,41,13,8,6,1,254
66230503,85,67,90,58,20,14,9,0,343
66230504,68,65,75,64,27,17,6,0,322
66230505,98,85,108,76,27,18,11,0,423
66230506,82,76,105,76,34,20,10,2,405
66230507,53,84,82,91,50,28,3,2,393
66230508,47,71,72,82,36,16,3,0,327
66230509,56,50,67,58,21,11,7,0,270
66230510,89,75,105,61,18,11,10,1,370
66230601,2,1,0,0,1,0,0,0,4
66230602,2,1,5,0,1,1,0,0,10
66230603,0,0,0,0,0,0,0,0,0
66230701,41,45,35,34,11,9,3,2,180
66230702,48,54,52,35,15,11,3,1,219
66230703,5,5,5,2,2,1,0,2,22
66230704,2,4,3,4,1,2,0,0,16
66230705,3,1,3,2,0,0,0,0,9
66230801,12,13,15,10,3,5,0,0,58
66230802,2,3,1,3,0,0,0,0,9
66230803,2,5,2,1,0,0,0,0,10
66230901,7,3,3,4,0,1,1,1,20
66230902,32,46,39,31,13,6,2,1,170
66230903,21,22,18,18,8,5,2,1,95
66230904,5,3,6,7,4,2,0,1,28
66231001,2,3,1,0,1,0,0,0,7
66231002,4,5,1,4,0,0,0,1,15
66231003,1,1,3,0,1,0,0,0,6
66231101,3,8,6,1,3,0,0,0,21
66231102,5,8,7,2,4,3,0,0,29
66231103,33,44,26,33,14,6,1,2,159
66231104,39,40,33,33,18,13,1,2,179
66231201,4,2,3,1,2,0,0,0,12
66231202,4,1,0,4,0,0,0,0,9
66231301,0,2,1,0,0,0,0,0,3
66231302,1,3,1,0,3,0,0,0,8
66231401,61,86,63,46,15,5,1,0,277
66231402,53,65,53,43,21,11,7,5,258
66231403,8,4,4,3,5,0,0,1,25
66231404,9,17,20,11,4,3,1,0,65
66231501,26,27,7,7,3,5,1,3,79
66231502,4,4,4,2,0,1,1,0,16
66231503,1,4,3,3,1,0,1,0,13
66231601,27,34,19,17,16,12,1,3,129
66231602,5,5,2,0,2,0,0,1,15
66231603,3,4,4,2,1,1,0,0,15
66231604,9,5,4,2,2,0,0,0,22
66231605,50,54,54,38,19,10,3,2,230
66231701,5,6,3,3,0,0,1,1,19
66231702,1,1,3,1,0,0,0,0,6
66231703,4,3,1,4,0,0,0,0,12
66231801,4,5,3,3,2,1,0,0,18
66231802,25,26,17,34,14,5,2,2,125
66231803,51,58,39,38,19,6,3,1,215
66231804,2,5,3,3,2,0,0,0,15
66231901,3,0,1,1,0,0,1,0,6
66231902,5,5,5,3,1,1,0,0,20
66232001,48,47,46,46,20,9,5,6,227
66232002,46,77,69,86,60,35,16,11,400
66232003,36,75,65,73,35,9,3,3,299
66232004,12,15,18,24,19,8,6,4,106
66232005,26,56,47,69,38,32,10,16,294
66232006,26,47,51,58,35,20,13,8,258
66232007,77,117,90,100,33,20,7,2,446
66232008,69,101,111,72,31,9,2,1,396
66232009,51,83,64,79,40,30,9,8,364
66232010,30,61,57,44,29,18,11,8,258
66232011,57,111,108,95,71,52,13,31,538
66232012,26,21,32,36,22,13,3,5,158
66232101,26,23,17,27,19,8,6,13,139
66232102,19,18,20,14,5,1,0,5,82
66232103,0,1,2,1,1,0,0,0,5
66232104,10,58,48,64,48,10,0,1,239
66232105,5,4,5,8,0,0,0,0,22
66232106,4,11,19,16,5,10,5,1,71
66232107,19,17,36,34,17,10,6,3,142
66232201,65,61,69,40,16,10,6,0,267
66232202,61,48,65,39,17,10,5,0,245
66232203,73,50,74,35,13,9,7,0,261
66232204,61,61,67,58,26,17,4,0,294
66232205,81,64,83,52,19,15,7,0,321
66232206,65,69,69,51,24,15,5,0,298
66232207,69,69,80,58,29,14,8,1,328
66232208,64,85,78,84,48,24,6,1,390
66232209,12,18,23,20,7,2,1,0,83
66232210,23,38,34,43,21,11,0,0,170
66232211,1,2,3,3,1,0,0,0,10
66232212,1,2,7,6,2,0,0,0,18
66232213,44,40,48,39,16,12,2,0,201
66232214,8,11,16,15,5,1,0,0,56
66232301,38,49,37,28,19,7,3,0,181
66232302,1,3,2,4,2,0,0,0,12
66232303,3,3,2,4,1,0,0,0,13
66232304,25,20,28,27,11,3,5,0,119
66232305,4,4,7,4,4,0,0,2,25
66232306,39,36,26,39,11,5,3,1,160
66232401,6,7,2,2,2,1,0,0,20
66232402,2,1,1,2,0,0,0,0,6
66232403,0,5,6,2,3,0,0,0,16
66232404,1,3,3,0,0,0,1,0,8
66232501,25,27,22,20,14,7,3,0,118
66232502,2,5,5,4,0,1,0,0,17
66232503,3,2,3,2,1,0,0,0,11
66232504,14,20,19,8,7,3,2,3,76
66232505,3,5,1,2,1,1,0,0,13
66232506,15,26,17,19,13,8,2,2,102
66232601,4,10,5,3,1,1,1,0,25
66232602,3,10,4,4,1,3,1,0,26
66232701,30,52,23,20,9,4,1,4,143
66232702,1,2,1,0,0,0,0,0,4
66232703,1,2,1,3,0,1,0,2,10
66232704,4,0,2,2,1,0,0,0,9
66232801,48,80,69,85,69,44,16,21,432
66232802,54,81,75,80,49,27,6,6,378
66232803,20,38,47,37,22,8,1,1,174
66232804,69,85,77,62,23,7,4,3,330
66232805,85,108,63,49,21,9,2,4,341
66232806,82,121,97,75,24,15,4,6,424
66232807,55,85,77,71,32,15,4,6,345
66232808,38,93,68,83,36,23,7,15,363
66232809,95,98,70,58,27,14,5,4,371
66232810,45,83,54,51,23,6,2,4,268
66232811,27,49,37,37,21,4,2,2,179
66232812,58,96,84,63,43,21,7,7,379
66232813,52,79,113,100,59,28,9,9,449
66232901,40,73,75,96,50,25,11,8,378
66232902,74,76,75,85,52,24,9,7,402
66232903,36,42,53,64,40,28,13,16,292
66232904,17,41,42,45,24,10,2,3,184
66232905,26,49,62,55,34,14,4,3,247
66232906,54,79,74,49,37,20,15,9,337
66232907,46,48,64,61,52,31,14,12,328
66232908,24,16,37,38,29,24,13,17,198
66232909,45,64,47,53,35,19,4,7,274
66232910,26,43,50,45,29,24,12,21,250
66232911,31,47,47,36,35,17,2,15,230
66300101,26,27,18,24,10,4,1,0,110
66300201,1,0,4,5,1,0,0,0,11
66300202,48,51,59,60,40,12,7,3,280
66300203,37,30,41,32,16,10,5,2,173
66300204,41,35,26,32,17,7,2,2,162
66300205,38,51,34,38,14,6,3,1,185
66300301,13,7,8,6,5,3,1,0,43
66300401,18,12,7,6,2,0,3,0,48
66300501,25,11,7,15,10,1,0,0,69
66300601,34,36,29,17,13,5,0,0,134
66380101,12,6,7,12,7,4,0,1,49
66380102,63,70,94,102,60,40,18,26,473
66380103,36,58,60,61,31,19,6,4,275
66380104,12,20,17,29,13,10,3,3,107
66380105,31,43,32,37,28,10,4,5,190
66380106,19,57,69,57,57,40,16,16,331
66380107,46,49,77,63,49,51,8,10,353
66380108,44,80,87,90,83,61,15,29,489
66380109,50,74,106,75,59,45,7,17,433
66380110,49,76,99,98,48,55,6,18,449
66380111,57,115,140,168,86,41,18,20,645
66380112,54,109,143,239,122,38,14,10,729
66380113,84,112,138,238,126,57,22,15,792
66380114,35,87,47,74,32,24,8,2,309
66380201,12,52,45,124,67,30,7,4,341
66380202,40,93,93,100,44,12,3,1,386
66380203,20,45,51,51,32,30,9,14,252
66380204,55,66,87,90,63,24,8,16,409
66380205,36,69,82,83,42,24,6,10,352
66380206,25,36,43,46,39,40,6,11,246
66380207,35,56,53,52,26,34,3,10,269
66380208,30,47,58,54,27,18,6,13,253
66380209,35,55,66,71,33,25,7,11,303
66380210,45,64,68,67,44,27,3,11,329
66380211,72,130,92,79,53,28,4,14,472
66380212,45,74,59,43,11,19,0,3,254
66380213,42,64,60,57,37,16,11,7,294
66380214,26,50,49,53,39,21,11,6,255
66380301,27,49,72,61,69,40,24,38,380
66380302,33,58,89,89,71,48,14,20,422
66380303,41,75,96,90,39,42,8,9,400
66380304,49,77,100,97,107,52,17,34,533
66380305,24,47,57,42,31,6,6,8,221
66380306,22,47,51,59,26,13,5,5,228
66380307,18,50,23,47,18,5,2,0,163
66380308,15,33,32,34,17,8,1,2,142
66380309,91,149,128,184,157,85,17,15,826
66380310,19,39,52,74,43,10,2,1,240
66380311,38,76,117,113,79,36,17,14,490
66380312,60,105,133,116,65,41,9,7,536
66380313,33,97,89,76,53,34,14,11,407
66380401,43,81,62,88,44,25,9,14,366
66380402,52,87,92,92,68,29,10,21,451
66380403,17,39,66,66,46,48,12,24,318
66380404,30,64,48,42,32,12,3,4,235
66380405,51,79,116,97,91,67,19,36,556
66380406,30,43,55,65,60,34,8,4,299
66380407,44,56,70,78,48,30,5,4,335
66380408,55,58,81,77,42,16,6,12,347
66380409,35,68,47,55,30,8,2,3,248
66380410,35,72,69,69,27,13,4,2,291
66380411,34,59,58,50,28,9,3,3,244
66380412,22,43,35,80,51,34,4,1,270
66380501,11,24,10,24,10,7,1,3,90
66380502,9,20,9,11,10,5,0,1,65
66380503,8,17,17,15,16,9,1,1,84
66380504,10,5,5,7,12,11,5,2,57
66380505,22,43,39,39,29,14,4,1,191
66380506,13,25,25,35,35,11,2,2,148
66380507,25,36,43,56,32,13,4,7,216
66380508,33,50,46,64,38,25,8,16,280
66380509,31,43,50,63,28,19,13,15,262
66380510,50,63,77,69,50,32,9,14,364
66380511,48,74,77,59,47,24,6,15,350
66380512,25,58,64,55,42,29,11,12,296
66380513,12,48,58,61,45,44,16,23,307
66380514,24,62,75,81,57,41,14,15,369
66380601,42,76,73,74,62,33,13,14,387
66380602,42,78,60,61,35,16,6,3,301
66380603,49,81,95,101,40,26,9,11,412
66380604,33,58,75,102,71,34,10,30,413
66380605,47,72,74,82,76,40,11,21,423
66380606,43,57,73,70,58,51,19,19,390
66380607,38,57,75,93,56,36,10,19,384
66380608,29,55,53,57,16,12,5,1,228
66380609,15,43,41,29,14,10,1,1,154
66380610,34,68,88,85,68,52,14,20,429
66380611,28,52,52,59,55,40,13,26,325
66380612,37,50,70,57,47,25,6,14,306
66380613,52,68,67,76,50,43,19,12,387
66380614,49,66,89,90,60,47,16,29,446
66380615,48,64,81,72,56,40,9,13,383
66380701,51,71,93,111,80,78,14,30,528
66380702,33,49,60,61,42,15,9,16,285
66380703,27,47,70,70,38,37,12,13,314
66380704,38,63,75,74,41,26,10,12,339
66380705,33,59,58,49,32,13,2,6,252
66380706,19,39,37,35,12,13,1,2,158
66380707,84,115,98,67,36,16,1,3,420
66380708,30,46,47,64,18,9,1,0,215
66380709,39,40,40,42,33,19,6,7,226
66380710,42,66,58,83,47,24,10,11,341
66380711,28,45,64,49,27,12,4,8,237
66380712,28,58,73,73,46,20,7,8,313
66380713,26,40,47,63,50,35,8,12,281
66380801,30,63,39,57,25,6,6,1,227
66380802,34,40,39,54,42,5,3,3,220
66380803,24,49,60,83,47,22,4,6,295
66380804,18,43,39,38,13,7,1,1,160
66380805,23,34,29,42,15,5,1,3,152
66380806,30,39,50,34,21,17,3,3,197
66380807,51,35,30,25,13,8,4,1,167
66380808,53,84,99,106,74,54,23,16,509
66380809,19,26,37,34,14,8,3,2,143
66380810,37,52,37,39,19,10,2,3,199
66380811,20,44,53,53,15,5,1,0,191
66380812,17,47,40,29,17,3,3,1,157
66380813,15,32,21,29,18,3,4,3,125
66380814,22,29,28,38,15,17,5,10,164
66380815,7,18,11,7,1,1,0,0,45
66380816,19,36,24,54,34,13,9,3,192
66380901,29,50,38,42,14,4,3,1,181
66380902,28,40,33,35,16,6,6,6,170
66380903,19,63,66,77,30,19,7,6,287
66380904,13,18,40,50,35,15,4,9,184
66380905,47,67,64,63,44,14,4,7,310
66380906,44,81,70,88,61,27,11,21,403
66380907,62,65,122,124,81,66,28,27,575
66380908,28,54,81,83,54,41,16,16,373
66380909,29,64,86,69,53,39,12,24,376
66380910,88,56,58,62,35,32,12,19,362
66380911,38,54,76,86,38,42,16,24,374
66380912,36,56,71,61,38,43,20,18,343
66380913,28,58,80,101,75,44,25,25,436
66381001,29,50,80,74,73,22,19,15,362
66381002,51,53,67,70,41,29,10,10,331
66381003,49,81,65,74,34,41,5,12,361
66381004,38,61,54,51,37,24,9,15,289
66381005,48,73,59,47,22,13,4,4,270
66381006,38,75,106,86,70,36,11,18,440
66381007,27,78,92,102,77,35,20,10,441
66381008,43,84,103,104,73,53,27,37,524
66381009,54,69,73,79,44,30,12,18,379
66381010,47,73,84,102,54,42,11,18,431
66381011,44,73,67,62,21,26,9,11,313
66381101,16,25,27,34,22,21,8,10,163
66381102,10,17,40,28,15,19,8,10,147
66381103,58,72,118,120,80,57,27,41,573
66381104,42,83,101,102,52,35,17,20,452
66381105,53,65,86,65,40,11,9,4,333
66381106,41,74,73,64,26,20,7,2,307
66381107,52,93,83,67,36,32,5,4,372
66381108,54,71,77,82,48,40,9,25,406
66381109,25,54,72,56,58,48,11,18,342
66381110,52,68,91,87,67,45,22,29,461
66381111,38,40,48,57,31,28,15,18,275
66381112,16,24,31,36,26,23,9,22,187
66381201,21,33,19,24,10,4,1,1,113
66381202,18,16,7,6,3,2,0,0,52
66381203,35,89,77,87,54,25,3,18,388
66381204,9,17,16,26,13,3,6,4,94
66381205,40,91,84,131,110,32,6,3,497
66381206,48,67,69,78,44,17,3,2,328
66381207,3,7,0,0,0,1,0,0,11
66381208,0,8,2,4,1,0,0,0,15
66381209,9,23,20,30,37,25,5,1,150
66381210,14,10,24,25,15,13,2,2,105
66381211,27,26,31,27,22,17,4,13,167
66381301,39,85,78,77,40,22,2,7,350
66381302,43,52,55,59,53,17,15,9,303
66381303,24,35,61,57,44,27,8,8,264
66381304,24,48,58,63,29,10,2,5,239
66381305,46,85,82,74,53,30,10,11,391
66381306,64,80,95,114,74,48,20,32,527
66381307,61,90,111,98,63,37,12,12,484
66381308,27,31,52,62,43,38,10,12,275
66381309,32,41,65,51,35,27,12,18,281
66381310,44,44,64,58,44,43,16,14,327
66381311,25,39,53,62,53,34,18,25,309
66381312,25,47,40,66,39,13,3,6,239
66381313,47,77,68,90,56,30,12,7,387
66381314,7,26,24,28,11,4,1,0,101
66381315,17,19,25,29,15,8,0,2,115
66381316,22,28,38,36,31,15,8,12,190
66381317,16,18,21,37,15,4,1,0,112
66381318,46,74,93,99,47,32,7,14,412
66381319,17,42,52,42,20,16,4,3,196
66381401,28,38,42,43,11,8,1,0,171
66381402,7,23,49,71,42,27,7,8,234
66381403,39,67,78,73,67,52,25,28,429
66381404,36,42,48,69,39,29,10,7,280
66381405,34,43,66,67,59,37,7,10,323
66381406,50,80,72,50,43,32,5,11,343
66381407,38,63,94,76,52,36,17,21,397
66381408,33,43,66,85,57,31,20,20,355
66381409,34,45,65,76,61,52,13,10,356
66381501,18,19,27,31,16,11,4,3,129
66381502,14,26,32,39,17,10,4,3,145
66381503,48,71,79,69,40,20,7,7,341
66381504,48,61,76,77,43,20,15,16,356
66381505,16,30,40,42,24,16,5,7,180
66381506,29,75,73,93,43,16,4,4,337
66381507,66,93,102,94,61,36,13,9,474
66381508,56,91,90,97,72,41,9,8,464
66381509,33,66,76,79,46,43,11,7,361
66381510,31,51,86,95,55,41,19,27,405
66381511,24,42,43,45,55,47,9,10,275
66381512,57,79,92,94,47,32,16,14,431
66381513,64,82,84,107,66,34,13,15,465
66381514,36,54,64,73,53,41,9,11,341
66381601,86,113,64,58,26,14,1,1,363
66381602,56,67,32,32,12,2,2,0,203
66381603,95,126,81,49,16,8,1,1,377
66381604,36,70,51,40,20,10,1,1,229
66381605,49,57,38,35,14,3,3,0,199
66381606,66,77,64,54,36,16,3,3,319
66381607,83,121,87,54,25,18,3,2,393
66381608,42,68,69,58,32,10,3,1,283
66381609,40,63,52,64,39,13,3,11,285
66381610,37,62,59,75,53,31,6,7,330
66381611,52,77,69,91,35,24,3,6,357
66381701,37,65,61,68,50,12,5,10,308
66381702,33,41,37,53,25,16,5,5,215
66381703,87,84,51,50,31,19,2,3,327
66381704,37,71,64,66,34,11,4,6,293
66381705,53,67,61,29,18,12,1,3,244
66381706,43,67,36,30,10,6,0,1,193
66381707,71,70,59,32,18,12,3,1,266
66381708,113,126,53,29,20,7,3,1,352
66381709,72,47,28,8,6,4,0,0,165
66381710,60,64,40,27,10,2,0,0,203
66381711,70,65,25,19,6,4,0,0,189
66381712,84,103,65,64,35,15,1,9,376
66381713,105,122,93,51,27,10,3,2,413
66381714,116,100,58,41,15,7,3,0,340
66381801,86,174,213,186,116,94,27,29,925
66381802,49,70,75,95,62,41,15,28,435
66381803,36,68,72,69,66,48,21,15,395
66381804,61,97,91,89,46,21,6,2,413
66381805,18,28,37,40,17,5,3,1,149
66381806,37,59,68,77,55,29,5,11,341
66381807,35,59,61,72,48,32,12,17,336
66381808,47,66,74,83,51,23,10,14,368
66381809,64,74,65,46,36,14,9,5,313
66381810,24,36,53,34,27,17,2,5,198
66381901,49,63,50,66,31,23,9,10,301
66381902,67,91,95,105,61,27,8,10,464
66381903,61,58,64,65,31,27,12,10,328
66381904,17,30,36,30,29,17,8,11,178
66381905,39,77,64,72,64,43,13,12,384
66381906,19,40,20,37,15,9,1,2,143
66382001,6,6,6,2,2,2,0,0,24
66382002,29,42,30,67,48,29,12,5,262
66382003,37,75,61,69,37,15,8,2,304
66382004,4,1,3,8,3,5,0,1,25
66382005,27,38,49,43,29,16,8,11,221
66382006,18,24,37,38,27,12,8,9,173
66382007,28,41,44,50,34,21,3,8,229
66382008,27,38,38,31,18,6,0,4,162
66382009,29,44,45,44,32,22,7,7,230
66382101,22,22,22,25,14,4,1,4,114
66382102,7,7,12,10,10,7,2,1,56
66382103,9,19,13,18,11,1,0,0,71
66382104,24,93,62,67,29,12,1,3,291
66382105,4,13,14,8,12,8,1,0,60
66382106,2,5,3,3,0,3,0,0,16
66382107,20,35,45,50,59,32,11,8,260
66382108,0,0,1,2,0,0,0,0,3
66382201,74,109,122,122,68,41,20,26,582
66382202,33,45,53,63,28,31,6,7,266
66382203,20,54,49,55,30,21,11,12,252
66382204,41,48,83,80,54,48,19,20,393
66382205,39,51,53,72,40,23,10,24,312
66382206,94,113,139,113,75,66,21,20,641
66382207,38,61,44,38,24,13,7,5,230
66382208,24,50,43,65,54,37,13,19,305
66382209,44,59,50,38,34,16,9,13,263
66382210,20,35,33,40,21,13,2,2,166
66382211,17,27,31,44,21,22,4,4,170
66382212,19,25,27,40,19,10,4,9,153
66382213,20,32,48,51,42,22,4,14,233
66382214,44,67,72,87,57,47,18,18,410
66382301,19,29,49,35,31,20,17,7,207
66382302,49,61,53,55,23,24,12,12,289
66382303,15,15,8,15,9,4,1,3,70
66382304,23,51,38,51,21,12,6,3,205
66382305,0,4,1,0,1,0,0,0,6
66382306,9,6,5,4,6,2,0,0,32
66382307,11,17,9,15,3,1,0,3,59
66440101,8,26,9,16,1,5,0,0,65
66440102,9,20,13,11,4,1,0,0,58
66440103,31,37,18,12,9,6,1,0,114
66440104,12,17,6,7,1,0,0,0,43
66440105,5,16,6,3,2,1,0,0,33
66440106,12,15,9,9,5,1,1,0,52
66440107,11,13,10,8,6,0,0,0,48
66440108,6,9,3,2,0,0,0,0,20
66440109,2,4,2,1,3,0,0,0,12
66440110,9,16,6,2,1,0,0,0,34
66440111,11,4,8,4,2,0,0,0,29
66440201,39,60,36,41,16,8,0,1,201
66440202,19,30,14,14,12,5,0,1,95
66440203,16,18,9,4,0,0,1,0,48
66440204,10,13,2,7,1,0,0,0,33
66440205,12,11,6,5,2,0,0,0,36
66440206,12,23,11,13,7,4,1,0,71
66440207,18,35,20,14,9,2,1,0,99
66440208,26,23,14,8,7,2,0,0,80
66440301,48,40,49,51,23,11,5,7,234
66440302,17,35,43,31,16,14,1,4,161
66440303,0,4,1,0,0,0,0,0,5
66440304,31,38,39,34,13,10,3,3,171
66440305,13,23,16,25,4,6,1,1,89
66440306,11,13,7,14,3,1,0,0,49
66440307,23,31,17,18,2,1,0,0,92
66440308,10,9,4,6,4,1,0,0,34
66440309,9,13,8,7,2,1,0,0,40
66440310,9,8,2,6,2,3,0,0,30
66440311,9,21,14,8,5,1,0,0,58
66440312,12,11,3,4,1,0,0,0,31
66440313,12,22,21,13,9,3,0,0,80
66440314,6,9,1,3,2,0,0,0,21
66440315,9,6,0,3,0,0,0,0,18
66440316,2,5,0,0,1,1,0,1,10
66440401,23,24,16,8,2,3,0,1,77
66440402,11,27,10,13,4,3,0,0,68
66440403,9,26,9,7,4,1,0,0,56
66440404,12,17,7,8,0,2,1,0,47
66440405,12,27,12,6,2,1,1,0,61
66440406,4,12,3,4,1,1,1,0,26
66440407,8,22,6,7,2,2,0,0,47
66440408,10,14,9,2,0,0,0,0,35
66440501,5,16,11,8,2,0,0,0,42
66440502,11,33,34,39,15,8,0,1,141
66440503,18,44,46,50,29,9,5,5,206
66440504,18,25,27,28,20,15,8,3,144
66440505,72,117,105,90,34,16,6,6,446
66440506,68,113,94,64,36,15,4,4,398
66440507,67,61,37,34,12,7,0,0,218
66440508,28,35,22,10,4,2,0,0,101
66440509,28,28,22,12,7,1,0,1,99
66440510,12,21,8,6,0,0,0,0,47
66440511,21,19,8,4,1,0,0,0,53
66440512,40,21,8,9,0,1,0,0,79
66440513,21,11,2,1,0,0,0,0,35
66440601,37,73,40,47,30,25,2,5,259
66440602,18,28,30,26,27,14,9,2,154
66440603,18,23,30,36,14,10,2,2,135
66440604,22,34,32,20,9,3,1,0,121
66440605,26,23,16,14,8,2,1,1,91
66440606,18,30,28,16,13,11,3,3,122
66440607,27,34,35,40,18,16,5,4,179
66440608,54,63,50,55,35,17,8,4,286
66440609,25,45,47,58,27,15,7,11,235
66440610,11,43,50,27,34,19,3,7,194
66440611,7,18,17,17,15,5,3,0,82
66440612,33,53,66,68,24,34,7,9,294
66440613,28,39,53,46,31,26,7,11,241
66440614,19,22,31,39,22,16,2,6,157
66440615,37,38,63,57,23,19,1,5,243
66440616,28,39,23,16,9,3,1,1,120
66440617,11,17,8,11,8,1,0,1,57
66440618,18,27,14,8,2,0,0,0,69
66440619,17,28,13,12,6,6,2,2,86
66440620,19,35,19,19,7,4,2,1,106
66440621,22,30,12,17,9,3,2,1,96
66440622,25,43,36,26,15,6,4,3,158
66480101,36,67,78,69,51,28,17,14,360
66480102,37,58,73,68,37,30,10,13,326
66480103,81,89,103,84,53,22,9,14,455
66480104,57,72,69,68,34,15,12,9,336
66480105,64,104,83,74,34,15,6,9,389
66480106,68,96,82,70,39,14,3,4,376
66480107,40,57,47,56,32,17,7,9,265
66480108,39,47,61,56,34,20,8,10,275
66480109,42,41,53,55,31,17,6,13,258
66480110,52,74,92,90,60,40,21,25,454
66480111,34,59,73,69,51,25,17,20,348
66480112,41,55,67,75,58,43,17,20,376
66480113,40,45,74,68,42,33,14,14,330
66480114,49,60,86,110,65,52,11,25,458
66480115,28,37,48,53,42,28,11,16,263
66480116,44,43,52,63,36,23,9,10,280
66480117,30,48,61,57,37,27,8,6,274
66480118,35,44,53,62,44,34,8,19,299
66480119,34,43,77,66,46,21,8,18,313
66480201,24,54,82,81,60,48,19,23,391
66480202,36,39,57,53,30,16,8,13,252
66480203,25,41,34,32,17,7,4,1,161
66480204,38,35,72,69,38,23,16,19,310
66480205,35,34,65,65,38,33,6,23,299
66480206,35,41,53,48,41,34,12,14,278
66480207,60,66,68,75,62,38,20,21,410
66480208,46,58,72,85,52,34,10,18,375
66480209,36,60,78,59,43,24,12,17,329
66480210,48,66,82,79,54,44,12,22,407
66480211,32,39,45,54,32,19,5,8,234
66480212,48,67,79,73,48,23,11,15,364
66480213,76,78,83,82,43,21,8,13,404
66480301,49,52,77,68,29,20,6,13,314
66480302,55,65,71,63,42,36,15,16,363
66480303,6,8,12,9,10,3,3,9,60
66480304,36,48,56,54,57,42,12,16,321
66480305,19,44,67,52,32,25,10,8,257
66480306,33,45,63,66,40,23,9,12,291
66480307,20,28,46,52,36,26,7,18,233
66480308,41,61,75,96,75,57,19,25,449
66480309,49,68,90,94,53,29,13,21,417
66480310,53,63,90,76,58,29,22,22,413
66480311,27,37,59,44,42,24,12,13,258
66480312,29,58,67,70,38,30,18,15,325
66480313,17,41,45,41,19,11,3,1,178
66480314,9,28,17,34,12,7,2,2,111
66480315,25,48,66,69,46,36,13,23,326
66480316,11,17,11,21,19,22,5,5,111
66480401,24,41,67,44,52,32,14,16,290
66480402,18,34,41,50,39,30,12,14,238
66480403,25,31,48,72,57,39,18,19,309
66480404,32,44,64,49,45,31,24,29,318
66480405,7,6,2,3,1,0,0,0,19
66480406,28,39,41,54,38,27,9,9,245
66480407,4,6,7,11,3,6,0,0,37
66480408,4,0,1,1,1,0,0,0,7
66480409,11,9,8,4,5,0,0,0,37
66480410,10,14,6,6,4,3,0,0,43
66480411,3,12,4,19,8,0,0,1,47
66480501,15,40,39,54,30,23,15,12,228
66480502,37,45,92,74,64,48,17,23,400
66480503,34,36,57,52,30,31,4,19,263
66480504,40,47,66,57,41,21,15,25,312
66480505,18,35,45,55,53,32,6,17,261
66480506,50,52,93,102,63,53,25,36,474
66480507,45,58,92,105,66,54,24,22,466
66480508,33,50,53,49,33,15,17,13,263
66480509,76,94,101,91,57,20,7,11,457
66480510,22,50,55,42,43,19,9,15,255
66480511,42,50,63,79,54,38,20,20,366
66480512,26,35,59,52,43,36,15,4,270
66480513,46,69,91,87,72,55,7,18,445
66480514,43,68,60,59,31,23,7,5,296
66510101,1,3,1,0,2,0,0,0,7
66510102,4,1,1,1,1,0,0,0,8
66510103,11,4,5,5,1,1,0,0,27
66510104,36,38,39,40,40,9,1,1,204
66510105,71,82,59,48,9,4,1,0,274
66510106,72,57,38,22,12,4,0,0,205
66510107,53,70,23,23,13,1,0,0,183
66510108,76,113,72,57,15,4,1,1,339
66510109,63,64,48,39,9,2,2,0,227
66510110,76,114,50,24,8,3,0,2,277
66510111,62,61,25,19,9,6,0,0,182
66510112,1,2,0,2,0,1,0,0,6
66510201,7,3,3,0,0,0,0,0,13
66510301,3,3,1,4,0,0,0,0,11
66510302,1,4,2,2,0,0,0,0,9
66510303,2,1,1,2,0,0,0,0,6
66510304,0,3,2,2,0,0,0,0,7
66510401,4,2,1,1,2,1,0,0,11
66510402,5,2,1,1,0,0,0,0,9
66510403,3,6,2,3,1,0,0,0,15
66510404,3,3,2,2,0,0,0,0,10
66510405,3,2,0,0,0,1,0,0,6
66510406,0,1,2,0,0,0,0,0,3
66510407,2,8,2,2,0,0,0,0,14
66510501,1,0,2,0,0,0,0,0,3
66510502,0,1,1,1,0,0,0,0,3
66510503,4,4,0,2,0,0,0,0,10
66510504,46,54,51,35,18,5,0,2,211
66510505,47,45,35,36,16,8,2,0,189
66510506,103,109,51,45,14,3,0,1,326
66510507,73,85,32,36,6,3,1,0,236
66510508,117,136,50,41,11,5,2,1,363
66510509,77,119,66,39,9,3,1,0,314
66510510,76,95,52,34,10,4,0,0,271
66510511,64,90,73,59,31,6,0,0,323
66510601,4,3,1,0,0,0,0,0,8
66510602,1,4,1,1,0,0,0,0,7
66510603,4,1,2,1,0,0,0,0,8
66510604,4,3,1,1,1,0,0,0,10
66510605,1,0,1,1,0,0,0,0,3
66510606,1,1,1,2,3,1,0,0,9
66510607,2,5,3,2,1,0,0,0,13
66510608,3,1,0,0,0,0,0,0,4
66510609,1,2,2,0,2,0,0,0,7
66510610,0,2,1,2,0,1,0,0,6
66510701,38,40,23,30,8,2,0,0,141
66510702,4,2,3,3,0,0,0,0,12
66510703,3,2,2,0,0,1,0,0,8
66510704,0,2,1,1,0,1,0,0,5
66510705,0,4,0,0,0,0,0,0,4
66510706,3,3,1,1,0,0,0,0,8
66510707,4,4,1,1,1,0,0,0,11
66510708,0,2,0,1,1,0,0,0,4
66510709,2,0,0,1,0,0,0,0,3
66510710,2,1,0,1,1,0,0,0,5
66510711,2,1,1,1,0,0,0,0,5
66510712,2,2,1,0,0,1,0,0,6
66510713,3,2,1,3,2,0,0,0,11
66510714,87,90,35,21,16,2,2,1,254
66510715,69,89,45,33,15,4,0,0,255
66510716,50,35,13,12,5,3,1,0,119
66510801,29,30,10,16,3,2,0,1,91
66510802,44,49,18,20,5,1,0,0,137
66510803,0,1,0,0,0,0,0,0,1
66510804,3,3,0,1,0,0,0,0,7
66510805,0,1,0,0,1,0,0,0,2
66510806,2,0,0,1,0,0,0,0,3
66510807,0,0,1,1,0,0,0,0,2
66510808,2,4,3,1,0,0,1,0,11
66510809,2,4,1,0,1,0,0,0,8
66510810,3,3,1,2,2,0,0,0,11
66510811,0,4,0,0,0,0,0,0,4
66510812,1,1,1,0,0,0,0,0,3
66510813,4,3,1,0,0,0,0,0,8
66510814,0,2,0,1,1,0,0,0,4
66510815,0,4,0,1,0,0,0,0,5
66510816,2,1,0,0,0,0,0,0,3
66510817,8,4,2,0,1,0,0,0,15
66510818,36,55,31,21,7,4,1,0,155
66510901,2,0,2,1,1,0,0,1,7
66510902,5,5,2,2,2,0,0,0,16
66511001,10,20,5,8,6,2,1,0,52
66511002,2,2,0,0,0,0,0,0,4
66511003,4,4,3,0,0,0,0,0,11
66511004,0,2,1,1,0,0,0,0,4
66511005,1,0,1,1,0,0,0,0,3
66511101,0,6,1,1,1,0,0,0,9
66511102,5,2,0,0,0,0,0,0,7
66511103,2,2,1,1,1,0,0,0,7
66511104,2,6,1,1,0,0,0,0,10
66511201,3,3,1,0,0,0,0,0,7
66511202,1,3,2,0,2,1,0,0,9
66511203,9,1,3,2,0,0,0,0,15
66511301,1,1,0,0,1,0,0,0,3
66511302,12,12,7,4,1,0,0,0,36
66511303,4,6,2,2,1,0,0,0,15
66511304,0,2,4,3,1,1,0,0,11
66511305,2,3,2,1,1,0,0,0,9
66511306,4,3,3,4,1,0,0,0,15
66511307,9,5,1,3,0,0,0,0,18
66511308,37,35,21,16,8,4,0,1,122
66511309,43,37,34,16,9,2,0,0,141
66511310,26,24,12,9,1,2,0,1,75
66511311,1,9,5,0,0,0,0,0,15
66511312,1,5,1,2,0,0,0,0,9
66550101,7,9,3,3,0,1,1,0,24
66550102,8,3,0,2,2,1,0,1,17
66550103,10,12,7,4,2,3,0,1,39
66550104,6,7,7,5,0,2,1,1,29
66550105,14,12,10,3,6,5,0,0,50
66550106,4,6,4,3,2,0,0,0,19
66550201,11,8,7,2,4,2,2,0,36
66550202,35,57,48,42,24,10,5,4,225
66550203,52,61,55,33,16,0,3,0,220
66550204,73,92,62,47,22,8,1,1,306
66550205,38,56,45,45,27,9,10,3,233
66550206,34,39,26,35,11,11,3,7,166
66550207,9,7,5,5,3,0,0,0,29
66550208,6,7,7,3,0,2,0,0,25
66550209,7,10,9,17,10,3,4,0,60
66550210,41,56,33,14,9,3,1,1,158
66550211,47,50,25,21,22,8,3,0,176
66550301,12,9,8,3,4,1,1,0,38
66550302,11,11,4,4,1,1,1,0,33
66550303,12,9,9,5,4,3,1,0,43
66550304,13,14,5,3,2,2,1,1,41
66550305,19,18,13,10,4,1,0,0,65
66550306,8,15,6,13,9,0,0,0,51
66550307,17,11,10,3,3,1,0,0,45
66550308,30,37,22,12,13,6,1,1,122
66550309,46,83,45,57,25,10,5,4,275
66550310,55,64,53,55,28,10,6,1,272
66550311,75,126,82,67,36,15,5,1,407
66550312,59,87,36,12,13,0,2,0,209
66650101,36,47,55,42,38,16,3,2,239
66650102,18,40,38,40,25,20,7,7,195
66650103,1,0,2,1,2,0,1,0,7
66650104,3,2,4,2,2,0,0,0,13
66650105,17,14,13,7,10,3,1,1,66
66650201,3,7,6,2,2,1,0,1,22
66650202,69,91,60,56,19,7,2,0,304
66650203,69,132,74,80,29,12,4,1,401
66650204,89,106,68,52,20,1,2,1,339
66650205,76,113,107,81,46,15,4,9,451
66650206,38,43,43,34,32,17,10,10,227
66650207,82,93,92,49,17,11,3,4,351
66650208,29,59,88,51,20,24,9,4,284
66650209,7,5,5,4,3,2,1,0,27
66650301,6,4,4,1,2,0,1,0,18
66650302,27,57,46,70,47,23,9,6,285
66650303,37,50,51,29,30,22,10,8,237
66650304,2,3,3,3,3,1,0,2,17
66650305,27,38,27,31,22,3,3,2,153
66650306,19,27,35,46,23,13,4,2,169
66650307,14,27,30,34,17,10,1,2,135
66650308,11,13,20,21,17,8,3,3,96
66650309,25,50,49,77,45,22,12,6,286
66650310,88,120,108,94,34,12,1,0,457
66650311,4,5,9,8,2,2,1,2,33
66650401,22,27,18,25,20,8,1,2,123
66650402,6,10,9,8,7,4,3,0,47
66650403,9,9,2,3,2,1,0,0,26
66650404,5,6,2,4,0,0,1,0,18
66650501,4,2,2,2,0,0,0,1,11
66650502,6,4,7,8,0,1,1,0,27
66650503,7,12,6,2,6,0,0,0,33
66650601,4,2,2,0,2,2,1,0,13
66650701,9,7,9,7,3,0,1,0,36
66650801,2,3,5,1,1,0,1,0,13
66650901,3,7,4,6,3,1,2,0,26
66651001,49,85,55,62,33,15,4,8,311
66651002,44,59,77,80,45,20,5,8,338
66651003,4,5,2,1,1,0,0,1,14
66651004,10,3,5,3,1,1,0,0,23
66651005,1,2,1,1,2,0,0,0,7
66651006,2,1,3,0,0,1,0,1,8
66651007,51,89,65,58,32,13,9,11,328
66651008,48,84,76,80,37,33,11,16,385
66651101,3,5,3,3,5,2,0,0,21
66651201,0,0,0,0,0,0,0,0,0
66651202,2,0,0,0,0,0,0,0,2
66651301,4,0,2,2,1,0,0,0,9
66651302,0,0,0,0,0,0,0,0,0
66651303,44,57,52,71,45,20,6,13,308
66651304,60,79,69,47,36,16,5,6,318
66651305,74,93,91,75,50,25,6,5,419
66651306,69,84,84,95,52,22,9,10,425
66651307,51,65,55,55,28,5,6,3,268
66651308,26,46,45,68,38,18,8,6,255
66651309,46,54,76,78,50,32,19,22,377
66651310,56,82,67,47,36,15,3,5,311
66651311,86,71,70,82,44,21,2,5,381
66651312,86,96,116,116,46,29,11,8,508
66720101,3,1,3,2,0,0,1,0,10
66720102,6,6,1,3,4,1,0,0,21
66720103,5,0,0,2,0,1,0,0,8
66720104,1,4,2,4,3,0,0,0,14
66720201,2,4,2,1,1,0,1,1,12
66720202,4,3,1,4,2,0,1,0,15
66720301,0,1,0,2,0,0,0,0,3
66720302,1,2,1,7,3,1,0,0,15
66720303,6,2,2,0,2,0,0,0,12
66720401,4,4,3,2,1,0,0,0,14
66720402,7,5,4,3,0,0,0,0,19
66720403,7,12,9,5,4,2,0,1,40
66720404,2,4,5,2,2,0,0,0,15
66720501,6,6,0,2,0,0,0,0,14
66720502,1,3,1,1,0,0,0,0,6
66720503,3,1,2,1,1,0,0,0,8
66720504,2,0,0,2,2,0,0,0,6
66720601,2,1,1,2,1,0,0,0,7
66720602,1,3,2,2,0,1,0,0,9
66720603,1,1,1,1,0,0,0,0,4
66720604,2,2,1,0,1,0,0,0,6
66720701,5,12,8,2,4,3,0,0,34
66720702,13,7,4,3,2,0,0,0,29
66720801,1,6,2,4,0,0,0,0,13
66720802,4,4,4,1,1,0,0,0,14
66720901,6,4,2,4,1,1,0,0,18
66720902,3,5,4,0,1,0,0,0,13
66720903,6,5,1,1,1,1,0,0,15
66721001,3,8,2,4,1,0,0,0,18
66721002,7,5,4,1,3,0,0,0,20
66721101,2,1,1,3,0,0,0,0,7
66721102,9,5,1,0,0,1,0,0,16
66721103,3,3,2,3,4,0,0,0,15
66721104,5,2,2,5,1,0,0,0,15
66721201,93,108,102,100,43,28,2,7,483
66721202,59,91,48,39,13,7,5,1,263
66721203,74,86,70,66,22,10,3,2,333
66721204,108,98,79,44,24,17,2,4,376
66721205,89,108,69,46,27,7,0,1,347
66721206,106,107,57,44,22,5,4,1,346
66721207,112,103,72,59,22,8,3,1,380
66721208,94,125,57,59,33,12,2,2,384
66721209,73,92,40,46,21,11,4,0,287
66721210,93,125,137,134,85,39,21,17,651
66721211,5,7,1,3,3,0,0,1,20
66721212,12,13,6,5,3,3,1,0,43
66721213,2,3,4,2,1,0,1,0,13
66721214,25,34,39,26,25,15,2,4,170
66721215,64,85,61,50,24,7,1,2,294
66721216,53,68,60,52,25,14,7,7,286
66721301,5,2,1,3,1,0,1,0,13
66721302,1,4,2,2,0,1,0,0,10
66721303,1,10,3,3,1,1,0,0,19
66721401,3,3,2,0,1,0,0,0,9
66721402,15,14,6,10,4,2,0,0,51
66721403,11,17,12,13,4,4,1,0,62
66790101,21,13,12,15,7,5,2,3,78
66790102,3,8,4,2,3,1,0,0,21
66790103,2,5,5,3,1,1,0,0,17
66790104,3,4,0,3,1,0,0,0,11
66790105,24,20,13,19,5,6,2,2,91
66790201,7,4,5,0,1,1,0,0,18
66790202,4,4,0,2,1,1,0,0,12
66790301,8,2,4,1,4,0,1,1,21
66790302,26,26,35,34,15,4,5,4,149
66790303,26,46,41,23,12,7,3,1,159
66790304,22,36,17,17,13,1,4,1,111
66790305,24,21,28,17,8,4,1,4,107
66790306,4,2,4,1,2,1,0,0,14
66790401,1,1,1,3,0,0,0,0,6
66790402,2,2,1,3,3,1,0,0,12
66790403,5,1,1,1,2,0,0,1,11
66790404,0,3,1,4,0,0,0,0,8
66790405,3,0,0,0,2,1,0,0,6
66790501,1,1,1,1,0,0,0,0,4
66790502,7,4,2,6,4,1,2,0,26
66790503,4,1,0,4,0,0,0,1,10
66790601,61,73,71,64,39,35,10,12,365
66790602,56,47,50,43,27,27,6,9,265
66790603,38,54,58,40,34,7,3,4,238
66790604,60,70,48,42,32,6,4,8,270
66790605,59,84,96,73,43,18,8,8,389
66790606,34,53,55,57,38,19,5,5,266
66790607,54,44,42,53,33,27,11,0,264
66790608,28,42,31,31,23,14,9,7,185
66790609,62,67,35,27,36,7,5,5,244
66790610,48,90,70,48,26,4,3,2,291
66790611,65,71,59,37,27,3,3,1,266
66790612,48,62,40,34,17,11,3,2,217
66790613,59,74,49,16,34,7,0,0,239
66790701,3,4,2,2,0,1,0,0,12
66790702,1,7,2,2,1,0,0,0,13
66790801,5,7,5,3,1,0,0,0,21
66790802,10,4,5,6,5,1,0,0,31
66790901,29,42,38,29,10,8,3,4,163
66790902,7,5,7,7,2,1,1,0,30
66790903,0,4,3,3,1,0,1,1,13
66790904,13,18,18,9,10,6,3,2,79
66790905,37,44,37,21,15,7,3,1,165
66791001,22,38,39,68,55,22,9,13,266
66791002,2,4,2,0,1,1,0,0,10
66791003,6,3,2,4,5,2,0,0,22
66791101,6,3,0,3,2,1,2,1,18
66791102,12,8,6,6,5,3,1,0,41
66791103,3,8,1,3,1,0,1,0,17
66791201,24,30,17,14,6,3,0,0,94
66791202,7,2,2,3,1,1,0,0,16
66791203,5,7,5,3,0,0,0,0,20
66791204,14,7,5,4,1,0,0,0,31
66791205,1,0,0,0,0,0,0,1,2
66791206,5,14,0,4,3,2,0,0,28
66860101,40,40,34,44,24,11,4,2,199
66860102,50,82,88,109,44,28,8,9,418
66860103,74,109,68,53,18,14,6,4,346
66860104,78,93,79,49,24,11,3,3,340
66860105,80,108,39,35,15,4,0,0,281
66860106,64,91,55,33,20,2,1,1,267
66860107,61,83,38,35,17,2,1,0,237
66860108,81,77,41,33,16,6,0,0,254
66860109,78,85,44,35,8,4,1,0,255
66860110,77,80,81,53,34,14,7,1,347
66860201,54,57,50,37,30,11,4,1,244
66860202,25,47,29,25,14,1,1,0,142
66860203,5,6,4,8,3,0,2,0,28
66860204,0,1,1,0,0,0,0,0,2
66860205,2,0,1,0,0,0,0,0,3
66860206,0,1,1,0,1,0,0,0,3
66860207,0,1,1,0,0,0,0,0,2
66860208,1,4,0,0,0,0,0,0,5
66860209,3,2,1,1,1,1,1,0,10
66860210,0,1,0,0,0,0,0,0,1
66860301,1,4,3,3,3,0,0,0,14
66860302,8,5,4,3,4,0,0,0,24
66860303,2,2,3,2,4,0,0,0,13
66860304,5,4,3,3,4,1,0,1,21
66860401,1,3,0,0,0,0,0,0,4
66860402,0,0,1,2,3,1,0,0,7
66860403,1,1,1,1,0,0,0,0,4
66860501,2,1,3,2,0,1,0,1,10
66860502,4,5,3,1,1,0,0,0,14
66860601,21,47,37,30,23,7,6,6,177
66860602,11,16,11,9,9,0,1,0,57
66860603,4,4,5,3,3,4,1,0,24
66860604,6,4,4,8,2,0,0,0,24
66860605,9,3,3,2,1,1,0,0,19
66860606,7,7,2,1,0,1,0,0,18
66860607,0,5,2,0,1,0,0,0,8
66860608,34,46,43,29,17,7,1,1,178
66860609,32,31,43,47,17,10,5,4,189
66860701,3,10,3,0,4,1,0,0,21
66860702,1,5,0,3,1,0,0,0,10
66860703,4,6,1,3,1,0,0,0,15
66860704,0,0,0,0,1,0,0,0,1
66860705,0,0,5,2,0,0,0,0,7
66860706,0,3,0,2,0,1,0,1,7
66860707,1,6,2,5,2,0,0,0,16
66860801,0,1,2,2,2,0,0,0,7
66860802,0,2,1,1,1,0,0,0,5
66860803,1,2,2,3,1,0,0,0,9
66860804,0,6,1,0,1,0,0,0,8
66860805,8,7,7,5,4,2,0,0,33
66860901,2,2,1,1,0,1,0,0,7
66860902,3,2,0,2,0,0,0,0,7
66860903,1,1,2,2,1,1,1,0,9
66861001,2,0,0,1,0,0,1,0,4
66861002,8,7,5,7,3,4,2,0,36
66861003,2,3,5,2,2,1,0,0,15
66861101,75,88,54,58,32,7,5,2,321
66861102,5,1,2,1,1,0,0,0,10
66861103,3,6,1,3,0,0,0,0,13
66861201,3,5,1,1,0,0,0,0,10
66861202,1,1,2,0,0,0,0,0,4
66861203,3,1,4,3,1,3,0,0,15
66861204,2,2,0,2,1,0,0,0,7
66861301,19,29,38,26,13,9,2,4,140
66861302,25,37,36,41,26,17,7,9,198
66861303,30,38,51,27,19,9,2,5,181
66861304,35,34,70,50,32,22,11,8,262
66861305,30,42,52,58,47,32,5,8,274
66861306,21,47,35,50,16,7,1,5,182
66861307,38,58,54,51,15,10,6,2,234
66861308,18,27,37,30,16,14,3,1,146
66861309,71,83,60,53,20,9,1,4,301
66861310,78,93,55,40,24,4,3,2,299
66861311,86,68,50,42,17,5,0,0,268
66861312,70,87,57,31,12,7,2,0,266
66861313,83,87,37,50,20,4,0,2,283
66861314,36,39,48,39,18,6,3,1,190
66930101,12,10,9,6,7,4,0,0,48
66930102,7,3,9,2,2,0,0,0,23
66930201,9,7,6,8,2,0,0,0,32
66930202,11,11,6,3,7,2,0,0,40
66930203,4,5,1,2,2,2,0,0,16
66930301,11,13,11,6,8,3,1,0,53
66930302,6,8,7,6,3,1,1,0,32
66930303,8,16,13,14,6,1,0,0,58
66930304,20,14,11,7,3,1,0,2,58
66930305,43,37,26,23,11,7,3,4,154
66930306,50,48,41,16,18,6,3,2,184
66930307,105,127,91,72,28,9,2,0,434
66930308,71,67,36,34,20,4,1,1,234
66930309,55,51,31,21,16,4,1,1,180
66930310,35,59,45,21,12,6,1,1,180
66930311,78,91,86,68,37,21,11,4,396
66930312,62,83,47,23,17,7,0,2,241
66930313,72,62,63,43,23,5,1,0,269
66930314,28,33,46,43,23,8,3,3,187
66930315,0,3,0,1,0,0,0,0,4
66930316,48,53,67,67,34,21,9,16,315
66930317,68,93,41,32,14,4,1,1,254
66930318,41,76,43,37,22,9,5,6,239
66930319,23,45,55,69,41,28,12,8,281
66930401,13,19,14,9,2,5,1,1,64
66930402,16,10,8,6,3,3,0,0,46
66930501,5,3,4,1,3,0,0,0,16
66930502,0,4,4,8,1,3,0,0,20
66930601,3,3,4,3,1,0,1,0,15
66930602,2,3,3,2,1,2,1,1,15
66930603,3,1,0,0,2,2,2,1,11
66930604,2,4,6,5,1,1,0,0,19
66930701,3,6,1,6,2,0,0,0,18
66930702,2,5,2,3,2,2,0,0,16
66930703,29,20,17,12,8,3,1,2,92
66930704,12,14,10,4,6,4,0,1,51
67000101,32,33,19,19,11,1,0,0,115
67000102,46,44,26,30,17,7,1,3,174
67000103,2,2,1,1,1,0,0,0,7
67000104,0,1,1,2,1,0,0,0,5
67000105,1,1,1,1,2,0,0,0,6
67000106,1,1,3,0,0,1,0,0,6
67000107,3,2,4,2,1,0,0,0,12
67000108,1,1,1,0,1,0,0,0,4
67000109,0,2,0,0,0,0,0,0,2
67000110,44,69,41,18,17,2,1,0,192
67000201,7,3,1,3,0,0,0,0,14
67000202,2,3,3,2,0,1,0,0,11
67000203,1,2,1,1,0,0,0,0,5
67000204,5,15,17,20,12,6,1,2,78
67000205,29,61,38,41,22,3,0,0,194
67000206,53,75,38,34,20,3,2,2,227
67000207,40,53,27,19,9,2,0,0,150
67000208,58,63,35,25,7,3,0,0,191
67000209,104,119,59,51,24,4,0,0,361
67000210,72,70,28,31,11,3,1,0,216
67000211,43,58,55,50,18,10,1,2,237
67000212,58,58,46,37,21,10,2,4,236
67000213,68,101,62,43,16,6,0,0,296
67000214,73,94,52,43,30,8,3,2,305
67000215,62,60,58,70,37,19,5,4,315
67000216,37,62,69,67,33,16,4,2,290
67000301,4,3,0,0,0,0,0,0,7
67000302,5,2,2,1,0,0,0,0,10
67000303,4,1,0,1,0,0,0,0,6
67000401,3,8,2,1,1,0,0,1,16
67000402,6,2,3,3,0,0,0,0,14
67000501,13,18,15,14,4,2,0,0,66
67000502,1,2,1,1,0,1,0,0,6
67000503,3,0,3,1,1,0,0,0,8
67000504,0,3,1,1,0,1,0,0,6
67000505,9,3,3,2,1,0,1,0,19
67000601,1,0,2,0,0,0,0,0,3
67000602,2,5,4,0,0,1,0,0,12
67000603,36,44,27,33,10,2,0,0,152
67000604,73,73,44,34,16,8,2,2,252
67000605,58,79,38,27,21,6,3,4,236
67000606,29,48,38,43,15,6,3,1,183
67000701,55,57,39,35,3,7,2,1,199
67000702,1,3,1,1,0,1,0,0,7
67000703,5,1,1,0,2,0,0,1,10
67000704,2,3,1,2,0,0,0,0,8
67000705,4,2,4,3,1,0,1,0,15
67000706,3,4,0,1,1,0,0,0,9
67000707,2,3,3,1,2,0,0,0,11
67000801,3,4,0,0,1,0,0,0,8
67000802,2,2,0,2,0,0,0,0,6
67000803,1,2,1,0,0,0,0,0,4
67000804,1,4,0,1,0,1,0,0,7
67000805,5,1,0,0,0,0,0,0,6
67000806,0,2,1,0,0,0,0,0,3
67000807,3,1,2,1,0,0,0,0,7
67000808,0,0,0,0,0,0,0,0,0
67000809,1,2,2,0,0,0,0,0,5
67000901,4,0,0,1,0,1,0,0,6
67000902,2,2,1,0,0,0,0,0,5
67000903,3,1,0,1,0,0,0,0,5
67000904,5,1,0,3,0,0,0,0,9
67001001,1,4,0,0,0,0,0,0,5
67001002,1,2,1,2,2,0,0,0,8
67001003,21,17,8,7,0,1,1,0,55
67001004,1,2,0,1,0,0,0,0,4
67001101,2,6,2,2,2,0,0,0,14
67001102,1,2,0,2,0,0,0,0,5
67001201,4,1,1,2,0,0,0,0,8
67001202,6,4,3,1,2,0,0,0,16
67001203,1,2,3,2,0,0,0,0,8
67001204,44,79,46,32,23,6,3,1,234
67001205,29,37,43,41,18,9,3,2,182
67001206,38,49,30,16,10,3,2,0,148
67001207,97,82,55,52,16,3,1,1,307
67001208,2,0,0,0,0,0,0,0,2
67001209,31,47,41,33,14,7,1,1,175
67001210,55,95,57,42,14,3,1,0,267
67001211,68,95,70,58,26,7,2,2,328
67001212,94,122,78,52,24,5,0,0,375
67001213,47,64,41,33,9,2,2,1,199
67070101,51,63,73,71,39,19,13,5,334
67070102,57,107,94,95,56,24,13,12,458
67070103,42,60,45,36,24,7,3,5,222
67070104,35,60,47,34,28,14,6,3,227
67070105,102,131,67,52,29,10,3,2,396
67070106,86,132,73,72,19,15,2,4,403
67070107,73,90,62,34,10,5,3,1,278
67070108,69,74,28,29,18,8,0,1,227
67070109,96,85,51,36,21,11,2,1,303
67070110,65,57,56,30,17,9,2,1,237
67070111,24,41,27,32,15,6,0,0,145
67070112,39,44,55,41,31,8,6,7,231
67070113,29,46,43,44,44,27,7,4,244
67070114,36,43,23,27,11,7,2,2,151
67070115,42,67,56,49,18,9,4,2,247
67070116,27,45,29,24,27,10,5,11,178
67070117,49,71,56,64,27,14,9,5,295
67070201,16,6,1,1,2,0,0,0,26
67070202,6,14,5,2,3,3,1,0,34
67070301,21,26,13,14,7,5,1,0,87
67070401,20,28,27,20,20,12,6,5,138
67070402,21,22,21,18,9,6,2,2,101
67070403,47,62,52,51,37,13,7,2,271
67070404,10,19,10,10,4,0,0,1,54
67070405,25,42,57,81,45,19,5,4,278
67070501,14,29,13,13,4,3,0,1,77
67070502,6,7,10,6,0,1,1,1,32
67070503,6,11,6,8,2,0,1,0,34
67070504,6,20,4,4,3,6,1,0,44
67070601,2,3,2,2,0,0,0,0,9
67070602,12,13,8,3,6,0,1,0,43
67070603,29,37,23,15,13,9,2,2,130
67070604,40,42,39,18,10,6,1,1,157
67070605,31,31,19,38,19,3,3,3,147
67070606,10,19,9,8,6,4,0,0,56
67070607,44,56,23,20,6,7,1,1,158
67070608,6,10,6,3,5,0,0,1,31
67070701,0,0,0,0,0,0,1,0,1
67070702,9,11,11,11,2,3,1,0,48
67070801,22,25,15,8,5,3,3,0,81
67070802,15,23,14,7,1,0,2,0,62
67070803,10,18,10,7,1,0,1,0,47
67070901,9,16,14,11,4,1,0,2,57
67070902,9,22,16,10,9,0,0,1,67
67070903,6,8,10,3,2,0,1,0,30
67071001,5,5,4,4,4,0,1,0,23
67071002,6,11,7,7,1,0,0,1,33
67071101,44,73,57,92,34,20,9,5,334
67071102,61,70,76,63,33,23,9,7,342
67071103,39,75,46,39,27,13,2,7,248
67071104,63,94,83,76,37,15,7,2,377
67071105,62,76,47,47,28,10,3,3,276
67071106,54,112,56,30,15,6,2,3,278
67071107,86,109,55,32,17,3,1,1,304
67071108,68,95,58,44,25,9,1,2,302
67071109,58,78,33,29,12,7,1,0,218
67071110,74,130,64,59,31,15,5,2,380
67071111,42,67,52,33,24,10,1,2,231
67071112,32,46,49,33,27,7,8,3,205
67071113,46,82,96,53,31,20,8,5,341
67140101,85,107,69,92,34,10,5,6,408
67140102,88,95,69,50,34,12,6,5,359
67140103,73,96,59,62,14,2,4,1,311
67140104,98,92,59,47,17,3,3,2,321
67140105,79,119,80,59,20,11,0,1,369
67140106,64,113,56,34,28,8,0,3,306
67140107,71,89,77,56,24,10,4,6,337
67140108,83,88,74,45,18,5,2,1,316
67140109,103,87,52,37,12,5,1,1,298
67140110,79,121,75,61,26,8,2,3,375
67140111,62,75,30,31,18,7,3,2,228
67140112,66,87,55,53,26,7,1,3,298
67140113,40,50,34,36,16,11,3,9,199
67140114,38,52,62,62,27,27,12,18,298
67140115,54,55,35,31,21,4,6,5,211
67140201,0,2,2,0,0,1,0,1,6
67140202,2,4,4,4,1,0,0,0,15
67140203,2,5,1,0,1,1,0,1,11
67140204,1,3,0,2,1,0,0,0,7
67140205,1,1,3,1,1,0,0,0,7
67140206,5,1,2,0,2,0,0,0,10
67140207,3,2,2,3,1,1,0,0,12
67140301,143,187,125,77,56,13,9,8,618
67140302,1,3,1,1,1,1,0,0,8
67140303,1,1,0,1,0,0,0,0,3
67140304,2,0,1,1,1,1,0,0,6
67140305,2,3,3,1,0,0,0,0,9
67140306,2,1,0,1,0,0,0,0,4
67140401,3,3,2,3,2,0,0,0,13
67140402,5,3,3,4,2,0,0,0,17
67140403,3,6,6,5,0,0,0,0,20
67140404,6,3,1,0,0,1,0,0,11
67140501,43,61,35,44,22,5,2,5,217
67140502,5,2,2,3,1,1,0,0,14
67140503,2,8,5,2,4,0,0,0,21
67140504,6,10,10,10,10,7,1,5,59
67140505,6,12,5,4,2,0,0,0,29
67140601,27,55,63,79,62,28,11,5,330
67140602,44,72,79,73,33,26,5,7,339
67140603,24,42,27,22,13,6,2,0,136
67140604,29,40,52,43,38,28,12,14,256
67140605,45,67,68,65,31,16,7,3,302
67140606,50,66,57,40,20,5,1,1,240
67140607,47,63,52,53,18,11,4,6,254
67140608,38,48,53,59,34,16,8,8,264
67140609,30,42,64,72,29,17,6,5,265
67140610,21,31,34,42,16,12,5,3,164
67140611,76,81,81,49,27,8,4,2,328
67140612,44,64,59,60,33,12,6,5,283
67140613,67,92,112,101,59,18,8,14,471
67140614,0,2,1,0,3,0,1,0,7
67140615,14,31,19,21,16,11,7,5,124
67140616,22,39,37,40,29,17,14,7,205
67140617,38,49,65,59,38,23,10,11,293
67140701,2,2,0,1,0,0,1,0,6
67140702,16,11,7,10,2,5,3,4,58
67140703,2,3,2,2,0,0,0,1,10
67140801,29,43,27,22,11,3,3,0,138
67140802,1,3,0,1,0,0,0,0,5
67140803,4,1,2,0,0,1,0,0,8
67140804,5,20,5,5,1,4,0,1,41
67140805,5,7,1,4,1,1,0,0,19
67140806,9,19,15,8,8,4,1,0,64
67140807,0,1,2,3,0,2,0,0,8
67140808,5,7,1,0,0,1,0,0,14
67140809,33,67,45,35,6,3,5,1,195
67140901,11,8,8,3,11,4,2,4,51
67140902,3,4,1,1,3,0,1,0,13
67140903,7,1,1,2,1,0,0,0,12
67140904,5,5,3,2,2,0,0,1,18
67140905,1,4,1,0,0,0,0,0,6
67140906,2,3,3,1,1,0,0,1,11
67210101,46,75,38,32,19,10,3,4,227
67210102,5,7,5,4,0,2,0,0,23
67210103,5,5,2,5,0,0,0,0,17
67210104,12,4,6,5,2,3,0,0,32
67210201,63,69,46,29,16,5,3,1,232
67210202,41,32,21,9,5,0,0,0,108
67210203,76,73,41,23,7,2,1,0,223
67210204,118,111,80,59,23,10,5,3,409
67210205,88,112,74,67,20,5,0,1,367
67210206,37,53,64,42,20,14,3,3,236
67210207,33,74,73,50,26,14,2,0,272
67210208,0,3,3,1,0,0,0,0,7
67210209,13,2,3,3,1,1,0,0,23
67210210,2,0,0,1,1,0,0,0,4
67210211,2,2,4,0,3,1,0,0,12
67210212,7,1,3,2,1,0,0,0,14
67210213,3,3,3,2,2,0,0,0,13
67210214,37,50,58,48,31,10,3,3,240
67210215,39,60,60,44,21,5,6,1,236
67210216,55,72,58,19,11,4,0,1,220
67210217,67,76,46,38,15,5,0,0,247
67280101,65,61,56,52,34,15,8,14,305
67280102,16,11,14,9,4,5,0,1,60
67280201,21,27,16,20,9,2,5,2,102
67280202,16,18,12,13,10,2,2,1,74
67280203,3,5,4,5,2,3,0,0,22
67280204,6,4,0,2,2,0,0,1,15
67280301,4,1,4,2,2,1,0,0,14
67280302,6,2,5,0,1,1,0,0,15
67280303,7,4,6,5,2,3,0,0,27
67280304,4,1,3,0,0,2,0,0,10
67280401,1,1,7,3,3,0,1,0,16
67280402,2,1,0,1,0,0,1,0,5
67280403,2,1,1,0,0,0,0,0,4
67280501,4,4,3,2,1,3,0,0,17
67280502,2,2,4,0,0,1,0,0,9
67280503,5,5,3,1,0,1,0,0,15
67280601,1,6,0,1,1,0,0,0,9
67280602,2,3,1,4,1,1,1,1,14
67280603,2,1,0,1,0,0,0,0,4
67280701,2,2,3,2,1,2,0,0,12
67280702,0,4,1,2,0,1,0,0,8
67280703,4,4,9,4,2,2,1,3,29
67280801,8,12,5,6,5,0,0,2,38
67280802,6,6,2,4,4,0,0,1,23
67280803,6,5,0,5,1,0,1,0,18
67280901,26,25,17,16,16,9,2,1,112
67280902,16,19,15,22,9,4,1,4,90
67280903,18,38,27,28,13,3,1,2,130
67280904,12,29,51,56,45,17,8,6,224
67281001,22,41,38,53,28,20,8,6,216
67281002,36,40,33,29,8,7,4,5,162
67281003,66,53,63,55,22,14,4,6,283
67281004,42,43,35,31,10,5,2,2,170
67281005,40,43,31,27,4,9,2,2,158
67281006,35,39,22,20,13,10,1,1,141
67281007,37,41,29,24,18,4,6,3,162
67281008,47,43,31,33,19,9,2,2,186
67281009,40,48,28,34,16,10,2,4,182
67281010,67,68,48,53,20,7,0,6,269
67281011,36,47,59,47,27,10,1,1,228
67281012,44,45,34,27,10,4,0,0,164
67281013,42,49,45,35,18,11,6,3,209
67281014,44,46,27,27,18,5,1,3,171
67281015,55,52,41,25,12,5,1,3,194
67281016,59,62,30,35,12,6,1,2,207
67281017,42,49,37,29,14,7,2,2,182
67281018,42,45,52,52,32,20,3,2,248
67281019,50,77,60,57,33,10,9,7,303
67281020,47,44,48,60,27,19,5,7,257
67281021,43,52,67,48,33,13,8,3,267
67281022,37,56,63,55,38,22,9,9,289
67281023,8,10,9,12,5,5,2,4,55
67281024,26,42,66,50,32,28,14,5,263
67281025,5,10,3,6,10,5,0,3,42
67281026,3,3,2,3,2,0,0,0,13
67281101,1,2,3,0,0,0,0,0,6
67281102,6,4,7,4,2,2,4,2,31
67281103,9,2,7,3,2,0,1,1,25
67281201,7,5,5,1,1,1,0,1,21
67281202,6,7,1,2,5,0,0,0,21
67281301,33,34,32,29,13,10,3,2,156
67281302,11,10,4,2,5,0,1,0,33
67281303,7,5,2,3,2,2,0,0,21
67281401,6,6,4,9,8,4,1,2,40
67281402,16,36,35,27,22,14,3,5,158
67281403,11,9,5,7,1,5,1,1,40
67281404,6,3,6,3,4,3,1,0,26
67281405,4,2,8,9,7,3,1,1,35
67281406,14,8,7,13,7,3,1,1,54
67281407,6,5,2,2,0,1,1,1,18
67281408,5,5,7,6,1,2,2,0,28
67281501,11,10,9,9,4,3,1,3,50
67281502,5,4,3,3,2,3,0,0,20
67281503,8,4,3,3,4,0,0,0,22
67281601,3,4,1,1,1,0,0,0,10
67281602,3,3,1,1,1,0,0,0,9
67281603,6,7,2,2,0,0,0,1,18
67350101,21,28,40,37,16,7,3,1,153
67350102,35,43,40,35,13,5,1,0,172
67350103,45,69,60,47,19,10,6,0,256
67350104,62,62,43,42,25,3,2,0,239
67350105,84,112,78,56,41,10,4,2,387
67350106,75,115,69,65,36,11,3,5,379
67350107,85,87,65,48,31,8,4,1,329
67350108,56,75,38,32,22,6,5,0,234
67350109,75,92,91,74,37,17,5,6,397
67350110,78,92,94,81,39,13,5,1,403
67350201,30,54,37,28,17,11,3,4,184
67350202,6,3,3,5,3,0,2,0,22
67350203,1,0,1,0,2,0,0,0,4
67350204,13,7,12,5,7,2,0,1,47
67350205,8,17,8,6,2,0,1,1,43
67350206,9,3,12,5,1,1,0,1,32
67350207,4,7,3,4,2,0,0,1,21
67350208,6,2,2,2,1,1,0,0,14
67350301,20,33,34,27,22,8,3,4,151
67350302,4,9,1,5,4,2,0,1,26
67350303,3,3,3,4,2,0,0,0,15
67350304,2,5,4,3,1,1,0,0,16
67350305,2,3,7,2,3,1,3,1,22
67350306,8,5,13,7,4,2,0,0,39
67350307,8,10,5,7,0,0,0,1,31
67350308,29,42,28,32,26,9,4,12,182
67350401,0,3,1,4,1,2,1,0,12
67350402,11,7,8,16,8,2,0,1,53
67350403,4,1,8,7,1,1,0,0,22
67350404,15,29,22,25,19,13,1,0,124
67350501,0,1,1,2,3,1,0,0,8
67350502,0,2,1,1,0,0,0,0,4
67350503,3,5,3,1,0,0,2,0,14
67350504,1,0,1,0,0,0,0,0,2
67350601,5,3,2,3,1,0,0,0,14
67350602,3,4,1,1,0,0,0,0,9
67350603,1,0,1,0,0,0,0,0,2
67350701,30,51,54,62,18,9,3,2,229
67350702,36,64,80,53,46,38,9,19,345
67350703,33,65,99,76,44,35,17,12,381
67350704,23,32,32,30,18,9,3,2,149
67350705,70,80,84,74,34,16,3,9,370
67350706,48,67,78,94,53,31,15,14,400
67350707,51,64,73,78,47,24,2,7,346
67350708,67,92,62,70,30,12,7,4,344
67350709,47,90,54,55,48,12,6,4,316
67350710,24,31,48,45,39,33,16,13,249
67420101,4,5,3,5,1,1,0,0,19
67420201,17,19,9,7,5,0,0,0,57
67420301,6,4,9,5,2,1,0,0,27
67420401,81,95,77,57,17,10,2,0,339
67420402,72,77,70,52,26,10,4,0,311
67420403,70,62,45,39,18,6,0,2,242
67420404,56,85,47,51,16,2,1,1,259
67420405,52,72,46,36,14,7,2,0,229
67420406,32,58,42,32,11,5,3,2,185
67420407,37,48,50,57,31,15,7,4,249
67420408,39,54,58,25,12,5,1,0,194
67420409,5,7,3,8,6,4,0,0,33
67420410,22,28,17,19,10,6,0,2,104
67420411,0,1,0,0,0,0,0,0,1
67420412,0,1,2,0,0,0,0,0,3
67420413,42,70,57,53,27,8,0,1,258
67420414,29,42,47,40,28,4,2,0,192
67420501,5,11,5,5,2,1,0,0,29
67420601,4,4,1,0,1,0,0,0,10
67420701,7,2,5,1,3,1,0,0,19
67420702,18,13,12,7,5,0,0,0,55
67420801,5,10,6,1,5,1,0,1,29
67420901,9,13,7,5,0,3,0,1,38
67421001,2,7,2,2,2,1,0,0,16
67421002,12,24,9,7,7,2,2,0,63
67630101,64,91,74,66,39,12,5,3,354
67630102,68,100,77,57,18,6,2,0,328
67630103,75,87,84,70,44,12,5,7,384
67630104,63,107,74,71,35,8,3,1,362
67630105,50,88,62,70,34,6,4,4,318
67630106,48,72,37,41,7,1,1,1,208
67630107,50,81,43,21,13,2,0,0,210
67630108,89,120,61,44,22,9,0,0,345
67630109,91,104,84,70,29,10,0,1,389
67630110,64,89,62,53,25,10,4,0,307
67630111,72,104,78,56,29,13,2,0,354
67630112,50,73,43,39,21,2,1,0,229
67630113,55,75,48,65,26,14,1,2,286
67630114,47,79,56,51,20,9,5,2,269
67630115,68,103,90,62,39,21,1,7,391
67630201,34,33,25,18,4,5,0,0,119
67630202,19,17,17,13,3,4,2,3,78
67630203,57,88,45,45,13,7,1,2,258
67630204,37,85,65,69,31,15,4,4,310
67630205,67,109,94,87,41,15,4,10,427
67630206,78,124,75,64,18,3,0,0,362
67630207,89,101,71,37,11,7,1,1,318
67630208,46,57,25,18,9,4,1,2,162
67630209,77,93,65,47,29,7,1,3,322
67630210,72,103,71,39,22,12,3,3,325
67630211,94,102,71,52,23,3,3,3,351
67630212,68,57,25,14,5,0,0,0,169
67630213,36,36,15,6,6,1,0,0,100
67630301,122,104,47,44,18,6,1,0,342
67630302,96,135,48,57,12,4,2,1,355
67630303,81,76,29,28,8,6,0,0,228
67630304,121,122,40,42,13,2,1,0,341
67630305,70,81,46,29,4,5,0,1,236
67630306,97,88,61,38,17,7,0,0,308
67630307,88,123,80,60,17,11,0,0,379
67630308,101,110,75,51,21,6,2,0,366
67630309,75,111,90,83,33,8,1,4,405
67630310,70,70,54,38,16,11,2,0,261
67630311,59,89,63,46,20,7,1,0,285
67630401,75,68,65,50,39,13,7,8,325
67630402,70,111,75,86,28,12,1,1,384
67630403,52,74,74,59,29,10,7,4,309
67630404,44,61,59,38,23,7,1,1,234
67630405,56,88,79,51,27,19,2,2,324
67630406,40,80,58,47,29,21,4,1,280
67630407,29,40,46,38,27,15,3,0,198
67630408,30,54,98,84,31,17,1,1,316
67630409,29,51,68,72,32,11,4,4,271
67630410,50,58,43,31,14,14,1,3,214
67630501,36,63,39,46,28,11,5,3,231
67630502,38,61,58,66,37,24,7,11,302
67630503,27,79,57,53,20,12,2,2,252
67630504,24,53,34,27,23,3,0,0,164
67630505,37,64,54,54,24,12,3,1,249
67630506,40,91,76,66,41,32,8,8,362
67630507,37,87,80,83,33,9,4,2,335
67630508,22,38,39,63,23,19,5,8,217
67630509,22,53,52,59,35,17,7,12,257
67630510,15,52,53,52,32,26,3,6,239
67630511,50,106,113,73,52,32,3,3,432
67630512,14,30,41,32,16,5,2,0,140
67630513,34,46,67,69,56,25,14,9,320
67630514,23,49,66,110,58,26,3,18,353
67630515,41,76,72,46,20,9,7,2,273
67630516,42,60,49,36,24,8,2,3,224
67630517,25,49,64,68,37,20,3,5,271
67630518,30,63,55,66,47,23,11,10,305
67630601,19,56,94,125,61,36,12,17,420
67630602,22,43,70,57,34,28,4,6,264
67630603,12,24,46,63,47,39,25,32,288
67630604,51,67,83,71,50,33,12,9,376
67630605,50,75,55,47,49,21,11,6,314
67630606,28,58,81,74,48,33,12,19,353
67630607,39,72,80,104,52,25,15,13,400
67630608,34,65,74,87,72,50,11,15,408
67630609,19,39,61,79,49,34,8,9,298
67630610,26,53,83,56,39,26,6,9,298
67630611,28,45,48,63,33,23,13,14,267
67630612,20,53,53,55,39,22,8,7,257
67630613,54,47,55,61,46,17,15,10,305
67630614,42,63,63,68,54,37,13,7,347
67630615,62,73,84,90,48,45,10,14,426
67630701,6,4,5,8,1,0,0,1,25
67630702,23,46,37,57,43,28,9,13,256
67630703,27,56,64,76,54,38,14,24,353
67630704,36,67,60,72,42,21,6,5,309
67630705,42,71,66,64,42,13,6,4,308
67630706,59,84,85,110,57,25,12,13,445
67630707,41,69,61,94,35,21,8,1,330
67630708,37,71,65,59,31,10,3,2,278
67630709,28,42,39,64,31,11,5,1,221
67630710,19,57,87,96,73,40,29,17,418
67630711,57,69,109,94,88,53,21,28,519
67630712,18,26,37,39,25,9,7,4,165
67630801,32,48,55,60,26,13,2,4,240
67630802,42,69,60,65,45,21,9,9,320
67630803,28,59,51,50,29,10,5,3,235
67630804,43,85,88,82,56,29,16,11,410
67630805,26,66,65,62,46,27,6,9,307
67630806,42,69,81,64,36,23,5,6,326
67630807,38,68,76,61,36,12,6,4,301
67630808,44,75,82,88,40,24,9,12,374
67630809,38,57,65,73,50,32,23,20,358
67630810,27,43,51,48,35,28,5,11,248
67630811,94,48,43,56,25,18,9,9,302
67630812,14,17,22,30,20,10,12,10,135
67630813,37,44,56,63,38,22,10,14,284
67630901,43,62,64,42,19,11,2,3,246
67630902,24,34,32,39,26,17,5,12,189
67630903,14,5,32,23,11,7,3,6,101
67630904,22,30,20,14,10,4,0,3,103
67631001,4,5,3,2,2,0,1,0,17
67631002,0,1,1,0,0,1,0,0,3
67631101,68,87,67,76,40,24,9,5,376
67631102,62,100,84,71,52,17,7,6,399
67631103,3,7,2,3,1,0,1,0,17
67631201,30,40,33,28,11,4,0,3,149
67631202,2,10,3,0,1,0,2,0,18
67631203,5,7,4,4,2,0,0,0,22
67631301,1,4,1,0,0,0,0,0,6
67631302,4,5,0,5,2,1,0,0,17
67631401,60,77,48,56,30,12,3,3,289
67631402,6,1,1,3,1,0,0,0,12
67631403,2,7,2,7,0,0,0,0,18
67631501,10,5,4,4,0,1,0,0,24
67631601,47,51,34,40,12,6,1,2,193
67631602,65,70,39,36,25,11,0,0,246
67631603,5,5,2,3,3,1,0,0,19
67631701,57,119,87,72,42,10,2,4,393
67631702,59,94,59,52,19,4,2,0,289
67631703,35,65,61,70,35,8,3,1,278
67631704,61,97,91,82,27,16,3,2,379
67631705,36,60,58,61,44,9,3,4,275
67631706,53,73,66,65,34,20,4,2,317
67631707,60,91,100,102,52,33,13,6,457
67631708,32,56,53,51,24,18,5,2,241
67631709,22,55,61,47,30,20,6,8,249
67631801,45,77,74,67,46,22,8,7,346
67631802,27,47,60,58,41,29,9,3,274
67631803,58,46,75,87,40,28,7,11,352
67631804,31,45,61,48,36,8,3,5,237
67631805,20,43,60,46,26,13,2,5,215
67631806,18,40,50,56,23,9,4,1,201
67631807,19,39,37,43,17,13,8,6,182
67631808,8,24,27,66,31,10,2,1,169
67631809,27,78,38,47,16,5,0,1,212
67631810,50,130,85,61,31,11,2,0,370
67631811,38,110,70,51,32,2,0,2,305
67631812,25,36,33,31,21,12,3,1,162
67631813,2,2,2,3,2,0,0,0,11
67631814,46,48,72,58,44,19,6,8,301
67631815,22,31,37,34,28,16,5,4,177
67631816,24,42,54,35,30,20,6,7,218
67631901,3,2,3,0,1,1,1,1,12
67631902,0,1,3,1,0,2,0,0,7
67631903,11,12,12,18,6,0,4,2,65
67631904,1,4,5,7,2,2,0,0,21
67631905,45,80,72,82,39,19,6,6,349
67631906,35,43,45,31,14,6,3,3,180
67631907,4,1,4,3,2,2,1,0,17
67631908,9,1,5,11,7,3,4,3,43
67631909,56,66,53,61,31,14,1,1,283
67631910,80,81,63,44,14,9,3,1,295
67631911,44,42,42,29,14,15,2,1,189
67632001,15,22,21,27,14,4,1,1,105
67632002,12,17,14,22,12,4,1,3,85
67632003,36,37,47,56,27,20,6,5,234
67632004,2,11,4,19,3,2,0,0,41
67632005,6,17,22,26,9,2,0,1,83
67632006,48,94,74,86,37,18,7,4,368
67632007,11,42,44,39,14,5,0,0,155
67632008,48,92,97,71,46,21,11,7,393
67632009,46,97,66,55,29,11,3,3,310
67632010,29,59,46,58,29,6,2,3,232
67632011,25,45,38,38,16,13,8,5,188
67632012,31,59,56,44,28,12,4,6,240
67632013,35,42,62,51,31,26,8,7,262
67632101,8,0,1,1,0,0,0,0,10
67700101,26,17,23,28,15,5,1,5,120
67700102,28,31,45,29,24,22,9,8,196
67700103,70,110,112,84,66,47,14,7,510
67700104,42,73,55,73,50,40,11,15,359
67700105,66,84,83,81,53,26,10,14,417
67700106,83,95,94,67,34,15,3,3,394
67700107,89,92,80,63,27,13,8,7,379
67700108,96,84,58,39,19,5,0,0,301
67700109,80,103,48,47,12,4,0,1,295
67700110,51,77,48,47,22,9,2,3,259
67700111,64,83,74,56,30,17,11,5,340
67700201,0,4,1,1,2,0,0,0,8
67700202,11,12,12,11,7,1,1,0,55
67700203,11,14,10,6,2,1,0,0,44
67700204,5,5,3,1,1,2,0,1,18
67700205,32,63,60,57,42,17,7,24,302
67700206,46,60,38,31,15,4,2,2,198
67700207,64,50,49,53,31,17,7,10,281
67700208,2,3,2,3,3,0,0,2,15
67700301,0,1,4,3,3,0,1,1,13
67700302,1,1,0,1,0,1,0,0,4
67700303,1,2,3,0,1,0,0,0,7
67700304,1,1,0,0,2,1,0,0,5
67700305,1,0,0,2,0,0,0,0,3
67700401,3,1,1,1,0,0,0,2,8
67700402,0,0,1,1,0,0,1,1,4
67700403,2,2,0,2,0,1,0,0,7
67700404,2,0,1,2,0,0,0,0,5
67700501,0,0,0,1,0,0,0,0,1
67700502,1,0,0,0,0,0,0,0,1
67700503,0,0,2,0,0,0,0,0,2
67700504,0,3,0,0,1,0,0,0,4
67700601,1,0,1,1,0,0,0,0,3
67700602,1,2,2,2,1,1,0,0,9
67700701,1,1,4,2,1,0,0,0,9
67700702,1,0,1,0,0,0,0,0,2
67700703,0,1,0,0,0,0,0,0,1
67700704,1,2,0,1,1,0,0,0,5
67700705,2,1,0,1,2,1,0,0,7
67700801,1,7,9,7,0,0,1,1,26
67700802,1,1,1,1,0,0,0,0,4
67700803,1,3,1,4,0,1,0,0,10
67700804,1,2,3,1,0,0,0,0,7
67700805,0,2,1,0,0,0,0,0,3
67700901,29,40,45,41,20,19,2,1,197
67700902,1,7,4,2,4,1,0,1,20
67700903,1,3,4,7,3,3,1,1,23
67700904,2,1,0,0,0,0,0,0,3
67700905,3,1,0,0,0,1,0,0,5
67700906,6,7,12,8,6,3,2,0,44
67700907,2,4,2,2,3,0,0,0,13
67700908,7,14,9,4,7,2,0,0,43
67701001,26,54,42,59,39,24,6,5,255
67701002,39,53,56,56,44,14,10,3,275
67701003,38,59,57,58,30,17,8,6,273
67701004,27,41,50,56,27,11,5,5,222
67701005,59,80,81,73,32,21,2,6,354
67701006,46,92,79,72,47,21,3,5,365
67701007,59,63,87,70,41,28,6,13,367
67701008,67,85,73,81,31,17,6,11,371
67701009,53,79,76,70,31,14,8,4,335
67701010,50,75,62,74,22,11,2,2,298
67701011,15,48,23,36,15,6,2,1,146
67701012,35,23,23,18,11,4,3,2,119
67701013,82,76,103,100,64,39,23,26,513
67701014,5,6,3,4,7,2,3,1,31
67701101,9,4,11,6,2,1,0,2,35
67701102,2,3,5,2,1,0,0,1,14
67701103,9,11,9,9,5,4,1,0,48
67701104,2,8,1,3,0,0,1,0,15
67701105,3,9,2,6,5,1,0,2,28
67701201,90,75,94,87,51,44,13,12,466
67701202,7,6,6,9,4,4,2,0,38
67701203,21,21,30,21,20,15,4,4,136
67701204,2,1,1,1,1,0,1,1,8
67701205,2,0,2,3,4,1,0,0,12
67701206,0,0,1,1,3,1,0,0,6
67701301,2,5,1,0,3,1,0,0,12
67701302,3,2,3,3,1,2,0,0,14
67701303,2,9,3,2,1,1,0,1,19
67701304,3,1,4,6,4,1,1,0,20
67701305,2,0,1,3,1,2,0,0,9
67701306,1,1,1,1,2,2,0,0,8
67701307,3,2,1,4,0,1,0,0,11
67701401,0,3,4,0,0,0,0,0,7
67701402,4,3,3,2,3,0,0,0,15
67701403,1,1,0,0,2,0,0,0,4
67701501,1,0,0,1,0,0,0,1,3
67701502,3,2,1,1,0,0,0,0,7
67701503,1,2,1,0,2,0,0,0,6
67701504,1,1,1,1,0,0,1,0,5
67701505,1,2,6,1,1,0,0,0,11
67701601,46,62,69,46,40,15,7,11,296
67701602,50,71,50,39,18,8,1,2,239
67701603,55,40,70,55,16,6,2,0,244
67701604,3,3,1,2,0,0,0,0,9
67701605,11,9,4,9,2,1,0,0,36
67701606,1,4,2,0,1,0,0,0,8
67701607,1,2,2,0,3,1,0,0,9
67701701,2,0,0,4,0,0,0,0,6
67701702,2,1,0,2,2,0,0,0,7
67701703,1,0,0,1,2,0,0,0,4
67701704,0,1,3,2,0,0,0,0,6
67701705,1,4,5,2,2,0,0,0,14
67701801,36,36,38,28,20,4,3,5,170
67701802,3,2,0,2,0,1,0,0,8
67701803,2,1,0,1,1,1,1,0,7
67701804,1,2,2,3,1,1,0,0,10
67701805,1,3,2,4,4,2,0,0,16
67701806,0,3,1,3,1,0,0,0,8
67701901,3,1,0,0,0,0,0,0,4
67701902,1,0,2,0,0,0,0,0,3
67701903,2,2,1,1,2,0,0,0,8
67701904,2,2,0,0,1,0,0,0,5
67702001,1,3,2,2,2,0,0,0,10
67702002,0,0,1,1,0,0,0,0,2
67702101,72,82,46,31,11,2,2,2,248
67702102,69,85,63,46,24,6,3,5,301
67702103,69,87,41,39,13,3,1,1,254
67702104,90,99,56,23,15,4,2,2,291
67702105,82,104,48,45,20,10,2,2,313
67702106,61,79,50,45,18,11,1,1,266
67702107,80,136,93,62,28,10,3,3,415
67702108,41,84,53,44,15,7,0,0,244
67702109,71,79,47,38,12,9,1,0,257
67702110,64,78,55,47,17,3,1,1,266
67702201,42,41,67,51,36,28,10,16,291
67702202,21,44,69,67,57,29,13,18,318
67702203,42,70,102,88,61,46,9,10,428
67702204,33,54,83,98,70,65,40,47,490
67702205,55,74,60,61,53,29,10,11,353
67702206,59,104,86,78,40,26,11,7,411
67702207,46,72,60,45,30,20,2,5,280
67702208,56,71,56,45,21,9,5,2,265
67702209,53,61,46,45,13,8,7,3,236
67702210,45,74,75,53,31,4,3,3,288
67702211,55,78,48,69,16,13,4,3,286
67702212,50,65,64,76,27,26,10,8,326
67702213,40,58,46,37,12,4,1,1,199
67702214,55,74,96,105,37,20,3,1,391
67702301,10,4,2,3,2,1,0,3,25
67780101,36,60,63,62,38,11,7,2,279
67780102,49,61,44,41,24,11,3,0,233
67780103,33,50,62,44,24,14,3,3,233
67780104,31,41,37,43,33,15,11,10,221
67780105,54,76,80,87,31,23,8,9,368
67780106,42,80,65,59,48,32,13,10,349
67780107,37,38,43,50,29,14,8,8,227
67780108,34,39,51,45,30,23,4,17,243
67780109,54,65,42,29,20,19,6,6,241
67780110,8,7,9,6,4,1,2,0,37
67780111,13,12,9,6,10,1,0,2,53
67780201,28,43,36,51,22,14,8,9,211
67780202,19,21,25,30,24,16,9,6,150
67780203,17,29,38,43,17,12,4,5,165
67780204,32,39,51,56,36,23,10,20,267
67780205,48,81,84,78,49,31,9,12,392
67780206,46,56,50,49,34,11,4,6,256
67780207,39,74,70,84,59,37,13,18,394
67780208,49,71,49,40,18,9,1,2,239
67780209,45,72,69,88,49,23,7,7,360
67780210,70,94,62,39,28,9,4,3,309
67780211,28,32,35,41,20,14,4,10,184
67780212,34,44,33,44,24,21,8,4,212
67780213,25,25,27,42,24,20,5,7,175
67780214,43,74,62,50,34,14,8,5,290
67780215,46,49,55,58,54,24,12,19,317
67780216,25,27,29,32,25,22,6,6,172
67780217,41,35,33,30,19,23,3,3,187
67780218,36,33,41,41,29,23,4,13,220
67780301,14,11,4,14,4,5,0,0,52
67780401,8,4,1,2,4,0,0,0,19
67780402,7,3,4,10,2,2,2,2,32
67780403,7,20,14,9,4,4,3,0,61
67780404,23,34,18,19,11,11,2,8,126
67780405,21,35,32,33,17,12,5,9,164
67780406,17,27,21,21,7,4,3,5,105
67780407,48,76,57,61,41,14,5,7,309
67780501,21,44,41,41,35,13,6,5,206
67780502,20,12,18,11,4,5,5,1,76
67780503,3,3,1,4,2,0,1,0,14
67780504,7,7,8,3,2,2,0,0,29
67780505,9,7,6,2,2,1,0,0,27
67780506,38,58,58,69,58,29,6,13,329
67780507,31,43,39,46,41,24,8,14,246
67780601,0,0,2,1,1,0,0,0,4
67780602,9,29,37,64,27,7,2,1,176
67780603,21,26,23,23,22,10,6,4,135
67780604,45,47,73,56,47,33,19,18,338
67780701,4,4,3,3,0,1,0,0,15
67780702,3,3,4,2,3,2,0,0,17
67780703,0,4,3,3,1,0,0,0,11
67780704,3,4,3,2,2,0,0,0,14
67780801,2,2,4,4,3,1,0,0,16
67780802,0,0,1,1,0,0,0,0,2
67780803,1,6,4,1,4,0,0,0,16
67780901,0,1,3,4,1,0,0,0,9
67780902,14,31,25,27,19,8,1,2,127
67780903,33,44,52,57,34,21,9,12,262
67780904,26,23,21,28,14,10,5,6,133
67780905,54,64,86,75,57,32,10,15,393
67780906,44,85,59,74,51,28,8,8,357
67780907,15,32,31,30,21,9,3,11,152
67780908,23,15,18,16,15,19,3,4,113
67780909,42,54,45,49,29,19,7,3,248
67780910,41,60,57,50,19,9,5,2,243
67780911,68,85,67,62,28,12,6,6,334
67780912,69,77,67,59,26,9,3,1,311
67780913,58,83,59,63,27,13,3,1,307
67781001,63,73,88,85,40,30,13,23,415
67781002,25,41,48,63,34,16,14,13,254
67781003,27,33,57,47,39,30,7,18,258
67781004,40,58,61,68,33,22,11,15,308
67781005,54,54,71,77,32,22,6,5,321
67781006,44,57,35,32,23,8,1,5,205
67781007,41,76,71,74,33,27,8,11,341
67781008,46,65,67,82,61,39,11,16,387
67781009,54,83,87,75,62,34,14,10,419
67781010,41,47,43,45,13,6,1,1,197
67781011,61,51,51,57,28,14,7,1,270
67781012,46,71,63,52,36,11,11,7,297
67781013,54,45,94,93,49,39,14,22,410
67781014,25,46,54,60,35,27,15,21,283
67781015,41,29,46,39,38,28,9,9,239
67840101,1,0,1,2,0,0,1,0,5
67840102,5,3,1,1,2,0,0,0,12
67840201,1,1,0,1,2,0,0,0,5
67840202,30,34,36,22,21,10,0,7,160
67840203,2,5,3,4,1,0,1,0,16
67840204,0,2,2,0,1,0,0,0,5
67840301,2,4,0,0,0,1,0,0,7
67840302,0,3,5,1,1,2,0,0,12
67840303,0,0,0,1,1,1,0,1,4
67840401,0,0,1,1,0,0,1,0,3
67840402,3,4,1,2,2,1,0,0,13
67840403,1,1,0,2,1,0,0,0,5
67840404,1,1,1,2,1,0,0,0,6
67840501,1,0,1,1,3,0,0,1,7
67840502,0,0,3,0,2,0,0,1,6
67840503,0,2,3,4,0,0,0,0,9
67840601,2,3,2,2,1,0,0,0,10
67840701,1,4,0,3,3,0,0,0,11
67840702,1,2,1,4,0,1,0,0,9
67840703,1,1,1,2,3,0,0,0,8
67840704,1,2,1,5,0,1,0,1,11
67840801,7,5,5,4,2,1,0,0,24
67840802,16,11,17,19,10,8,3,1,85
67840803,53,51,44,61,43,17,5,4,278
67840804,41,49,77,76,46,21,14,8,332
67840805,44,51,57,46,27,15,5,5,250
67840806,56,52,44,33,31,17,1,1,235
67840807,80,89,58,33,21,3,2,4,290
67840808,91,102,68,72,35,16,1,3,388
67840809,49,62,59,38,26,23,4,4,265
67840810,51,61,49,36,24,5,5,1,232
67840811,57,73,57,75,44,8,10,9,333
67840812,4,2,3,3,2,0,0,1,15
67840813,6,5,4,8,2,0,1,1,27
67840901,4,2,2,1,0,0,0,0,9
67840902,0,2,2,0,1,0,0,0,5
67841001,2,1,1,1,1,2,1,0,9
67841002,1,0,1,1,0,0,0,0,3
67841003,3,3,1,2,1,1,0,0,11
67841004,3,3,1,0,0,1,0,0,8
67841101,0,0,1,2,0,0,2,0,5
67841102,3,1,1,3,0,0,0,0,8
67841103,4,1,2,2,1,1,0,1,12
67841104,1,0,0,0,2,0,0,0,3
67841201,3,1,1,5,0,1,0,0,11
67841202,2,3,2,2,0,1,0,0,10
67841203,5,1,5,7,6,2,0,0,26
67841204,1,0,0,2,1,0,0,2,6
67910101,102,132,74,69,29,6,3,0,415
67910102,47,57,32,22,11,5,3,1,178
67910103,83,63,39,26,16,4,1,0,232
67910104,61,58,27,14,7,4,1,0,172
67910105,91,63,24,19,7,1,1,0,206
67910106,110,98,44,32,16,2,0,0,302
67910107,136,121,54,41,12,5,1,1,371
67910108,83,58,29,21,7,4,0,1,203
67910109,96,76,32,15,7,0,0,0,226
67910110,146,102,58,29,6,2,1,0,344
67910111,60,67,47,22,11,1,1,1,210
67910201,50,62,34,19,13,5,1,0,184
67910202,87,83,55,37,23,9,10,0,304
67910203,60,70,54,41,22,15,3,3,268
67910204,69,78,45,40,19,9,5,3,268
67910205,84,80,39,43,16,7,1,0,270
67910206,129,116,55,46,15,8,1,0,370
67910207,79,81,63,38,22,3,4,1,291
67910208,73,106,62,42,17,6,3,0,309
67910209,77,82,44,34,13,2,1,2,255
67910210,101,116,58,41,22,10,3,4,355
67910211,96,106,58,41,16,14,1,1,333
67910212,103,98,40,40,12,4,1,1,299
67910213,100,121,56,47,15,4,2,0,345
67910214,44,79,72,44,22,11,5,2,279
67910215,74,104,53,38,16,7,3,3,298
67910216,75,89,63,24,6,1,1,0,259
67910217,103,85,46,33,22,5,0,0,294
67910218,115,145,79,67,31,10,3,3,453
67910301,70,92,58,45,19,16,6,4,310
67910302,46,59,47,28,19,6,1,0,206
67910303,46,57,53,46,29,7,1,2,241
67910304,89,109,81,79,25,11,1,0,395
67910305,48,61,28,15,8,1,0,0,161
67910306,59,68,33,25,14,3,0,0,202
67910307,85,116,81,61,34,8,2,0,387
67910308,44,83,43,46,20,6,2,0,244
67910309,51,79,72,76,25,23,1,1,328
67910310,71,109,96,75,35,9,9,0,404
67910401,65,66,39,29,17,4,2,3,225
67910402,97,84,30,29,7,7,0,0,254
67910403,88,70,36,18,6,4,1,2,225
67910404,51,68,43,30,17,3,2,1,215
67910405,64,53,16,15,7,3,0,1,159
67910406,78,60,51,25,8,2,0,0,224
67910407,98,57,27,17,7,2,0,1,209
67910408,134,80,36,13,9,1,1,0,274
67910409,69,64,30,16,7,4,1,0,191
67910410,66,65,33,22,9,4,1,0,200
67910411,85,72,35,18,12,1,0,1,224
67910412,62,72,33,14,8,3,0,1,193
67910501,8,9,7,5,3,3,0,0,35
67910502,9,7,5,3,3,0,1,0,28
67910503,6,1,1,0,0,0,0,0,8
67910601,16,17,17,11,6,3,1,0,71
67910602,10,13,6,3,4,1,0,1,38
67910603,5,9,3,4,1,1,0,0,23
67910701,16,11,7,4,13,3,1,0,55
67910702,9,9,7,7,4,2,0,0,38
67910801,5,5,1,3,1,0,0,0,15
67910802,12,6,6,6,4,3,2,0,39
67910803,4,7,3,5,3,1,0,0,23
67910901,7,10,3,7,6,1,1,0,35
67910902,39,12,5,5,2,3,0,0,66
67910903,3,7,8,10,5,0,1,1,35
67910904,3,10,7,2,9,0,0,0,31
67910905,9,5,3,5,4,2,0,2,30
67910906,9,19,7,8,6,2,0,0,51
67911001,6,8,8,8,1,2,1,0,34
67911002,21,21,15,15,7,1,0,4,84
67911003,15,19,19,13,13,4,2,2,87
67911004,6,7,11,7,3,1,0,0,35
67911005,14,13,4,5,4,2,2,0,44
67911006,81,77,60,57,27,11,4,5,322
67911007,30,33,22,26,14,5,4,3,137
67911008,34,25,28,37,10,6,3,4,147
67911009,6,5,6,6,3,3,0,0,29
67911101,11,5,4,6,0,0,0,1,27
67911102,6,7,5,7,3,0,0,1,29
67911103,3,5,10,3,2,0,0,0,23
67911104,14,10,16,10,5,2,2,1,60
67911105,5,8,8,6,5,2,0,0,34
67911201,34,54,42,44,36,15,10,11,246
67911202,51,60,77,77,46,28,8,5,352
67911203,55,97,93,80,64,23,10,11,433
67911204,60,68,52,59,31,16,5,0,291
67911205,42,70,55,45,19,8,3,1,243
67911206,77,96,68,89,39,20,4,7,400
67911207,64,96,63,62,35,12,8,5,345
67911208,98,115,81,74,35,13,4,2,422
67911209,101,95,81,56,29,10,3,1,376
67911210,82,97,65,47,27,9,4,3,334
67911211,47,64,45,42,18,6,1,2,225
67911212,50,60,44,35,21,6,4,3,223
67911213,101,97,89,56,37,9,9,7,405
67911301,79,89,97,107,59,30,22,16,499
67911302,27,59,60,40,41,31,7,5,270
67911303,45,58,62,53,28,16,2,3,267
67911304,49,77,63,57,37,20,8,6,317
67911305,99,94,98,100,50,31,13,13,498
67911306,90,120,125,116,48,15,11,6,531
67911307,31,56,59,39,28,23,6,4,246
67911308,44,64,55,49,27,12,9,4,264
67911309,43,62,57,38,27,11,4,4,246
67911310,29,52,49,69,28,25,5,7,264
67911311,39,54,49,73,34,13,8,9,279
67911312,30,63,54,61,27,16,4,4,259
67911313,48,70,57,75,32,10,6,2,300
67911314,49,82,57,58,28,7,3,3,287
67911401,6,8,4,4,2,3,0,0,27
67911402,21,9,6,7,3,1,0,0,47
67911403,15,19,9,10,2,2,4,2,63
67911404,11,15,3,11,2,2,0,1,45
67911405,42,12,8,9,5,1,0,1,78
67911406,13,5,7,9,4,3,0,0,41
67911501,10,22,10,14,4,1,1,1,63
67911502,57,18,12,15,13,8,2,0,125
67911503,5,7,5,11,1,1,0,2,32
67911504,10,6,13,12,4,0,1,0,46
67911505,4,4,7,2,2,1,0,0,20
67911506,2,4,5,1,1,0,0,1,14
67911601,6,5,10,7,1,0,0,0,29
67911602,20,8,4,8,3,0,0,0,43
67911701,12,5,8,10,4,3,0,0,42
67911702,9,9,6,7,2,1,0,0,34
67911801,60,70,38,30,10,4,2,0,214
67911802,63,73,44,18,12,8,3,0,221
67911803,63,63,28,15,12,4,1,2,188
67911804,72,67,48,39,20,4,2,1,253
67911805,31,65,38,33,17,6,0,2,192
67911806,66,80,48,26,8,6,2,0,236
67911807,71,73,60,48,27,4,1,3,287
67911808,50,71,64,41,24,12,3,1,266
67911809,57,69,47,60,19,7,2,4,265
67911811,28,48,38,47,40,4,4,2,211
67911812,45,47,56,50,23,9,3,1,234
67911813,52,89,61,55,27,15,4,1,304
67911814,49,92,72,65,31,13,1,3,326
67911901,57,76,35,27,18,4,0,1,218
67911902,51,77,43,49,11,3,0,0,234
67911903,85,100,48,38,20,0,2,1,294
67911904,96,97,52,28,18,10,1,1,303
67911905,126,155,66,46,23,7,1,0,424
67911906,68,85,56,31,16,4,1,0,261
67911907,42,61,35,22,13,5,2,0,180
67911908,94,73,33,14,5,4,0,0,223
67911909,90,53,17,10,5,0,0,0,175
67911910,71,68,36,23,1,2,0,1,202
67911911,94,69,44,20,12,2,2,0,243
67912001,63,76,54,54,29,17,4,4,301
67912002,53,81,59,54,41,12,8,5,313
67912003,48,74,102,100,57,38,17,14,450
67912004,44,84,77,79,41,14,8,6,353
67912005,69,77,64,52,32,8,1,3,306
67912006,120,119,62,50,28,5,2,2,388
67912007,71,108,67,50,24,4,0,2,326
67912008,21,39,45,38,21,6,1,0,171
67912009,64,88,64,69,31,15,1,1,333
67912101,22,31,54,44,24,13,8,7,203
67912102,52,75,69,79,49,20,13,4,361
67912103,44,48,59,60,40,13,6,11,281
67912104,32,33,43,57,40,13,7,6,231
67912105,78,106,101,80,44,15,10,2,436
67912106,81,115,83,79,27,15,8,7,415
67912107,57,94,50,45,11,12,2,0,271
67912108,56,68,44,44,11,5,3,1,232
67912109,84,140,98,92,34,27,2,2,479
67912110,21,48,66,100,63,38,14,23,373
67912111,35,45,60,63,42,23,13,7,288
67912112,47,71,70,70,35,30,7,8,338
67912113,36,42,45,35,23,3,2,2,188
67912114,22,18,27,20,13,7,4,2,113
67912115,17,27,19,30,14,7,3,2,119
67912116,36,55,41,46,25,10,4,4,221
67912201,19,35,31,22,13,9,0,2,131
67912202,28,30,29,41,11,8,0,1,148
67912203,25,32,33,51,45,14,6,1,207
67912204,24,37,31,45,27,7,7,3,181
67912205,37,69,67,64,23,20,3,3,286
67912206,35,69,75,104,41,18,7,5,354
67912207,80,111,78,95,50,25,14,9,462
67912208,75,98,84,85,31,16,13,1,403
67912209,57,87,61,48,28,9,1,2,293
67912210,89,105,80,45,28,14,2,2,365
67912211,42,56,62,46,26,8,2,1,243
67912212,36,85,49,46,25,8,1,4,254
67912213,38,59,55,55,28,1,1,3,240
67912214,33,60,54,59,18,5,0,0,229
67912215,59,64,58,53,23,7,1,0,265
67912216,40,68,58,82,35,18,7,3,311
67912217,20,37,26,47,18,9,2,0,159
67912218,18,30,27,27,19,4,5,2,132
67980101,8,3,4,3,1,1,0,0,20
67980102,5,6,2,4,4,0,0,0,21
67980103,8,4,3,2,2,0,0,0,19
67980201,5,1,5,4,6,1,0,0,22
67980202,3,2,0,1,1,0,0,0,7
67980203,10,4,9,3,1,3,0,0,30
67980301,5,2,2,1,3,1,0,0,14
67980302,10,3,3,1,4,0,0,0,21
67980401,3,0,2,1,1,1,0,0,8
67980402,3,7,1,2,2,1,0,0,16
67980501,9,13,9,5,6,4,2,1,49
67980502,5,7,3,7,3,3,0,0,28
67980503,4,1,2,1,0,0,0,0,8
67980504,2,3,1,0,3,0,0,0,9
67980505,16,3,0,2,1,0,0,0,22
67980506,5,4,1,1,3,0,0,0,14
67980507,1,6,3,1,2,0,0,0,13
67980601,29,21,14,8,1,3,1,0,77
67980701,47,37,44,30,22,9,5,4,198
67980702,96,118,72,58,32,13,6,5,400
67980703,89,107,49,46,14,7,3,3,318
67980704,50,60,52,32,15,5,4,2,220
67980705,41,36,35,37,18,3,2,2,174
67980706,11,12,6,3,1,2,0,2,37
67980707,26,38,31,37,30,9,4,3,178
67980708,38,89,95,97,53,28,6,7,413
67980709,45,42,40,24,16,7,5,1,180
67980710,45,54,49,31,12,8,3,0,202
67980711,60,85,34,49,22,3,6,2,261
67980801,5,5,3,1,0,0,0,0,14
67980901,5,4,2,4,2,2,0,0,19
67980902,4,4,2,1,0,1,0,0,12
67980903,2,4,3,2,1,0,0,0,12
67980904,1,9,1,2,2,0,0,0,15
67980905,4,2,2,1,0,0,1,0,10
67981001,6,4,2,6,1,0,0,1,20
67981002,3,9,4,7,0,0,0,1,24
67981003,1,7,6,2,1,0,0,0,17
67981004,5,6,3,4,1,0,1,0,20
67981005,2,2,6,3,2,0,0,0,15
67981006,1,0,2,2,1,0,0,0,6
68120101,1,3,5,7,2,1,1,0,20
68120102,11,7,5,1,1,2,1,0,28
68120201,2,1,1,2,2,0,0,0,8
68120202,3,1,1,1,1,1,0,1,9
68120301,7,4,3,4,2,1,0,0,21
68120302,2,1,3,0,0,1,0,0,7
68120303,0,1,0,1,0,0,0,0,2
68120401,7,4,9,2,3,1,2,2,30
68120402,2,2,1,3,0,1,0,1,10
68120403,1,5,3,0,0,0,0,0,9
68120501,0,2,4,3,1,0,0,0,10
68120502,24,37,45,34,18,11,5,0,174
68120503,52,43,38,41,20,14,4,5,217
68120504,1,0,1,0,1,0,0,0,3
68120601,2,0,1,1,0,0,0,0,4
68120602,4,1,1,0,0,0,0,0,6
68190101,19,16,11,14,5,4,0,2,71
68190102,9,7,6,3,1,1,2,0,29
68190103,10,8,6,4,2,0,0,0,30
68190104,12,17,12,14,4,1,0,0,60
68190201,15,15,10,5,7,4,0,2,58
68190202,11,4,6,6,1,2,1,0,31
68190301,7,5,2,3,1,0,0,0,18
68190302,9,7,5,5,2,0,0,1,29
68190401,73,78,66,62,26,9,4,2,320
68190402,78,96,105,82,45,12,3,7,428
68190403,79,95,48,36,16,6,1,2,283
68190404,81,105,69,52,21,8,0,3,339
68190405,64,86,55,52,24,9,2,1,293
68190406,72,86,55,63,34,8,3,5,326
68190407,47,56,59,47,29,12,6,6,262
68190408,12,15,9,13,5,4,1,0,59
68190409,17,20,14,9,3,1,2,2,68
68190501,4,10,1,2,1,2,0,0,20
68190502,2,3,3,6,5,2,2,1,24
68190503,6,3,7,4,3,0,0,0,23
68190504,28,35,18,16,4,1,0,0,102
68190505,37,53,19,18,8,3,2,0,140
68190601,7,9,5,4,4,1,0,0,30
68190602,13,13,6,8,2,2,0,0,44
68190603,5,4,5,2,3,2,0,0,21
68190701,10,7,4,2,0,1,0,0,24
68190801,1,8,5,3,3,1,0,0,21
68190802,7,9,6,3,4,1,1,1,32
68190901,19,13,10,7,5,3,2,1,60
68190902,14,21,13,13,7,2,0,0,70
68190903,37,62,31,21,15,5,0,1,172
68190904,38,57,41,19,7,3,0,2,167
68190905,51,47,36,22,10,3,0,1,170
68190906,27,38,16,16,6,2,0,1,106
68190907,17,21,16,8,9,3,0,0,74
68190908,6,2,1,1,0,2,0,0,12
68190909,13,14,14,7,3,1,0,0,52
68190910,41,35,38,22,12,5,2,2,157
68190911,37,37,26,24,8,8,2,5,147
68190912,38,43,29,30,16,4,3,3,166
68260101,86,143,119,118,69,54,14,24,627
68260102,42,52,69,55,37,15,7,6,283
68260103,39,58,78,77,40,19,9,6,326
68260104,42,43,34,36,11,6,1,3,176
68260105,41,53,34,28,16,9,2,1,184
68260106,77,78,44,31,13,6,2,1,252
68260107,58,105,61,45,28,10,4,2,313
68260108,61,92,54,53,29,17,8,7,321
68260109,73,60,33,10,9,4,0,0,189
68260110,47,46,23,11,2,1,1,0,131
68260111,52,60,49,20,13,5,1,0,200
68260112,53,62,36,24,17,7,4,1,204
68260113,37,50,54,43,25,9,8,2,228
68260114,63,43,34,31,13,7,2,3,196
68260115,66,87,47,22,20,4,1,1,248
68260116,27,48,36,23,17,5,2,1,159
68260117,27,45,33,34,18,3,2,3,165
68260118,23,35,35,42,38,25,10,6,214
68260119,31,39,45,39,19,16,3,3,195
68260120,60,88,53,35,26,8,4,2,276
68260201,71,83,56,44,13,10,2,2,281
68260202,50,81,105,107,41,16,1,3,404
68260203,21,42,46,57,36,14,9,6,231
68260204,24,43,39,41,27,8,5,2,189
68260205,40,37,31,28,6,7,1,1,151
68260206,46,34,28,27,8,5,1,1,150
68260207,47,45,32,22,5,2,1,0,154
68260208,46,61,23,12,6,2,0,2,152
68260209,65,88,57,33,17,5,3,2,270
68260210,37,57,17,32,9,3,1,2,158
68260211,31,40,39,8,15,5,3,4,145
68260212,110,93,32,38,11,6,1,0,291
68260213,37,36,15,7,4,1,1,0,101
68260214,33,47,12,11,4,2,0,0,109
68260301,2,7,2,3,0,0,0,0,14
68260302,4,1,1,0,0,0,0,0,6
68260303,4,2,1,5,2,0,0,0,14
68260401,7,5,1,4,1,1,0,0,19
68260402,16,11,5,5,4,0,0,1,42
68260403,68,73,64,50,11,10,2,3,281
68260501,23,21,6,16,11,5,6,0,88
68260502,2,4,3,1,1,1,0,0,12
68260503,3,0,4,0,0,1,0,0,8
68260601,4,9,6,6,2,1,0,0,28
68260602,9,8,6,1,1,1,0,0,26
68260701,52,78,84,91,61,18,7,4,395
68260702,31,47,36,41,19,7,1,1,183
68260703,6,12,13,10,3,5,1,0,50
68260704,26,42,21,53,26,7,2,2,179
68260705,6,4,7,4,3,1,0,0,25
68260706,66,84,72,82,49,20,8,2,383
68260707,5,6,5,3,0,0,0,1,20
68260708,5,13,12,11,3,2,2,0,48
68260709,8,16,6,14,6,4,0,1,55
68260801,18,9,11,16,7,4,0,0,65
68260802,2,2,2,4,3,1,0,0,14
68260901,3,4,4,2,5,2,0,0,20
68260902,4,3,5,6,3,2,0,1,24
68261001,9,7,10,9,6,3,2,1,47
68261002,9,12,8,1,1,2,0,0,33
68261101,7,4,6,8,4,2,1,0,32
68261102,4,11,0,4,2,0,0,2,23
68261201,6,3,8,3,2,0,0,1,23
68261301,19,2,2,4,2,4,0,0,33
68261302,5,1,5,8,3,3,0,0,25
68261303,7,10,9,9,5,4,0,2,46
68261401,8,5,0,4,4,1,0,0,22
68261402,4,2,0,1,1,2,0,0,10
68261501,8,8,5,8,5,6,0,0,40
68261502,5,9,4,5,0,1,0,1,25
68261601,12,10,7,10,6,3,0,1,49
68261602,6,13,6,7,6,1,3,0,42
68261603,9,10,9,6,2,1,0,0,37
68261604,10,26,16,20,9,4,4,0,89
68261605,4,15,34,26,13,10,9,2,113
68261606,47,47,45,45,29,12,5,8,238
68261607,47,58,44,25,16,4,1,0,195
68261608,74,97,79,77,36,24,4,3,394
68261609,43,44,34,21,11,4,1,1,159
68261610,49,60,35,41,14,5,2,1,207
68261611,47,41,37,43,16,8,3,1,196
68261701,2,2,3,4,5,1,0,0,17
68261702,8,3,8,0,2,0,0,0,21
68261703,3,3,3,3,0,2,1,0,15
68261704,2,1,0,3,0,0,0,0,6
68261801,15,15,12,7,3,5,1,0,58
68261802,6,4,7,3,4,0,0,0,24
68261803,7,6,7,5,4,0,1,0,30
68261804,3,7,15,6,7,2,2,0,42
68261805,1,2,5,2,3,3,1,0,17
68261901,71,107,52,31,13,7,3,0,284
68261902,75,110,45,50,11,12,3,2,308
68261903,36,63,38,32,17,6,2,0,194
68261904,26,50,48,44,19,2,0,1,190
68261905,23,48,38,39,13,2,1,1,165
68261906,26,35,45,62,31,15,4,2,220
68261907,24,38,35,28,23,17,11,3,179
68261908,34,58,30,40,20,14,5,14,215
68261909,59,71,90,63,35,16,3,2,339
68261910,50,73,58,47,12,11,0,0,251
68261911,48,45,42,38,17,3,1,0,194
68330101,48,77,40,32,14,3,0,1,215
68330102,85,97,76,47,15,3,3,1,327
68330103,72,90,56,36,9,2,0,1,266
68330104,79,109,68,58,30,7,1,2,354
68330105,43,69,55,47,8,3,0,0,225
68330106,69,120,62,54,20,9,1,2,337
68330107,86,141,65,46,21,4,0,1,364
68330108,109,96,47,39,17,6,3,0,317
68330109,79,127,47,40,12,12,2,4,323
68330110,83,134,75,45,29,5,2,0,373
68330111,73,112,57,42,16,9,1,1,311
68330112,104,127,90,69,33,8,5,1,437
68330113,91,129,107,76,25,11,11,0,450
68330114,99,127,83,63,17,5,0,1,395
68330115,24,23,8,10,5,6,0,2,78
68330116,60,65,32,42,5,5,1,0,210
68330201,71,105,51,42,15,6,0,1,291
68330202,84,120,78,62,23,7,4,0,378
68330203,94,124,49,45,19,6,1,1,339
68330204,78,113,51,43,15,5,0,0,305
68330205,95,91,44,26,11,4,0,0,271
68330206,55,66,38,25,10,1,1,0,196
68330207,69,120,65,43,13,0,0,0,310
68330208,134,111,50,23,12,2,1,0,333
68330209,91,77,33,41,19,5,0,0,266
68330210,106,108,50,42,10,3,1,0,320
68330211,103,113,50,50,18,9,0,0,343
68330212,107,102,75,50,31,13,1,2,381
68330213,76,112,66,55,15,21,0,4,349
68330301,0,1,0,0,0,0,0,0,1
68330302,2,2,0,1,1,0,0,0,6
68330303,1,2,0,0,1,0,0,0,4
68330304,0,1,1,2,0,0,0,0,4
68330305,1,1,0,2,0,1,0,0,5
68330401,15,5,6,2,2,0,1,0,31
68330402,6,13,0,2,0,0,1,0,22
68330403,4,5,2,1,5,0,0,0,17
68330501,0,4,2,0,0,0,1,0,7
68330502,0,6,1,2,0,0,0,0,9
68330503,2,0,1,1,0,0,1,0,5
68330601,0,1,1,2,1,0,0,0,5
68330602,2,0,0,1,0,0,0,0,3
68330603,5,2,3,0,1,0,0,0,11
68330604,1,3,3,1,0,0,0,0,8
68330701,5,3,0,0,0,1,0,0,9
68330702,7,3,2,1,0,0,0,0,13
68330703,3,4,4,5,0,1,0,1,18
68330704,4,6,3,3,1,1,0,0,18
68330705,5,4,5,3,3,0,0,1,21
68330706,3,10,3,2,0,1,0,1,20
68330801,5,9,3,2,2,1,1,0,23
68330802,10,12,3,3,3,1,0,0,32
68330803,0,1,5,1,0,0,0,0,7
68330901,2,4,1,1,1,2,0,0,11
68330902,6,4,0,3,0,1,0,0,14
68330903,4,9,9,3,0,1,0,0,26
68331001,9,16,18,16,3,5,1,4,72
68331002,28,42,42,51,34,18,8,6,229
68331003,1,1,0,1,1,0,0,2,6
68331004,86,118,102,75,27,16,0,3,427
68331005,78,105,104,75,40,15,2,1,420
68331006,63,87,73,62,38,18,8,9,358
68331007,91,121,84,63,35,19,2,3,418
68331008,46,81,90,117,75,48,13,18,488
68331009,87,80,76,61,41,19,9,1,374
68331010,38,71,42,40,23,9,0,1,224
68331011,37,85,63,73,31,17,6,2,314
68331012,73,112,123,102,53,35,12,13,523
68331013,11,9,17,5,3,4,0,0,49
68331101,33,55,36,34,25,8,1,0,192
68331102,2,0,0,0,1,0,0,0,3
68331103,4,3,2,0,0,0,0,0,9
68331104,3,4,1,0,0,0,0,0,8
68331105,4,0,0,0,0,0,0,0,4
68331201,4,5,0,2,0,1,0,0,12
68331202,2,2,1,2,2,0,1,0,10
68331203,3,0,1,2,0,0,0,0,6
68331301,1,4,2,0,0,0,0,0,7
68331302,27,42,15,13,6,1,0,2,106
68331303,14,8,11,2,3,2,0,0,40
68331304,7,21,9,8,7,1,1,0,54
68331401,40,55,39,39,22,3,3,3,204
68331402,8,4,9,7,5,0,0,1,34
68331403,3,1,1,0,0,0,0,0,5
68331404,0,3,1,0,1,0,0,0,5
68331405,10,8,3,9,2,1,1,1,35
68331406,0,0,0,0,0,0,0,0,0
68331407,3,2,1,1,0,0,0,0,7
68331408,33,44,26,19,9,5,1,0,137
68331501,19,24,15,7,8,3,0,0,76
68331502,2,4,3,3,2,1,0,0,15
68331503,5,2,0,1,0,3,0,0,11
68331504,1,4,2,3,2,0,0,0,12
68331505,1,3,1,4,0,0,0,0,9
68331506,31,30,28,13,8,6,2,1,119
68331601,3,4,1,6,0,0,0,0,14
68331602,5,1,1,1,1,0,0,0,9
68331603,1,3,1,1,0,0,0,0,6
68331604,1,1,0,0,0,0,0,0,2
68331605,1,6,4,2,5,1,0,0,19
68331701,31,30,29,26,12,8,1,4,141
68331702,39,56,48,39,17,8,4,1,212
68331703,37,59,47,30,4,5,1,2,185
68331704,9,13,6,3,2,0,0,0,33
68331705,18,24,11,14,6,3,3,0,79
68331706,6,4,0,2,0,0,0,0,12
68331707,3,3,1,3,2,1,0,0,13
68331708,3,7,4,2,0,0,0,0,16
68331709,43,58,38,30,10,8,1,0,188
68331801,19,17,12,13,3,2,3,0,69
68331802,36,56,26,19,14,10,2,1,164
68331803,27,37,17,14,6,3,1,0,105
68331804,23,25,9,6,3,2,0,0,68
68331805,34,34,13,9,6,1,0,0,97
68331806,18,19,8,5,2,0,0,0,52
68331807,20,28,12,12,3,2,0,0,77
68331808,2,13,5,4,2,0,0,0,26
68331809,18,33,25,27,19,3,0,2,127
68331810,3,5,2,1,0,0,0,0,11
68331811,16,18,11,8,4,0,1,0,58
68331901,39,53,53,56,38,16,11,6,272
68331902,14,13,14,15,9,4,2,2,73
68331903,66,84,94,73,36,15,5,3,376
68331904,45,64,49,59,23,12,3,1,256
68331905,86,129,96,83,38,10,1,3,446
68331906,36,76,60,72,33,14,10,8,309
68331907,58,64,57,59,34,21,7,6,306
68331908,48,71,69,59,23,16,5,5,296
68331909,31,66,75,66,30,20,9,3,300
68331910,26,59,40,60,28,14,4,7,238
68331911,25,52,56,44,44,25,8,14,268
68331912,42,49,44,41,22,14,7,3,222
68331913,48,81,86,86,37,20,9,6,373
68331914,7,15,25,26,19,11,2,5,110
68331915,6,13,9,7,8,3,3,1,50
68470101,34,48,28,28,13,6,0,1,158
68470102,68,98,77,62,31,11,3,0,350
68470103,51,88,72,63,29,19,7,2,331
68470104,60,102,80,65,45,28,0,1,381
68470105,68,100,42,31,22,5,1,1,270
68470106,5,2,2,4,0,0,0,1,14
68470107,13,15,7,10,1,0,0,2,48
68470108,0,2,0,1,0,0,0,0,3
68470109,2,4,0,3,0,0,1,0,10
68470110,6,4,5,6,1,1,0,0,23
68470111,63,99,70,68,28,13,7,3,351
68470112,35,35,33,37,29,4,4,1,178
68470113,20,67,39,41,19,9,2,1,198
68470114,27,55,79,71,34,18,0,2,286
68470115,18,41,31,34,21,8,6,5,164
68470201,17,13,11,6,6,1,2,0,56
68470202,0,5,1,0,0,1,0,0,7
68470203,1,6,6,4,5,2,0,1,25
68470204,6,10,9,3,1,2,1,0,32
68470205,2,5,0,1,0,0,1,0,9
68540101,25,45,38,43,20,4,1,1,177
68540102,94,91,47,39,19,2,3,0,295
68540103,65,82,67,46,22,14,3,1,300
68540104,63,89,57,33,15,7,1,2,267
68540105,74,82,67,50,22,12,0,2,309
68540106,71,91,48,27,13,6,0,1,257
68540107,101,79,36,29,17,7,1,0,270
68540108,82,98,50,43,14,7,1,2,297
68540109,68,102,79,58,32,20,5,7,371
68540110,117,100,67,64,33,6,3,3,393
68540111,67,116,120,141,87,38,14,13,596
68540112,66,77,67,41,18,11,4,3,287
68540113,47,61,59,74,58,34,8,12,353
68540114,32,46,45,36,27,14,7,3,210
68540115,28,47,34,24,19,9,3,1,165
68540201,76,78,69,74,34,29,11,19,390
68540202,65,89,106,83,54,27,16,15,455
68540203,72,103,62,59,20,8,6,2,332
68540204,88,97,40,38,17,3,1,2,286
68540205,65,84,42,34,16,1,0,0,242
68540206,96,102,50,38,14,8,1,0,309
68540207,93,81,66,53,35,9,4,7,348
68540208,73,98,45,46,7,9,2,1,281
68540209,79,100,96,62,44,24,7,10,422
68540210,38,42,36,40,24,9,6,1,196
68540211,59,75,46,41,24,8,3,5,261
68540301,24,22,14,14,9,5,2,1,91
68540302,9,7,7,3,2,0,0,0,28
68540303,11,7,3,4,4,1,0,0,30
68540401,40,52,38,33,13,7,4,1,188
68540402,16,27,20,14,3,8,2,1,91
68540403,18,24,15,14,6,2,1,1,81
68540501,17,10,7,6,2,0,1,0,43
68540502,15,9,13,10,5,2,0,0,54
68540503,3,5,3,4,2,1,0,0,18
68540601,18,16,9,11,7,1,1,1,64
68540602,37,50,27,23,9,5,0,1,152
68540701,2,7,4,5,8,0,0,0,26
68540702,5,4,9,9,1,3,0,0,31
68540801,17,29,21,18,11,1,5,0,102
68540802,18,26,13,9,5,6,1,1,79
68540803,10,10,7,2,1,0,1,0,31
68540901,8,13,8,10,3,4,1,0,47
68541001,31,38,38,35,13,13,2,2,172
68541002,70,77,40,30,18,10,3,0,248
68541003,71,88,60,48,12,6,0,2,287
68541004,75,79,68,51,24,9,6,3,315
68541005,82,75,52,34,20,4,2,1,270
68541006,73,62,64,50,35,19,7,11,321
68541007,22,23,21,17,14,3,1,0,101
68541008,33,26,21,19,6,4,3,0,112
68541009,11,28,16,5,2,0,0,0,62
68541010,2,25,11,8,4,1,0,1,52
68541011,8,18,8,6,2,1,3,0,46
68541012,6,6,6,11,4,2,1,0,36
68541013,25,15,20,13,4,4,0,2,83
68541014,43,47,29,39,12,9,0,0,179
68541015,35,30,18,21,10,8,2,0,124
68541101,6,8,6,6,2,0,3,0,31
68541102,5,9,4,5,3,0,0,0,26
68541103,6,3,6,3,2,1,2,0,23
68541201,11,11,12,11,3,4,1,1,54
68541202,4,5,3,4,1,2,1,0,20
68541203,10,3,6,5,2,3,0,0,29
68541301,12,14,7,10,2,4,2,0,51
68541302,8,17,6,5,1,0,1,0,38
68541401,39,49,29,19,12,4,3,0,155
68541402,18,27,21,21,8,2,0,1,98
68541403,16,21,12,6,5,1,1,0,62
68541404,1,6,2,1,3,0,1,0,14
68541405,6,9,5,4,3,1,0,1,29
68541406,29,40,26,24,17,8,4,5,153
68680101,71,81,92,108,56,49,10,22,489
68680102,29,29,59,55,31,14,8,8,233
68680103,28,36,55,43,27,16,1,6,212
68680104,57,60,37,32,13,3,1,1,204
68680105,26,27,21,18,6,3,1,0,102
68680106,22,22,10,10,6,3,1,0,74
68680107,13,21,10,15,4,0,0,0,63
68680108,46,65,38,38,10,4,3,1,205
68680109,43,79,45,52,33,16,6,10,284
68680110,61,54,57,43,37,8,9,9,278
68680201,46,47,34,29,14,6,1,3,180
68680202,18,13,11,8,0,0,0,0,50
68680203,25,21,12,11,4,3,2,0,78
68680204,48,42,34,28,15,4,4,4,179
68680205,87,114,71,53,30,9,1,2,367
68680206,39,62,53,28,17,5,5,2,211
68680207,27,27,10,8,1,0,0,1,74
68680208,2,3,3,1,0,0,0,0,9
68680209,12,8,4,2,0,0,0,0,26
68680210,28,23,15,5,0,0,0,0,71
68680211,10,9,11,3,1,0,0,0,34
68680212,18,27,16,14,5,4,1,2,87
68680213,73,82,103,92,60,28,10,12,460
68680301,48,75,79,78,57,37,14,23,411
68680302,58,63,73,58,31,14,7,6,310
68680303,42,58,36,29,15,10,3,3,196
68680304,30,56,36,28,17,6,5,4,182
68680305,27,29,26,16,6,4,1,3,112
68680306,49,56,38,36,16,6,1,2,204
68680307,35,54,34,24,16,2,1,2,168
68680308,13,14,7,3,3,1,1,2,44
68680309,16,12,5,2,1,0,0,0,36
68680310,12,15,9,4,3,1,0,0,44
68680311,9,12,4,7,1,0,0,0,33
68680312,16,11,6,4,1,0,0,0,38
68680313,16,12,6,2,1,0,0,0,37
68680401,7,9,5,5,1,1,0,0,28
68680402,9,5,6,2,1,0,1,0,24
68680403,3,7,5,3,1,0,0,0,19
68680404,1,2,1,0,0,0,1,0,5
68680405,5,8,5,9,4,0,1,0,32
68680406,3,3,0,2,1,0,0,0,9
68680407,11,18,10,11,2,1,2,1,56
68680408,19,18,13,15,10,5,1,0,81
68680409,7,11,4,4,1,2,0,0,29
68680410,9,8,3,6,1,2,0,0,29
68680501,9,2,1,2,0,0,0,0,14
68680502,33,64,74,79,53,20,15,14,352
68680503,38,59,68,72,51,49,19,17,373
68680504,42,56,34,34,11,6,7,4,194
68680505,16,27,14,9,0,1,1,0,68
68680506,17,23,18,6,3,0,1,0,68
68680507,34,28,16,14,1,1,0,0,94
68680508,29,39,27,28,14,7,1,4,149
68680509,25,37,21,21,7,4,1,3,119
68680510,20,20,16,10,4,0,0,1,71
68680511,2,0,0,0,0,0,0,0,2
68680601,9,9,5,6,2,0,0,0,31
68680602,9,14,9,4,1,0,0,0,37
68680603,21,28,15,9,2,0,0,0,75
68680604,36,33,10,8,2,1,0,0,90
68680605,12,8,7,5,2,0,0,0,34
68680606,5,10,2,1,1,0,0,0,19
68680607,11,16,9,3,0,0,0,0,39
68680608,14,6,4,5,0,0,0,0,29
68680609,27,28,13,1,4,1,2,0,76
68680610,11,8,0,3,2,0,0,0,24
68680701,49,56,67,51,38,16,5,2,284
68680702,39,81,48,45,24,7,1,0,245
68680703,28,27,36,17,5,7,0,1,121
68680704,15,31,20,12,6,3,1,2,90
68680705,21,22,11,11,2,2,0,1,70
68680706,15,37,29,13,10,1,2,0,107
68680707,6,17,3,3,3,0,0,0,32
68680708,23,11,7,2,3,0,0,1,47
68680709,8,12,1,2,3,0,0,0,26
68680710,6,11,3,1,0,0,0,0,21
68680711,8,20,10,8,2,0,0,0,48
68680712,10,13,10,3,1,5,2,3,47
68680801,45,78,61,61,30,16,8,6,305
68680802,37,50,63,52,31,9,8,2,252
68680803,20,15,33,24,16,8,2,1,119
68680804,49,50,31,23,13,9,2,0,177
68680805,7,12,2,2,1,0,0,0,24
68680806,7,16,6,4,3,0,0,2,38
68680807,4,7,6,8,0,0,0,0,25
68680808,11,9,4,0,1,0,0,0,25
68680809,33,52,25,27,18,9,4,3,171
68680810,10,16,8,6,4,1,0,0,45
68750101,4,3,1,3,0,0,0,0,11
68750201,29,22,8,5,5,2,0,0,71
68750301,17,20,9,3,8,0,0,1,58
68750401,12,16,9,7,6,2,1,0,53
68750402,10,11,4,8,1,3,0,1,38
68750403,13,16,11,7,2,1,0,0,50
68750501,4,2,1,1,2,1,0,0,11
68750502,14,15,5,9,2,2,0,0,47
68750601,51,59,56,46,34,7,2,3,258
68750602,37,43,39,41,20,8,1,0,189
68750603,23,33,21,23,9,3,0,2,114
68750604,89,120,81,64,40,15,6,2,417
68750605,34,58,45,60,35,21,8,9,270
68750606,13,24,19,17,12,4,6,3,98
68750607,7,8,5,2,0,1,1,0,24
68750608,76,79,67,52,22,11,9,7,323
68750609,50,52,38,23,10,1,1,1,176
68750701,14,11,11,6,0,0,0,0,42
68750801,23,22,6,9,3,2,1,0,66
68750802,40,37,38,30,9,3,1,1,159
68750803,31,42,26,26,8,3,1,1,138
68750804,27,40,41,33,18,4,1,3,167
68750805,28,28,32,19,20,7,2,1,137
68750901,19,25,12,14,5,3,0,0,78
68750902,19,13,11,3,2,0,0,0,48
68751001,11,8,4,3,0,0,0,1,27
68751101,5,2,2,1,1,1,0,0,12
68751201,27,26,27,21,14,5,0,0,120
68751301,12,2,3,1,0,0,0,0,18
68751302,22,21,11,12,2,2,0,0,70
68751401,18,14,10,7,1,3,0,0,53
68751402,13,19,5,4,3,2,0,0,46
68751501,61,72,46,43,14,5,0,2,243
68751502,32,36,17,28,7,5,0,0,125
68751503,17,19,29,24,13,6,4,0,112
68751504,17,36,20,32,14,14,13,17,163
68751505,21,5,7,4,2,2,0,0,41
68751506,53,54,71,75,53,29,17,14,366
68751507,57,59,58,46,34,24,10,15,303
68751508,69,64,63,48,22,17,3,5,291
68751509,35,48,40,33,18,6,1,6,187
68751601,19,37,25,28,17,6,4,2,138
68751602,95,91,101,70,48,16,8,8,437
68751603,71,76,109,123,75,32,15,24,525
68751604,40,48,53,52,38,22,8,11,272
68751605,87,102,74,64,31,17,7,5,387
68751606,37,62,53,72,45,12,7,9,297
68751607,48,60,41,40,26,15,2,1,233
68751608,59,69,51,48,17,8,2,1,255
68751609,40,67,34,35,12,8,1,0,197
68751610,66,65,89,80,43,24,7,12,386
68751611,42,61,35,34,15,4,1,3,195
68751612,35,32,46,49,21,14,4,6,207
68751613,33,51,64,55,40,24,4,8,279
68751614,42,53,72,61,35,17,7,7,294
68751615,50,55,73,67,61,45,16,24,391
68751701,47,27,27,27,16,6,2,1,153
68751801,9,7,2,3,2,0,0,1,24
68820101,81,69,90,63,36,11,7,3,360
68820102,70,89,97,77,34,17,6,6,396
68820103,82,101,81,77,36,14,5,7,403
68820104,81,94,84,79,35,33,8,9,423
68820105,59,86,109,113,64,43,14,8,496
68820106,41,83,76,79,28,18,0,8,333
68820107,63,96,81,57,34,15,2,2,350
68820108,62,102,59,61,35,9,3,2,333
68820109,66,75,64,54,18,8,1,1,287
68820110,48,111,67,67,30,9,3,4,339
68820201,96,117,82,64,32,15,1,3,410
68820202,50,76,61,47,20,11,3,7,275
68820203,81,68,38,22,13,3,1,0,226
68820204,92,73,48,23,10,7,1,0,254
68820205,105,86,51,36,21,10,2,3,314
68820206,74,74,62,34,9,4,1,0,258
68820207,59,102,61,52,24,11,2,1,312
68820208,74,115,78,51,22,8,3,2,353
68820209,58,84,61,61,31,6,4,3,308
68820210,41,68,60,61,36,9,2,2,279
68820211,59,89,120,76,31,10,5,1,391
68820212,31,30,45,54,30,29,11,21,251
68820213,48,90,77,67,23,12,1,3,321
68820214,35,39,38,37,30,18,6,12,215
68820301,7,19,10,9,4,6,1,3,59
68820302,60,98,49,64,31,13,3,4,322
68820303,60,88,89,67,38,18,6,10,376
68820304,67,105,79,72,39,12,5,6,385
68820305,68,79,60,47,30,5,3,2,294
68820306,69,85,80,56,32,12,3,5,342
68820307,48,69,63,55,29,12,3,4,283
68820308,69,118,77,65,39,12,3,5,388
68820401,55,77,83,74,34,27,7,11,368
68820402,4,6,8,5,3,0,2,0,28
68820403,10,17,16,12,7,3,0,0,65
68820501,20,23,20,24,15,9,4,2,117
68820502,74,91,91,78,60,29,18,19,460
68820503,78,93,91,83,58,31,7,15,456
68820504,58,73,83,98,67,44,16,20,459
68820505,13,5,8,12,9,1,0,0,48
68820506,2,6,10,14,9,3,1,1,46
68820507,32,27,41,28,24,7,4,3,166
68820508,38,51,77,71,56,36,10,13,352
68820509,56,97,87,91,66,23,6,10,436
68820601,14,18,6,8,6,1,0,1,54
68820701,13,12,4,12,8,8,0,2,59
68820702,33,24,28,25,22,9,3,4,148
68820703,25,40,43,32,25,29,5,14,213
68820801,64,82,73,83,67,35,17,19,440
68820802,55,69,80,77,50,43,9,14,397
68820803,73,78,91,84,41,13,9,8,397
68820804,68,72,77,52,37,20,9,12,347
68820805,53,91,72,61,25,14,3,3,322
68820806,61,87,82,71,25,9,0,1,336
68820807,61,86,71,65,14,5,2,1,305
68820808,71,86,61,59,26,3,0,1,307
68820809,78,97,55,41,13,8,1,0,293
68820810,65,89,57,34,26,7,1,0,279
68820811,54,84,45,30,12,5,2,2,234
68820812,129,89,51,28,14,3,1,0,315
68820813,47,51,86,98,73,43,13,22,433
68820901,36,97,68,100,83,48,16,17,465
68820902,32,51,71,70,55,25,8,20,332
68820903,37,69,90,80,46,31,8,7,368
68820904,33,49,79,96,57,37,6,21,378
68820905,26,43,56,46,40,24,6,5,246
68820906,39,70,78,100,85,45,15,30,462
68820907,54,87,95,111,68,48,10,14,487
68820908,34,66,81,74,39,17,3,6,320
68820909,43,62,57,60,28,10,7,8,275
68820910,47,87,104,81,37,21,7,11,395
68820911,24,41,68,58,34,15,6,5,251
68820912,29,52,59,80,65,48,18,20,371
68820913,30,35,58,58,46,42,10,20,299
68820914,38,51,59,73,38,22,12,12,305
68821001,24,65,74,63,34,13,2,2,277
68821002,31,64,61,44,22,7,1,0,230
68821003,41,71,67,66,29,16,6,7,303
68821004,34,66,55,49,24,13,3,6,250
68821005,46,67,54,51,18,12,3,3,254
68821006,70,114,82,89,41,18,11,7,432
68821007,46,49,55,52,29,9,1,0,241
68821008,27,75,47,59,29,21,3,11,272
68821009,60,90,87,90,50,36,6,10,429
68821010,55,70,132,114,77,50,23,34,555
68821011,50,49,92,78,79,56,20,22,446
68821101,53,57,41,37,22,11,4,7,232
68821201,37,22,29,18,9,8,5,6,134
68821301,68,16,32,23,14,19,2,4,178
68821401,32,33,22,29,23,13,3,5,160
68821501,10,8,10,6,3,2,0,0,39
68821601,54,98,76,61,40,13,1,3,346
68821602,68,87,92,87,39,17,4,4,398
68821603,88,123,88,85,37,16,1,3,441
68821604,48,89,82,62,41,22,10,8,362
68821605,48,68,88,99,74,46,19,23,465
68821606,31,57,55,49,33,19,4,6,254
68821607,37,44,68,67,39,30,14,12,311
68821608,29,68,85,83,55,45,11,15,391
68821701,29,72,77,82,50,25,8,10,353
68821702,23,54,64,73,43,24,10,11,302
68821703,47,63,112,106,56,16,10,11,421
68821704,40,67,88,98,73,72,20,27,485
68821705,46,87,85,115,72,54,25,34,518
68821706,27,25,26,27,19,12,5,5,146
68821707,21,45,36,45,24,1,1,0,173
68821708,39,46,37,45,13,8,0,5,193
68821709,19,18,17,17,9,6,1,5,92
68821710,45,51,65,88,48,31,7,24,359
68821711,45,44,47,58,53,26,14,13,300
68821801,19,11,9,9,2,4,2,0,56
68821802,9,2,3,1,1,1,0,1,18
68821803,14,2,4,2,2,1,0,2,27
100070101,5,2,3,2,2,1,0,0,15
100070102,10,5,8,12,9,2,2,3,51
100070103,6,3,8,2,4,2,1,0,26
100070104,23,22,11,17,9,4,2,4,92
100070105,24,27,17,16,17,10,5,4,120
100070201,29,24,29,29,16,14,9,10,160
100070202,12,14,18,14,11,6,5,3,83
100070203,13,4,3,4,2,5,1,2,34
100070204,21,15,20,18,4,4,1,6,89
100070301,22,17,14,20,15,13,2,10,113
100070302,5,6,11,6,2,4,0,2,36
100070401,7,5,5,1,0,1,2,2,23
100070402,8,6,4,6,4,2,1,0,31
100070403,1,0,1,0,0,0,0,1,3
100070404,31,27,18,18,5,5,2,0,106
100070405,7,1,2,0,1,1,0,1,13
100070406,21,7,15,11,17,7,3,3,84
100070407,16,19,8,12,15,7,4,2,83
100070408,27,23,9,8,3,5,3,4,82
100070409,15,9,8,7,4,1,4,2,50
100140101,14,22,19,14,13,7,4,4,97
100140102,8,2,2,3,5,0,2,1,23
100140103,6,4,6,1,1,2,0,4,24
100140104,2,2,5,3,2,1,3,1,19
100140201,7,25,15,18,13,5,3,6,92
100140202,8,8,3,3,4,2,2,2,32
100140301,4,5,5,8,5,2,3,2,34
100140302,3,2,2,1,1,0,0,1,10
100140303,2,1,3,0,2,0,0,1,9
100140401,8,5,3,2,6,1,1,1,27
100140402,6,5,7,5,2,0,1,1,27
100140501,4,4,7,3,3,2,0,1,24
100140502,9,7,7,6,3,6,0,1,39
100140503,11,10,9,8,3,2,1,2,46
100140601,3,3,7,5,2,3,2,4,29
100140602,3,5,3,2,5,2,2,3,25
100140701,11,6,8,10,10,5,4,5,59
100140702,5,4,5,1,2,1,0,1,19
100140801,6,5,8,7,4,1,0,1,32
100140802,7,4,8,5,0,1,3,3,31
100140803,6,7,6,1,3,1,2,3,29
100140901,6,8,4,4,4,0,2,1,29
100140902,6,4,2,5,3,4,1,5,30
100210101,11,16,16,16,16,8,7,5,95
100210102,2,1,0,0,0,0,0,1,4
100210103,40,67,87,88,65,37,24,28,436
100210104,39,66,58,66,38,26,12,16,321
100210105,55,69,58,63,40,13,9,6,313
100210106,46,65,48,45,35,16,5,8,268
100210107,42,44,66,61,34,39,16,28,330
100210108,65,52,41,34,24,23,7,7,253
100210109,32,52,49,39,34,17,3,15,241
100210110,43,71,71,62,39,20,4,7,317
100210111,34,54,60,52,59,31,10,25,325
100210112,39,36,54,36,24,18,13,16,236
100210113,13,27,34,41,41,26,13,22,217
100210114,3,7,19,24,16,11,4,6,90
100210201,2,1,2,1,0,0,0,0,6
100210202,37,41,50,49,36,22,14,24,273
100210301,19,14,9,9,8,4,2,6,71
100210401,22,19,11,18,12,5,3,13,103
100210501,14,5,1,2,1,0,0,4,27
100210601,6,3,5,2,0,0,0,0,16
100210701,10,11,8,8,3,0,5,3,48
100210801,8,8,5,6,4,8,5,7,51
100210901,11,1,3,0,3,1,4,2,25
100210902,15,12,6,5,7,3,0,5,53
100211001,28,11,21,30,18,17,8,20,153
100211002,13,11,17,7,5,6,4,10,73
100211003,14,19,10,13,11,6,7,10,90
100211004,18,12,11,18,10,8,3,11,91
100211005,16,12,11,15,19,11,4,11,99
100211006,13,10,14,11,8,6,3,7,72
100280101,17,11,6,11,12,9,4,5,75
100280201,26,9,3,2,2,1,1,5,49
100280202,56,24,29,36,14,21,11,8,199
100280301,7,4,1,0,4,2,0,0,18
100280302,7,7,5,0,2,2,1,0,24
100350101,32,40,38,51,43,26,20,25,275
100350102,4,0,5,2,3,3,0,3,20
100350103,39,58,52,45,28,33,10,16,281
100350104,23,34,48,47,22,23,4,2,203
100350105,65,74,70,50,54,24,6,14,357
100350106,70,64,67,59,26,15,6,7,314
100350107,45,30,40,39,24,8,6,4,196
100350108,29,55,53,42,46,26,7,7,265
100350109,29,43,46,52,19,13,5,11,218
100350110,38,38,59,48,30,14,8,5,240
100350111,35,42,34,29,30,13,9,12,204
100350112,24,39,63,85,51,40,14,13,329
100350113,43,43,55,53,40,22,10,10,276
100350114,8,22,33,53,32,29,10,14,201
100350115,27,29,46,48,44,24,7,17,242
100350201,16,12,12,12,7,13,2,8,82
100350202,10,5,2,2,4,2,1,3,29
100350203,6,2,4,2,5,2,2,4,27
100350204,45,52,54,54,48,17,11,22,303
100350205,31,33,29,29,29,7,7,12,177
100350206,29,34,33,26,23,5,12,11,173
100350301,19,9,7,11,10,6,7,4,73
100350302,7,5,8,3,0,2,2,7,34
100350303,18,14,8,12,7,4,4,8,75
100350304,8,11,10,10,6,4,4,2,55
100350305,13,7,21,10,5,6,3,5,70
100350306,29,19,17,22,20,20,10,23,160
100350307,24,13,14,8,5,8,3,7,82
100350401,19,18,17,19,15,7,5,10,110
100350402,10,0,8,8,2,5,3,7,43
100350501,21,23,14,14,16,11,6,12,117
100350502,21,23,20,24,19,19,7,10,143
100350503,37,17,29,25,28,23,17,14,190
100350504,4,1,2,2,1,0,0,3,13
100350505,13,3,5,4,1,5,5,7,43
100350506,7,6,8,9,7,9,3,9,58
100350507,1,2,0,2,0,0,2,6,13
100350508,45,41,37,42,44,20,21,34,284
100350601,12,12,9,10,6,4,5,5,63
100350602,13,5,11,5,1,6,5,3,49
100350603,7,12,5,13,12,5,2,2,58
100350604,13,11,9,7,3,6,5,5,59
100350605,19,15,17,16,11,11,8,11,108
100350606,26,28,17,18,17,14,10,8,138
100350607,8,5,11,23,14,12,17,29,119
100350608,34,37,53,43,27,24,14,16,248
100420101,8,3,5,1,3,3,2,0,25
100420102,9,7,8,12,5,9,3,5,58
100420103,17,27,26,31,30,18,13,16,178
100420104,7,17,51,41,36,21,9,11,193
100420105,24,30,45,36,36,23,16,18,228
100420106,30,37,52,36,34,23,14,28,254
100420107,26,48,33,54,27,18,12,15,233
100420201,9,8,9,10,5,1,1,1,44
100420202,18,30,34,28,18,16,15,6,165
100420203,5,3,3,2,0,1,1,1,16
100420204,43,12,12,4,6,4,1,3,85
100420205,4,10,12,15,14,12,6,5,78
100420206,23,32,45,37,17,22,17,24,217
100420207,45,40,59,79,51,40,18,26,358
100420301,29,26,38,20,20,17,13,9,172
100420302,27,26,32,29,33,28,9,10,194
100420303,49,62,54,62,45,25,9,17,323
100420304,15,6,7,7,5,4,3,4,51
100420305,27,39,31,33,42,16,12,25,225
100420306,20,31,64,59,36,20,10,14,254
100420307,7,5,7,6,3,0,0,0,28
100420401,16,16,19,14,15,11,5,4,100
100420402,21,19,21,14,15,7,4,9,110
100420501,3,3,4,3,1,2,2,3,21
100420502,15,15,16,17,7,10,2,3,85
100420601,3,2,1,3,2,0,1,0,12
100420602,18,23,19,17,18,9,5,9,118
100420603,7,6,10,2,7,1,2,4,39
100420604,13,5,6,12,9,7,6,5,63
100490101,11,8,23,16,6,1,0,0,65
100490102,40,60,89,93,70,53,27,30,462
100490103,25,37,55,59,45,40,17,20,298
100490104,9,20,38,47,36,15,2,5,172
100490105,24,47,72,91,44,31,10,9,328
100490106,11,33,58,70,43,37,10,12,274
100490107,10,27,39,57,51,22,9,7,222
100490108,10,22,36,46,48,35,18,28,243
100490109,11,27,40,43,28,24,10,14,197
100490110,30,64,83,77,63,45,19,16,397
100490111,53,57,122,106,60,31,18,15,462
100490112,24,44,93,109,58,42,12,11,393
100490113,36,57,68,82,71,58,22,48,442
100490114,35,27,53,73,54,54,34,40,370
100490115,22,48,77,63,40,32,9,8,299
100490201,33,39,55,54,45,30,10,16,282
100490202,23,40,53,59,36,33,9,9,262
100490203,28,38,64,78,47,28,8,13,304
100490204,51,58,48,52,29,13,7,15,273
100490205,33,57,54,54,36,23,9,3,269
100490206,22,49,44,49,19,9,5,1,198
100490207,59,78,113,68,46,12,6,2,384
100490208,66,103,70,54,40,23,4,11,371
100490209,45,80,62,58,19,17,4,7,292
100490210,23,52,58,50,29,14,2,1,229
100490211,15,38,36,50,31,8,5,4,187
100490212,14,36,38,40,35,24,8,15,210
100490213,16,30,36,47,34,9,6,5,183
100490214,22,46,44,49,31,16,9,2,219
100490215,31,36,58,40,17,12,6,3,203
100490216,70,116,73,71,32,18,7,4,391
100490217,69,74,54,50,23,13,3,4,290
100490218,34,45,47,47,20,19,2,10,224
100490219,37,68,73,64,33,19,5,3,302
100490220,14,20,32,55,16,6,2,2,147
100490221,25,38,35,40,28,9,4,3,182
100490301,23,49,87,83,46,33,18,17,356
100490302,17,43,45,52,36,37,21,14,265
100490303,21,42,72,68,46,28,14,15,306
100490304,31,35,66,62,36,23,13,11,277
100490305,21,28,38,58,41,29,18,25,258
100490306,28,41,46,34,43,33,12,18,255
100490307,11,31,43,26,49,26,14,27,227
100490308,32,43,38,57,49,41,20,37,317
100490309,44,62,71,97,61,34,23,33,425
100490310,41,34,42,31,23,22,7,9,209
100490311,73,98,95,48,30,26,5,10,385
100490312,55,53,56,48,21,10,2,7,252
100490313,40,49,44,26,18,15,6,6,204
100490314,44,58,55,35,23,23,15,13,266
100490315,59,71,51,39,26,13,4,11,274
100490316,34,54,34,34,14,11,1,5,187
100490317,84,109,83,51,23,15,4,5,374
100490318,51,62,36,20,16,10,1,1,197
100490319,63,80,65,34,17,18,8,7,292
100490320,64,89,69,39,27,21,5,6,320
100490321,50,54,32,24,10,4,0,1,175
100490322,50,34,25,18,5,3,1,0,136
100490323,67,42,31,21,8,3,3,1,176
100490324,41,58,45,40,30,10,4,4,232
100490401,23,52,40,40,30,16,7,8,216
100490402,26,30,46,50,22,19,6,5,204
100490403,30,48,58,46,39,13,5,3,242
100490404,25,39,53,62,68,48,24,36,355
100490405,22,34,46,67,45,32,23,33,302
100490406,37,32,64,49,48,49,16,29,324
100490407,33,48,59,66,62,43,24,43,378
100490408,29,31,47,46,33,25,10,14,235
100490409,33,71,96,91,45,24,11,13,384
100490410,30,52,56,64,37,17,9,9,274
100490411,31,59,63,58,29,30,10,9,289
100490412,32,53,52,51,40,14,12,7,261
100490413,26,45,58,54,32,20,5,5,245
100490414,25,29,50,65,39,22,7,9,246
100490415,32,44,48,56,42,30,15,19,286
100490416,52,70,76,74,48,30,7,15,372
100490417,18,37,39,33,36,27,13,13,216
100490418,42,50,53,64,41,23,6,10,289
100490419,46,78,59,63,33,21,12,17,329
100490501,72,74,43,27,16,5,4,3,244
100490502,61,52,29,34,17,12,1,1,207
100490503,35,50,27,35,26,14,6,16,209
100490504,30,44,48,38,22,10,9,7,208
100490505,29,44,43,46,39,26,19,16,262
100490506,23,43,35,36,36,18,13,8,212
100490507,38,34,38,42,23,16,10,10,211
100490508,63,86,51,47,29,12,3,5,296
100490509,72,57,46,26,17,8,4,6,236
100490510,57,54,61,59,47,33,13,20,344
100490511,37,57,32,38,14,22,3,14,217
100490512,43,50,76,74,57,41,21,36,398
100490513,51,55,72,75,73,61,23,29,439
100490514,31,36,40,34,20,6,2,7,176
100490515,52,58,73,66,54,50,29,40,422
100490516,54,52,62,77,60,56,13,29,403
100490517,22,16,30,30,21,18,12,18,167
100490601,60,81,59,52,21,12,3,5,293
100490602,53,58,43,23,12,10,4,1,204
100490603,64,54,44,22,14,4,5,4,211
100490604,40,56,41,20,15,4,1,0,177
100490605,51,58,38,32,17,6,2,3,207
100490606,58,71,55,37,21,10,5,7,264
100490607,56,60,62,49,37,36,9,12,321
100490608,25,42,31,21,16,9,7,2,153
100490609,54,55,47,55,33,22,8,10,284
100490610,39,61,45,36,25,21,6,6,239
100490611,33,49,71,48,46,28,16,14,305
100490612,29,27,45,53,30,15,8,21,228
100490613,44,81,70,62,50,37,11,12,367
100490614,37,57,32,43,32,17,7,5,230
100490615,39,53,76,79,49,35,14,24,369
100490616,28,50,50,46,38,32,16,29,289
100490617,25,21,31,35,28,27,6,19,192
100490618,30,42,65,56,34,36,12,17,292
100490619,15,46,59,33,37,16,5,14,225
100490701,26,57,55,76,38,23,4,11,290
100490702,24,31,39,49,34,15,7,5,204
100490703,31,43,63,50,41,10,8,5,251
100490704,38,58,41,33,26,20,14,11,241
100490705,27,32,45,34,25,15,6,3,187
100490706,47,65,72,63,54,30,13,34,378
100490707,60,72,91,74,54,47,14,25,437
100490708,29,47,54,54,36,34,10,13,277
100490709,29,47,49,55,38,32,10,19,279
100490710,37,40,50,55,33,33,17,22,287
100490711,26,53,61,66,48,34,10,13,311
100490712,30,61,66,97,61,53,15,4,387
100490801,6,26,32,25,34,24,11,10,168
100490802,17,42,60,39,37,34,9,22,260
100490803,30,59,53,76,43,40,15,31,347
100490804,14,45,45,47,32,14,19,17,233
100490805,32,50,52,48,34,39,13,20,288
100490806,19,40,49,39,17,29,9,17,219
100490807,42,34,52,57,39,31,13,16,284
100490808,39,50,73,73,49,71,24,41,420
100490809,22,29,46,58,44,30,9,11,249
100490810,32,47,74,75,51,32,14,25,350
100490811,18,32,55,41,46,34,17,25,268
100490812,16,18,30,38,33,16,16,24,191
100490813,30,48,89,103,81,48,24,15,438
100490901,21,20,15,18,9,5,1,2,91
100490902,16,17,25,18,18,6,8,6,114
100490903,10,36,53,63,35,24,5,4,230
100490904,6,29,35,65,58,34,20,9,256
100490905,15,13,23,24,33,29,5,6,148
100490906,24,62,76,80,75,63,20,23,423
100490907,29,33,42,60,51,38,13,16,282
100490908,21,27,32,46,35,32,14,28,235
100490909,28,37,61,68,47,29,23,32,325
100490910,33,39,44,57,32,25,14,9,253
100490911,22,37,40,45,28,22,10,15,219
100490912,15,35,65,77,48,35,16,12,303
100490913,9,37,52,55,52,41,18,5,269
100490914,23,49,58,79,44,35,11,7,306
100560101,1,4,1,3,1,0,0,0,10
100560102,17,28,30,13,14,6,4,3,115
100560103,12,9,2,8,4,2,1,0,38
100560104,0,4,4,1,1,1,0,0,11
100560201,4,5,5,3,1,2,1,0,21
100560202,6,4,1,2,1,1,3,0,18
100560203,7,3,4,2,2,6,0,0,24
100560204,3,3,0,2,0,1,2,0,11
100560205,37,36,49,37,25,11,8,9,212
100560301,6,5,5,2,2,0,0,0,20
100560302,16,7,9,10,2,3,2,4,53
100560303,17,12,2,5,2,6,1,1,46
100560304,10,6,5,5,2,1,0,2,31
100560401,12,8,7,4,2,2,2,2,39
100560402,2,3,2,2,3,2,0,1,15
100560403,7,8,7,5,7,4,0,3,41
100560501,2,1,2,4,1,3,0,1,14
100560502,21,15,7,16,14,10,3,6,92
100560503,13,11,12,11,8,10,4,5,74
100560504,13,7,8,7,7,7,3,4,56
100560601,11,6,5,2,2,5,2,2,35
100560602,4,1,0,0,1,0,0,0,6
100560603,6,5,2,1,5,2,1,0,22
100560701,10,3,10,4,5,3,0,3,38
100630101,17,28,30,33,36,20,11,10,185
100630102,11,11,9,13,3,8,3,6,64
100630103,19,12,13,7,10,6,1,5,73
100630201,12,22,12,18,13,11,3,7,98
100630202,15,19,32,55,35,26,9,12,203
100630203,22,32,31,28,19,17,9,5,163
100630204,32,36,35,58,26,22,8,11,228
100630205,17,32,43,57,53,37,15,13,267
100630206,10,21,31,47,39,15,12,14,189
100630207,16,24,45,45,32,17,11,7,197
100630208,33,42,41,28,34,13,10,3,204
100630209,31,39,47,45,28,17,6,7,220
100630210,18,37,44,45,30,11,4,13,202
100630211,25,28,36,29,32,18,13,12,193
100630212,25,41,44,40,28,24,11,10,223
100630213,36,44,46,58,50,37,20,14,305
100630214,1,0,2,0,1,0,1,0,5
100630215,0,0,0,0,0,0,0,0,0
100630216,0,0,0,0,0,0,0,0,0
100630217,0,0,0,0,0,0,0,0,0
100630218,0,0,0,0,0,0,0,0,0
100700101,10,8,5,5,4,3,1,0,36
100700102,9,5,10,5,4,6,2,1,42
100700103,45,53,60,93,56,36,20,15,378
100700104,58,52,47,55,32,28,6,13,291
100700105,33,71,60,45,30,19,9,8,275
100700106,31,37,46,47,30,25,8,9,233
100700107,27,36,62,62,48,40,17,15,307
100700108,16,33,44,69,54,35,17,17,285
100700109,50,55,47,37,25,17,7,5,243
100700110,66,74,73,66,51,33,13,11,387
100700111,47,59,48,51,36,29,15,11,296
100700112,39,50,56,57,34,36,9,9,290
100700113,21,27,38,39,28,21,7,10,191
100700201,30,17,18,29,10,10,5,13,132
100700202,20,11,23,11,11,1,5,8,90
100700203,46,42,45,47,35,41,7,10,273
100700204,35,39,36,34,28,14,10,14,210
100700205,18,19,18,13,18,8,5,15,114
100700301,61,46,43,33,39,25,6,13,266
100700302,13,12,17,10,10,5,1,4,72
100700303,49,19,28,11,12,7,0,6,132
100700304,4,3,2,4,5,2,2,2,24
100700305,40,55,59,46,39,20,8,11,278
100700306,41,55,58,47,36,12,5,8,262
100700307,28,34,66,43,39,29,15,15,269
100700308,25,38,46,34,24,16,8,13,204
100700309,13,11,9,11,1,4,0,4,53
100700401,10,16,13,10,3,4,1,3,60
100700402,11,8,11,7,4,3,3,3,50
100700403,14,15,8,11,1,11,2,10,72
100700404,35,40,46,46,49,29,14,19,278
100770101,6,5,1,2,0,0,1,0,15
100770102,2,9,10,23,10,14,3,3,74
100770103,12,11,5,5,6,6,3,4,52
100770104,29,34,33,35,25,19,9,10,194
100770105,32,51,31,49,27,10,7,8,215
100770201,8,7,8,6,6,2,3,5,45
100770202,18,14,11,10,7,2,3,10,75
100770203,5,6,2,3,4,2,0,3,25
100770301,16,5,11,5,5,6,3,7,58
100770401,7,12,13,7,9,8,0,5,61
100770402,3,5,7,4,4,1,3,2,29
100770501,3,6,3,9,0,0,1,0,22
100770502,18,11,8,11,10,6,7,2,73
100770601,24,15,15,20,12,4,4,2,96
100770602,8,10,8,7,2,4,4,0,43
100770603,21,14,18,9,9,3,1,0,75
100840101,21,27,39,30,24,16,8,9,174
100840102,5,3,1,0,0,2,0,1,12
100840103,31,22,29,51,28,23,8,8,200
100840104,22,41,40,31,31,16,4,5,190
100840105,28,33,36,27,33,12,5,11,185
100840106,26,31,33,33,27,24,8,8,190
100840107,5,0,1,0,0,1,0,0,7
100840201,8,3,1,5,2,2,1,2,24
100840202,35,19,18,23,16,14,10,3,138
100840203,24,28,24,29,15,14,13,8,155
100840204,25,26,23,28,10,10,9,6,137
100840301,4,1,1,2,1,3,0,0,12
100840302,2,9,2,3,0,7,2,5,30
100840303,25,24,20,22,20,13,5,10,139
100840304,50,48,34,37,50,27,12,29,287
100840305,7,19,24,21,28,15,5,8,127
100840306,32,20,37,38,41,16,9,11,204
100840307,23,34,52,47,34,29,8,19,246
100840401,20,23,26,20,27,16,13,31,176
100840402,5,5,3,2,0,2,0,1,18
100840403,13,9,12,21,11,11,7,11,95
100910101,1,3,1,0,0,0,0,0,5
100910102,8,9,17,14,18,8,2,5,81
100910103,35,43,45,40,28,23,10,12,236
100910104,46,52,46,56,21,26,8,8,263
100910105,57,66,58,37,30,12,8,5,273
100910106,41,43,46,39,15,11,0,6,201
100910107,52,41,54,48,28,27,15,10,275
100910108,39,51,73,78,51,48,17,29,386
100910109,44,66,62,69,42,14,9,11,317
100910110,33,63,65,51,26,19,8,8,273
100910111,25,46,58,60,39,40,12,13,293
100910112,31,29,30,34,39,18,9,13,203
100910113,20,33,37,45,37,17,8,11,208
100910114,29,22,26,42,34,30,15,18,216
100910115,8,17,24,35,32,8,6,6,136
100910201,20,23,19,16,17,16,10,4,125
100910202,5,13,5,9,4,4,6,7,53
100910301,0,0,1,0,0,0,0,0,1
100910302,27,34,29,49,31,26,5,14,215
100910303,29,32,40,38,29,23,7,21,219
100910401,1,2,0,1,1,1,0,1,7
100910402,0,0,0,0,0,0,0,0,0
100910403,48,52,55,74,71,34,18,27,379
100910404,21,21,19,25,15,8,4,4,117
100910405,5,2,1,1,1,1,0,0,11
100910501,26,33,21,27,29,10,8,7,161
100910502,30,30,26,31,24,9,17,15,182
100910503,22,26,26,37,24,16,5,6,162
100910504,29,26,31,27,29,17,5,8,172
100910505,49,48,41,41,25,25,14,14,257
100910506,7,3,5,7,4,2,2,3,33
100910507,33,19,13,14,7,7,7,11,111
100910508,21,17,8,8,10,4,4,4,76
100910509,22,8,9,10,10,4,0,6,69
100910510,8,2,1,2,1,1,0,4,19
100910511,0,1,0,0,0,0,0,0,1
100910601,13,12,7,8,5,4,0,6,55
100910602,5,8,4,4,2,1,0,2,26
100910603,14,8,6,5,6,3,1,1,44
100910604,1,5,6,3,1,1,1,3,21
100910701,4,4,1,0,3,1,0,2,15
100910702,19,10,7,9,5,4,2,6,62
100910703,6,6,4,1,1,4,1,0,23
100980101,21,21,16,18,11,7,3,5,102
100980102,35,29,44,36,31,14,5,16,210
100980103,4,1,0,1,2,0,0,0,8
100980104,19,15,8,6,6,3,4,7,68
100980201,9,7,4,3,4,0,2,5,34
100980202,7,6,4,4,2,1,1,2,27
100980203,32,32,29,51,27,11,8,10,200
100980204,9,9,11,9,9,1,1,2,51
100980205,33,30,32,25,22,14,3,6,165
100980206,27,22,36,23,25,10,2,7,152
100980207,11,7,15,13,6,9,4,5,70
100980208,10,8,11,3,4,3,1,4,44
100980301,9,9,8,1,4,9,2,7,49
100980302,8,5,6,3,6,0,2,1,31
100980303,22,17,17,19,20,10,8,10,123
100980401,16,16,12,13,5,3,3,6,74
100980402,26,47,42,34,37,25,7,7,225
100980403,22,27,30,34,29,14,12,23,191
100980404,44,46,78,90,63,37,14,18,390
100980405,48,42,50,54,40,26,22,27,309
100980406,6,3,4,2,1,2,1,0,19
100980407,19,21,30,36,22,14,7,20,169
100980408,46,28,42,27,20,10,10,11,194
100980409,34,32,39,27,24,7,5,9,177
100980410,4,0,5,0,4,0,0,1,14
101050101,18,7,4,1,1,3,0,4,38
101050102,32,36,38,26,28,13,6,16,195
101050103,14,28,35,23,17,15,3,12,147
101050104,76,56,46,39,40,20,10,13,300
101050105,42,55,43,49,34,20,8,16,267
101050106,26,27,41,18,21,17,12,17,179
101050107,51,57,42,44,28,17,11,6,256
101050108,26,44,30,29,27,10,4,9,179
101050109,52,60,59,33,32,11,11,5,263
101050110,37,33,33,21,20,8,1,4,157
101050111,53,62,57,44,28,10,3,3,260
101050112,25,42,56,55,47,34,6,7,272
101050113,33,21,22,25,20,15,6,11,153
101050114,63,57,58,59,34,19,5,11,306
101050115,25,52,69,57,30,20,13,22,288
101050201,8,6,11,11,11,9,1,6,63
101050202,47,41,22,26,20,14,6,19,195
101050301,3,4,1,0,0,0,0,0,8
101050302,40,29,34,39,22,12,11,28,215
101050303,47,41,40,38,23,23,16,15,243
101050304,23,42,63,64,35,13,6,19,265
101050305,33,38,44,24,14,8,8,8,177
101050306,24,37,28,32,16,18,16,10,181
101050307,13,26,27,35,22,7,3,7,140
101050401,23,27,11,18,17,10,9,5,120
101050402,5,11,8,10,11,5,2,6,58
101050501,19,15,7,9,2,5,2,7,66
101050502,5,4,3,2,3,1,0,0,18
101050601,1,0,0,0,0,1,0,0,2
101050602,28,22,31,19,25,14,12,16,167
101050701,7,13,16,12,9,11,5,14,87
101050702,36,28,43,46,29,30,6,23,241
101050703,21,5,5,5,3,5,2,6,52
101050704,10,2,4,1,1,4,0,3,25
101050705,19,10,3,5,1,1,3,2,44
101050706,10,11,8,2,4,3,2,2,42
101050707,16,12,9,12,7,12,3,11,82
101050708,31,25,27,10,15,13,6,6,133
101050709,25,16,25,25,20,16,1,11,139
101050801,5,11,2,5,3,3,1,4,34
101050802,2,3,1,2,1,0,0,0,9
101120101,20,19,20,28,13,8,4,6,118
101120201,5,12,11,5,3,3,2,1,42
101120202,19,16,12,5,5,2,2,2,63
101120301,5,6,7,3,2,4,2,1,30
101120302,25,7,16,14,10,12,6,9,99
101120303,13,7,5,8,6,2,7,1,49
101120401,1,8,4,4,3,2,2,2,26
101120402,31,30,40,43,28,15,5,7,199
101120403,31,56,78,75,67,32,21,29,389
101120404,42,66,66,68,49,28,9,11,339
101120405,18,60,63,81,56,34,14,16,342
101120406,27,42,63,59,64,37,14,31,337
101120407,26,39,40,43,37,34,9,8,236
101120408,33,44,58,65,52,36,17,30,335
101120409,28,45,74,63,41,27,20,20,318
101120410,37,53,51,42,18,14,9,15,239
101120411,21,38,48,42,25,14,6,2,196
101120501,3,4,3,2,1,1,2,1,17
101120502,38,43,44,35,29,14,12,8,223
101120503,32,58,51,48,44,29,8,12,282
101120504,24,35,45,54,30,23,14,15,240
101120505,15,35,50,50,32,25,11,15,233
101120506,27,44,42,57,36,38,19,22,285
101120507,24,31,49,66,33,23,9,17,252
101120508,38,30,41,33,37,16,2,17,214
101120509,26,66,54,55,49,29,15,13,307
101120510,32,41,52,50,45,29,16,20,285
101120511,21,36,51,59,38,27,5,18,255
101120512,22,30,47,47,35,22,4,13,220
101120513,27,41,57,50,49,26,15,28,293
101120514,20,21,37,42,35,22,8,11,196
101120515,27,38,35,49,37,20,6,11,223
140070101,5,5,2,1,3,0,1,0,17
140070102,29,27,23,23,10,8,1,2,123
140070103,25,21,11,11,8,1,1,1,79
140070104,5,5,5,5,2,1,0,1,24
140070105,10,12,16,11,15,3,4,1,72
140070106,10,11,5,4,2,1,0,0,33
140070107,0,9,0,0,1,0,0,0,10
140070108,25,32,19,14,10,9,1,4,114
140070110,18,35,28,28,11,6,7,1,134
140070111,33,47,36,34,24,5,6,5,190
140070112,34,52,33,29,12,6,2,2,170
140070113,47,35,31,26,17,6,1,3,166
140070201,22,24,14,13,11,6,3,1,94
140070202,7,8,5,3,3,4,0,1,31
140070203,5,5,8,4,6,4,2,1,35
140070204,30,36,23,32,12,11,4,3,151
140070205,22,47,32,32,18,5,0,1,157
140070206,62,80,65,63,19,18,5,9,321
140070207,57,81,48,57,13,10,2,5,273
140070208,59,70,58,46,31,17,2,10,293
140070209,43,59,36,34,16,8,5,5,206
140070210,50,57,20,19,6,4,1,0,157
140070211,65,89,49,45,34,11,3,6,302
140070212,46,67,25,31,12,2,1,0,184
140070213,48,61,37,17,11,3,0,2,179
140070214,50,56,36,23,22,8,2,1,198
140070215,33,59,38,31,16,4,2,1,184
140070216,14,21,15,13,6,7,1,0,77
140070301,7,2,3,1,3,2,0,0,18
140070302,4,4,4,2,0,2,0,1,17
140070303,0,1,0,3,0,1,0,0,5
140070304,0,6,3,3,3,0,1,1,17
140070305,22,12,17,9,12,4,7,3,86
140070306,6,6,5,3,5,1,0,2,28
140070307,9,10,2,7,2,1,0,1,32
140070308,13,11,16,14,11,4,2,3,74
140070309,43,55,46,63,39,16,3,5,270
140070310,35,42,51,42,18,10,1,3,202
140070311,45,37,51,43,40,11,12,9,248
140070312,45,45,46,52,27,26,3,9,253
140070401,7,7,3,1,0,2,0,1,21
140070402,0,3,1,0,1,2,0,0,7
140070403,4,4,7,7,0,0,1,1,24
140070404,0,0,1,1,0,0,0,0,2
140070405,10,11,7,13,0,2,0,4,47
140070406,17,20,11,9,7,0,3,0,67
140070407,21,21,12,9,8,2,3,3,79
140070408,9,4,3,3,0,1,0,0,20
140070409,8,0,4,1,0,0,0,0,13
140070410,2,2,2,2,0,0,0,1,9
140070411,3,6,4,2,3,0,1,0,19
140070412,7,10,6,4,1,1,2,2,33
140070413,5,8,4,6,2,0,0,0,25
140070414,38,49,55,44,41,31,14,8,280
140070415,14,10,12,11,7,2,0,2,58
140070416,23,34,26,24,13,5,4,4,133
140070501,39,56,34,42,16,10,2,7,206
140070502,26,29,27,21,8,4,1,2,118
140070503,42,50,28,23,17,4,2,3,169
140070504,36,46,28,40,12,4,1,1,168
140070505,39,64,34,26,10,7,1,1,182
140070506,32,57,42,45,32,8,5,6,227
140070507,18,30,42,29,23,17,8,6,173
140070508,16,41,28,38,17,4,6,3,153
140070509,83,71,49,37,16,10,1,0,267
140070510,62,93,76,53,29,11,2,2,328
140070511,76,80,69,42,22,10,4,1,304
140070512,72,94,61,37,20,7,3,5,299
140070513,47,77,48,48,28,6,2,3,259
140070514,24,46,33,41,22,10,2,1,179
140070515,26,48,37,37,23,14,7,3,195
140070516,23,28,27,25,11,8,2,1,125
140070517,32,65,60,36,45,21,11,14,284
140070518,23,53,43,52,31,27,5,14,248
140070601,4,4,2,2,0,1,0,0,13
140070602,19,22,18,7,9,7,1,1,84
140070603,18,5,7,8,4,3,0,2,47
140070604,6,6,0,2,3,3,0,0,20
140070605,20,21,11,8,5,2,0,1,68
140070606,10,23,15,11,2,0,1,1,63
140070607,51,83,48,40,17,13,2,6,260
140070608,48,61,44,37,22,5,6,5,228
140070609,29,44,33,16,11,12,5,3,153
140070610,23,35,23,26,14,12,3,1,137
140070611,34,63,48,38,25,7,2,2,219
140070612,34,48,32,30,12,6,2,3,167
140070613,21,37,30,21,9,3,2,3,126
140070614,47,57,56,38,27,15,5,5,250
140070615,28,46,28,15,13,7,2,1,140
140070616,15,48,20,13,8,4,1,0,109
140070701,3,11,5,4,0,0,0,1,24
140070702,4,9,9,3,0,0,1,0,26
140070703,3,5,2,2,1,0,0,0,13
140070704,2,1,1,1,0,1,0,0,6
140070705,10,5,6,5,1,0,0,2,29
140070706,52,76,51,61,28,16,2,2,288
140070707,3,3,1,2,1,3,1,0,14
140070708,1,5,1,5,1,1,0,0,14
140070709,1,1,0,1,1,0,2,0,6
140070710,4,1,3,2,2,0,0,0,12
140070711,2,2,3,2,2,1,0,0,12
140070712,3,4,2,0,4,0,0,1,14
140070713,6,6,3,6,6,2,0,0,29
140070714,2,0,3,0,1,0,0,0,6
140070715,22,11,18,10,9,5,1,1,77
140070716,4,4,1,2,1,1,0,0,13
140070717,0,4,1,2,0,1,0,0,8
140070718,7,13,5,2,1,0,0,0,28
140070719,58,40,29,29,20,8,0,0,184
140070720,5,4,4,4,1,0,0,1,19
140070801,2,5,3,1,0,1,0,0,12
140070802,9,18,14,12,7,0,1,1,62
140070803,64,63,50,50,27,13,1,7,275
140070804,15,21,14,9,5,3,2,0,69
140070805,62,86,68,65,42,15,9,5,352
140070806,52,52,31,39,19,8,1,1,203
140070807,39,82,67,51,19,11,6,6,281
140070808,77,90,53,45,17,10,2,1,295
140070809,31,78,44,53,27,14,1,6,254
140070810,7,9,7,4,2,4,1,0,34
140070811,3,3,3,2,3,0,0,0,14
140070812,4,4,5,1,1,0,0,0,15
140070813,5,3,2,3,3,0,0,0,16
140070814,57,77,57,78,40,14,5,6,334
140070815,70,93,70,52,27,18,5,2,337
140070816,18,39,44,53,32,17,4,3,210
140070817,62,94,77,59,27,9,9,3,340
140070818,60,68,53,49,27,16,2,3,278
140070819,7,9,6,3,5,1,1,3,35
140070820,42,41,41,34,17,10,5,7,197
140070901,2,2,4,1,0,1,0,0,10
140070902,9,5,5,1,3,0,1,1,25
140070903,0,5,5,1,1,1,1,0,14
140070904,65,74,48,32,13,11,2,4,249
140070905,3,3,3,5,0,0,0,0,14
140070906,7,10,3,5,1,0,0,1,27
140070907,1,6,1,0,2,2,0,0,12
140070908,21,24,19,18,12,5,0,1,100
140140101,26,24,37,25,17,18,8,5,160
140140102,38,51,59,68,31,34,12,20,313
140140103,39,64,74,94,50,27,10,4,362
140140104,25,31,49,36,34,19,6,12,212
140140105,49,61,72,73,27,14,2,4,302
140140106,43,81,70,70,42,22,3,13,344
140140107,40,66,51,45,27,14,5,0,248
140140108,22,65,55,48,20,13,5,5,233
140140109,41,75,88,77,50,45,10,13,399
140140110,40,48,65,70,42,5,0,3,273
140140111,13,49,36,62,21,6,3,0,190
140140112,52,72,70,77,34,7,2,1,315
140140113,41,76,76,69,47,25,9,6,349
140140201,19,35,43,61,46,13,8,16,241
140140202,54,123,112,113,37,10,3,0,452
140140203,30,94,75,95,40,9,3,0,346
140140204,29,62,60,69,39,13,7,3,282
140140205,29,50,52,53,36,5,1,1,227
140140206,21,53,41,39,23,5,0,1,183
140140207,47,99,83,76,40,8,5,0,358
140140208,40,80,64,48,34,11,2,0,279
140140209,37,83,63,50,24,8,2,1,268
140140210,37,65,60,66,25,11,0,1,265
140140211,15,35,46,50,28,12,1,2,189
140140212,26,68,58,47,27,12,1,0,239
140140213,49,97,83,63,40,23,2,3,360
140140214,62,75,78,80,45,13,13,2,368
140140215,51,109,85,56,38,30,7,5,381
140140301,14,28,20,21,17,17,5,5,127
140140302,67,88,95,110,72,61,30,24,547
140140303,59,82,84,82,54,29,8,23,421
140140304,28,62,64,76,61,29,13,25,358
140140305,43,53,58,70,45,17,7,17,310
140140306,32,42,40,49,33,20,14,7,237
140140307,41,49,39,49,29,16,3,4,230
140140308,33,59,78,61,50,30,9,13,333
140140309,40,49,70,71,59,44,17,9,359
140140310,38,57,59,57,36,17,5,1,270
140140311,50,73,57,48,35,7,1,2,273
140140312,41,93,70,79,51,20,6,5,365
140140313,51,92,89,74,47,31,14,11,409
140140401,38,55,75,72,74,36,19,25,394
140140402,36,42,42,53,59,29,16,18,295
140140403,15,18,16,18,21,7,2,4,101
140140404,19,49,58,65,39,25,8,9,272
140140405,30,63,82,114,92,49,22,21,473
140140406,33,62,82,100,72,43,15,21,428
140140407,40,65,75,58,39,15,5,2,299
140140408,45,92,88,95,58,37,15,7,437
140140409,28,59,67,53,42,24,10,10,293
140140410,36,56,80,89,60,34,14,16,385
140140411,37,66,80,104,82,31,4,13,417
140140501,28,53,45,47,39,23,4,9,248
140140502,20,42,58,72,57,51,17,25,342
140140503,16,27,34,48,47,36,18,15,241
140140504,27,47,65,86,58,49,27,25,384
140140505,36,90,74,99,73,35,16,19,442
140140506,27,28,45,48,36,20,5,12,221
140140507,14,29,46,50,38,30,16,34,257
140140508,48,66,76,73,65,28,8,20,384
140140509,34,53,50,46,44,18,7,8,260
140140510,44,91,77,66,57,34,9,18,396
140140511,32,50,70,61,39,33,14,12,311
140140512,36,55,67,61,43,25,19,13,319
140140513,38,48,59,80,44,43,18,20,350
140140514,27,31,64,70,59,42,18,29,340
140140515,30,67,71,105,69,28,10,5,385
140140601,23,40,39,70,26,15,8,4,225
140140602,6,4,11,5,5,8,2,2,43
140140603,9,18,5,13,7,10,2,2,66
140140604,27,31,50,43,27,20,8,15,221
140140605,39,36,43,61,38,16,11,8,252
140140606,43,69,46,58,27,23,7,4,277
140140607,38,72,81,99,75,40,20,14,439
140140608,12,16,31,44,27,14,8,4,156
140140609,23,43,61,72,61,26,11,12,309
140140610,47,67,51,62,44,28,6,8,313
140140701,40,69,83,72,44,27,7,17,359
140140702,31,52,55,47,34,14,6,6,245
140140703,21,36,34,37,23,16,4,8,179
140140704,24,34,43,50,47,37,9,16,260
140140705,26,45,68,72,46,24,14,15,310
140140706,6,6,2,0,1,0,0,0,15
140140707,9,39,34,36,25,33,7,21,204
140140708,19,38,54,56,52,38,20,23,300
140140709,28,49,61,82,50,41,21,27,359
140140710,10,9,12,11,10,2,3,2,59
140140711,15,10,22,28,30,28,18,20,171
140140712,20,23,13,29,16,16,5,8,130
140140713,18,28,40,47,47,27,20,24,251
140140714,22,39,34,47,39,41,19,46,287
140140715,11,20,38,61,33,34,17,26,240
140140801,0,0,0,2,0,1,0,0,3
140140802,2,14,42,67,50,20,5,6,206
140140803,8,28,30,25,10,9,3,1,114
140140804,28,38,57,79,44,23,16,18,303
140140805,37,72,101,128,53,40,15,6,452
140140806,20,37,66,69,35,16,4,2,249
140140807,30,70,60,64,36,23,5,3,291
140140808,14,22,28,46,35,26,10,17,198
140140809,37,53,94,113,83,42,21,23,466
140140810,43,49,73,75,70,32,22,16,380
140140811,39,70,74,83,59,36,12,13,386
140140812,21,43,52,73,35,28,2,2,256
140140901,2,2,3,1,1,0,0,2,11
140140902,27,48,57,67,59,43,12,17,330
140140903,26,39,41,62,55,37,18,13,291
140140904,23,44,56,68,34,31,3,6,265
140140905,38,51,74,110,60,40,19,9,401
140140906,23,39,55,63,39,18,8,11,256
140140907,8,21,32,31,26,15,6,1,140
140140908,18,50,78,86,77,37,19,22,387
140140909,46,68,79,86,55,43,3,9,389
140140910,40,58,50,85,57,33,12,11,346
140140911,39,67,92,93,54,48,9,13,415
140140912,35,66,81,109,72,61,26,31,481
140140913,19,44,57,83,57,39,5,12,316
140140914,21,29,68,53,55,28,4,10,268
140140915,0,2,0,5,2,1,2,1,13
140141001,10,22,37,63,19,5,1,0,157
140141002,32,73,107,134,62,23,12,6,449
140141003,28,76,49,33,17,11,4,2,220
140141004,39,76,56,37,33,11,5,2,259
140141005,20,51,51,46,24,9,2,2,205
140141006,68,105,76,69,36,14,3,2,373
140141007,27,37,35,32,15,4,4,3,157
140141008,82,112,116,95,53,16,15,12,501
140141009,40,88,66,80,37,15,2,3,331
140141010,54,85,88,76,34,18,1,1,357
140141011,55,87,88,83,57,32,17,13,432
140141012,25,57,43,74,19,6,3,2,229
140141013,32,64,60,70,38,23,6,7,300
140141014,23,48,41,48,17,11,2,3,193
140141015,11,19,31,83,51,20,4,2,221
140141016,10,29,49,105,55,21,1,1,271
140141017,12,44,57,77,23,10,1,1,225
140141018,16,36,46,74,22,2,2,0,198
140141101,14,15,23,15,17,15,7,4,110
140141102,15,36,60,51,40,25,8,8,243
140141103,30,57,53,52,41,29,7,7,276
140141104,35,34,30,36,33,14,7,11,200
140141105,38,68,55,55,32,21,4,5,278
140141106,22,51,49,52,34,20,8,3,239
140141107,19,44,45,49,35,20,13,11,236
140141108,31,37,45,45,48,34,17,18,275
140141109,32,61,80,93,61,34,22,23,406
140141110,19,31,50,73,48,32,14,3,270
140141111,29,51,69,76,38,16,7,9,295
140141201,29,31,46,62,46,26,8,10,258
140141202,41,65,87,63,41,25,11,8,341
140141203,29,64,64,65,50,33,19,26,350
140141204,33,46,73,80,66,41,18,19,376
140141205,25,58,76,114,66,45,18,13,415
140141206,32,54,69,46,36,22,11,4,274
140141207,27,66,63,55,33,23,8,8,283
140141208,38,72,73,71,51,21,2,1,329
140141209,33,66,74,70,48,19,7,4,321
140141301,21,35,24,30,15,10,0,3,138
140141302,43,72,72,76,51,34,12,11,371
140141303,31,42,62,60,40,30,9,6,280
140141304,46,61,65,77,52,33,6,18,358
140141305,19,35,39,38,36,17,12,17,213
140141306,13,23,29,39,36,30,6,10,186
140141307,21,38,58,88,73,29,11,19,337
140141308,26,51,51,60,53,24,27,20,312
140141309,42,54,80,81,66,62,26,34,445
140141310,22,30,31,23,23,20,7,10,166
140141401,29,58,68,70,66,32,13,28,364
140141402,25,56,100,101,86,60,31,44,503
140141403,23,49,77,66,61,37,15,15,343
140141404,17,32,40,54,31,16,12,3,205
140141405,32,51,57,44,34,21,12,3,254
140141406,35,60,99,65,54,39,8,9,369
140141407,56,66,87,80,54,32,8,7,390
140141408,6,9,6,9,10,4,2,4,50
140141501,5,31,45,59,45,15,3,0,203
140141502,28,65,59,43,34,14,4,1,248
140141503,28,41,38,41,31,13,4,2,198
140141504,38,56,60,58,37,30,2,11,292
140141505,41,70,68,59,27,23,8,12,308
140141506,72,85,89,77,56,43,12,17,451
140141507,24,44,46,41,29,10,1,4,199
140141508,34,53,56,53,31,28,5,9,269
140141509,45,87,92,85,50,22,7,7,395
140141510,25,51,60,71,61,33,10,13,324
140141511,43,74,99,86,61,23,16,8,410
140141512,22,47,38,48,23,6,4,3,191
140141513,43,98,84,120,115,55,17,8,540
140141514,41,72,76,78,47,20,5,14,353
140141515,12,31,37,61,65,32,5,4,247
140141516,15,22,36,46,24,17,5,4,169
140141517,37,42,71,70,52,35,7,9,323
140141518,12,25,30,71,62,19,5,3,227
140141519,21,32,37,85,57,24,3,2,261
140141520,59,51,73,121,69,33,12,6,424
140141601,33,43,62,76,62,32,22,19,349
140141602,32,28,83,80,80,58,18,34,413
140141603,42,55,72,86,65,63,33,39,455
140141604,32,34,35,31,26,23,11,12,204
140141605,24,55,51,57,40,24,7,15,273
140141606,37,62,60,67,47,31,15,22,341
140141607,40,58,49,67,48,34,15,18,329
140141608,17,34,43,31,25,18,7,12,187
140141609,34,49,51,47,35,24,5,16,261
140141610,22,31,42,70,36,33,13,7,254
140141611,27,40,62,61,59,30,20,31,330
140141612,22,36,58,55,38,30,17,11,267
140141613,32,40,41,52,47,36,7,13,268
140141614,17,34,46,56,49,29,9,13,253
140141615,24,40,41,52,32,31,3,9,232
140141616,74,118,127,103,68,26,11,17,544
140141617,39,59,56,68,42,35,8,14,321
140141618,31,39,64,85,68,53,26,37,403
140141701,46,90,88,83,58,29,6,9,409
140141702,29,59,72,77,47,27,6,6,323
140141703,30,40,40,58,37,38,12,25,280
140141704,43,76,84,76,54,35,8,13,389
140141705,19,42,66,93,56,23,5,3,307
140141706,34,83,99,110,67,32,10,11,446
140141707,19,39,46,45,42,29,4,16,240
140141708,23,41,69,70,48,33,14,12,310
140141709,17,43,55,50,44,16,5,6,236
140141710,27,69,75,96,42,24,10,1,344
140141711,33,66,61,84,50,25,10,7,336
140141712,30,51,51,66,33,28,9,8,276
140141713,49,88,101,86,58,47,15,22,466
140141714,26,51,63,59,29,19,14,5,266
140141715,41,95,70,81,42,37,9,15,390
140141716,48,66,80,95,81,67,22,20,479
140141717,58,89,95,89,66,48,10,20,475
140141718,34,61,73,71,56,27,9,18,349
140141719,41,49,59,66,42,29,4,7,297
140141720,18,42,43,50,22,15,1,2,193
140141721,57,101,90,74,38,26,7,8,401
140141801,44,74,89,117,59,30,13,12,438
140141802,26,42,42,67,50,31,10,11,279
140141803,36,44,37,78,39,33,10,5,282
140141804,13,33,38,52,43,29,13,16,237
140141805,33,63,87,99,64,40,27,16,429
140141806,23,39,44,59,27,23,6,16,237
140141807,22,39,49,49,28,20,11,11,229
140141808,50,93,94,109,57,39,15,14,471
140141809,31,60,76,86,51,31,6,7,348
140141810,37,56,67,53,18,9,4,1,245
140141811,38,78,73,75,52,28,7,7,358
140141812,48,66,58,68,34,29,16,9,328
140141813,32,71,61,63,45,23,4,10,309
140141814,19,49,70,89,63,35,13,12,350
140141815,32,39,60,66,39,26,9,10,281
140141816,36,63,85,92,77,48,20,29,450
140141817,36,31,48,83,41,33,16,18,306
140141818,26,29,53,64,60,36,21,28,317
140141901,51,101,93,80,43,22,11,1,402
140141902,36,48,42,56,26,16,4,6,234
140141903,26,30,59,51,46,34,9,12,267
140141904,32,49,60,61,47,33,11,13,306
140141905,15,34,54,63,40,38,11,13,268
140141906,25,46,84,67,48,37,25,34,366
140141907,43,62,64,79,62,59,24,24,417
140141908,39,66,57,95,81,43,21,31,433
140141909,34,42,52,56,51,35,16,32,318
140141910,17,38,35,41,25,28,7,14,205
140141911,126,82,59,72,34,25,3,4,405
140141912,21,41,49,55,24,30,10,22,252
140141913,26,47,70,69,53,48,15,20,348
140141914,21,43,50,74,55,56,26,23,348
140141915,41,80,89,116,65,31,11,8,441
140141916,49,84,101,97,44,21,4,7,407
140141917,31,48,50,66,35,12,1,3,246
140141918,33,53,38,66,38,15,1,3,247
140141919,35,35,36,54,33,21,17,13,244
140142001,38,51,56,72,34,14,6,10,281
140142002,35,53,43,53,36,13,2,1,236
140142003,25,52,52,67,41,11,5,2,255
140142004,36,53,72,105,43,16,2,0,327
140142005,49,80,101,74,55,28,7,2,396
140142006,17,65,53,55,41,17,3,2,253
140142007,29,52,60,75,26,13,1,1,257
140142008,16,40,43,53,34,19,5,3,213
140142009,33,61,53,41,25,12,0,3,228
140142010,33,62,39,72,30,23,6,2,267
140142011,24,64,61,45,38,3,1,2,238
140142012,40,61,68,60,49,15,4,2,299
140142013,31,58,72,58,40,21,4,5,289
140142014,21,50,71,94,47,19,5,3,310
140142015,24,48,30,43,30,12,1,0,188
140142016,47,79,64,94,63,25,12,1,385
140142101,30,54,59,61,38,18,8,6,274
140142102,25,38,29,70,78,36,4,2,282
140142103,24,46,42,58,52,25,10,1,258
140142104,14,52,57,97,109,38,10,6,383
140142105,14,41,44,54,35,21,2,2,213
140142201,14,28,47,66,35,6,1,1,198
140142202,21,37,58,111,72,19,2,2,322
140142203,23,43,51,54,31,12,2,1,217
140142204,15,23,34,64,54,13,4,0,207
140142205,3,11,19,30,33,19,9,2,126
140142206,46,95,94,116,49,32,3,2,437
140142207,14,24,32,77,41,15,1,0,204
140142208,40,79,72,68,59,24,10,3,355
140142209,33,60,66,37,26,14,4,5,245
140142210,43,63,63,67,44,13,9,8,310
140142211,34,63,75,65,44,19,2,7,309
140142212,65,96,94,75,28,15,4,0,377
140142213,1,1,0,1,0,0,0,0,3
140142214,31,65,54,62,29,9,4,3,257
140142215,36,71,80,84,37,8,4,2,322
140142216,45,68,72,62,25,15,2,2,291
140142217,30,62,61,79,46,30,6,8,322
140142218,60,73,91,84,45,44,18,11,426
140142301,31,60,44,64,25,16,3,2,245
140142302,65,89,67,62,28,16,4,1,332
140142303,27,52,50,48,23,11,3,3,217
140142304,37,55,45,26,15,8,0,0,186
140142305,36,56,33,33,16,6,1,1,182
140142306,52,71,48,45,29,11,1,2,259
140142307,36,67,57,54,30,14,3,1,262
140142308,34,58,66,94,65,23,5,6,351
140142309,24,46,34,32,30,15,0,1,182
140142310,38,68,53,54,29,12,2,3,259
140142311,26,58,42,35,32,16,5,4,218
140142312,24,57,55,53,40,16,6,1,252
140142313,30,77,92,116,91,35,7,2,450
140142314,33,61,48,47,33,18,6,8,254
140142315,33,66,56,72,28,12,4,0,271
140142316,28,47,45,40,27,9,4,0,200
140142401,46,71,72,78,46,16,4,3,336
140142402,61,104,69,57,34,15,1,0,341
140142403,63,82,57,58,31,10,0,0,301
140142404,55,107,103,87,47,17,1,2,419
140142405,39,61,75,50,27,12,2,2,268
140142406,51,106,61,54,26,9,2,2,311
140142407,50,84,47,50,19,7,1,2,260
140142408,40,62,58,56,25,7,2,1,251
140142409,52,91,72,50,31,11,6,1,314
140142410,79,43,31,27,12,2,0,0,194
140142411,41,83,41,37,15,11,3,0,231
140142412,31,67,45,27,13,3,1,1,188
140142413,46,74,45,31,15,8,0,1,220
140142414,34,53,52,29,20,8,3,0,199
140142501,150,89,28,6,5,2,0,0,280
140142502,31,64,42,46,19,9,1,0,212
140142503,12,31,16,17,11,2,0,0,89
140142504,52,84,78,70,29,24,3,4,344
140142505,37,54,44,57,28,14,8,5,247
140142506,58,99,66,67,30,20,4,3,347
140142507,65,76,65,66,37,15,7,3,334
140142508,48,40,29,33,21,8,2,4,185
140142509,36,52,48,42,25,17,2,4,226
140142510,35,63,51,46,18,3,3,2,221
140142511,44,67,53,46,31,6,4,4,255
140142512,41,83,45,42,17,5,5,1,239
140142513,37,65,60,37,16,13,2,3,233
140142514,31,69,41,39,19,9,2,1,211
140142515,76,109,79,54,38,10,3,0,369
140142516,67,74,72,76,41,7,4,3,344
140142517,34,59,50,45,22,15,6,2,233
140142518,42,104,60,69,29,11,1,0,316
140142601,26,48,54,51,30,20,5,4,238
140142602,32,47,38,33,25,14,3,7,199
140142603,42,67,50,33,41,18,8,8,267
140142604,34,39,40,27,21,9,2,1,173
140142605,55,49,24,24,14,9,1,3,179
140142606,39,68,61,50,19,8,4,3,252
140142607,49,60,49,51,22,10,5,1,247
140142608,66,98,86,67,33,10,6,4,370
140142609,65,78,44,43,26,11,3,5,275
140142610,35,53,43,43,19,6,3,1,203
140142611,51,94,78,84,40,18,5,6,376
140142612,45,92,61,45,23,6,5,3,280
140142613,38,51,43,43,29,5,4,2,215
140142614,51,62,52,45,27,14,5,3,259
140142615,70,75,63,58,27,13,1,2,309
140142616,51,75,58,48,21,9,1,4,267
140142701,28,60,47,56,24,23,4,9,251
140142702,39,62,86,65,35,16,11,9,323
140142703,39,65,78,69,51,35,12,8,357
140142704,53,60,64,60,35,21,5,2,300
140142705,28,51,35,42,19,10,4,6,195
140142706,34,56,44,40,26,22,6,10,238
140142707,58,70,66,59,28,16,2,3,302
140142708,59,83,60,55,41,16,7,3,324
140142709,38,52,50,39,26,15,1,4,225
140142710,67,50,75,47,36,16,5,5,301
140142711,41,68,58,53,28,19,2,3,272
140142712,34,64,48,33,18,6,7,4,214
140142801,62,83,92,83,61,14,1,4,400
140142802,47,84,72,73,39,12,1,0,328
140142803,49,96,79,98,43,9,6,1,381
140142804,77,104,108,82,47,12,7,5,442
140142805,42,79,74,73,41,33,6,4,352
140142806,31,68,55,61,29,9,4,4,261
140142807,44,56,46,53,25,8,1,5,238
140142808,63,88,81,84,33,31,7,7,394
140142809,41,68,58,72,36,19,7,3,304
140142810,32,68,75,70,47,33,9,10,344
140142811,31,70,58,58,27,28,7,15,294
140142812,26,47,49,63,46,17,6,4,258
140142813,21,53,94,93,67,38,18,14,398
140142814,23,33,49,62,48,56,21,55,347
140142815,22,56,62,69,37,15,3,5,269
140142816,56,55,81,103,67,57,17,29,465
140142901,30,48,61,86,59,22,5,4,315
140142902,26,39,42,73,60,12,13,5,270
140142903,31,43,66,82,44,30,9,12,317
140142904,46,50,60,66,46,27,17,18,330
140142905,64,79,63,68,39,25,16,17,371
140142906,79,99,83,52,38,11,10,4,376
140142907,33,75,49,38,18,12,3,4,232
140142908,47,76,52,56,28,13,10,1,283
140142909,39,50,66,71,48,24,10,17,325
140142910,42,60,44,56,46,29,9,13,299
140142911,36,44,51,37,35,17,8,9,237
140142912,38,35,56,63,33,30,10,17,282
140142913,40,87,49,47,28,9,4,3,267
140142914,34,65,61,69,43,14,2,2,290
140142915,61,108,91,74,48,22,10,4,418
140142916,48,93,63,46,36,13,2,4,305
140142917,46,83,76,59,41,23,5,8,341
140142918,42,45,40,51,26,21,10,14,249
140142919,35,39,44,49,31,13,11,15,237
140143001,34,73,55,68,24,11,1,3,269
140143002,53,66,89,88,62,30,5,11,404
140143003,24,53,54,62,43,23,9,7,275
140143004,29,68,70,85,50,42,12,17,373
140143005,16,38,49,64,29,20,9,14,239
140143006,19,44,66,78,44,31,12,15,309
140143007,15,22,25,44,33,22,8,4,173
140143008,26,20,48,56,61,37,14,27,289
140143009,41,82,92,79,50,30,9,16,399
140143010,29,67,78,59,46,17,6,14,316
140143011,38,68,62,65,38,22,4,5,302
140143012,33,60,80,54,60,21,9,14,331
140143013,47,59,68,62,37,28,13,5,319
140143014,36,61,83,63,41,34,5,10,333
140143015,28,55,65,53,42,22,9,11,285
140143101,26,36,45,88,44,33,11,13,296
140143102,48,70,80,94,81,54,25,26,478
140143103,36,89,99,84,61,47,8,18,442
140143104,26,45,61,69,56,37,8,8,310
140143105,41,49,78,89,43,32,20,15,367
140143106,27,35,39,60,55,26,8,14,264
140143107,48,90,80,79,80,30,12,6,425
140143108,39,60,66,68,45,28,10,8,324
140143109,32,73,101,103,62,50,14,15,450
140143110,24,60,58,56,32,15,11,10,266
140143111,26,59,51,56,48,22,6,7,275
140143112,59,90,73,93,46,33,6,13,413
140143113,40,58,66,50,37,22,5,7,285
140143114,50,68,56,57,30,23,4,4,292
140143115,41,45,48,53,41,18,3,5,254
140143116,39,63,88,78,41,33,7,10,359
140143201,42,53,46,50,23,17,7,7,245
140143202,60,86,88,79,47,32,15,10,417
140143203,27,55,45,48,28,16,5,5,229
140143204,43,54,44,47,34,12,4,7,245
140143205,58,79,76,67,41,20,8,11,360
140143206,43,76,53,83,41,24,4,5,329
140143207,57,92,82,63,40,27,5,11,377
140143208,42,39,49,48,36,24,15,32,285
140143209,19,52,68,47,30,18,5,4,243
140143210,68,120,90,77,45,16,11,6,433
140143211,39,82,45,54,43,33,3,6,305
140143212,20,49,57,43,30,22,10,9,240
140143213,37,58,53,57,55,26,5,0,291
140143301,56,58,54,53,21,18,9,16,285
140143302,27,56,54,41,29,14,6,7,234
140143303,27,65,44,58,34,17,11,15,271
140143304,36,47,47,49,41,15,3,3,241
140143305,42,54,41,32,30,15,4,5,223
140143306,26,44,46,43,24,12,9,5,209
140143307,21,46,59,92,58,20,6,5,307
140143308,23,52,65,94,66,25,14,8,347
140143309,45,67,44,56,31,17,5,1,266
140143310,45,58,58,46,33,15,4,3,262
140143311,47,65,71,60,30,13,3,2,291
140143312,30,54,54,47,43,16,7,6,257
140143313,48,64,53,62,40,14,4,7,292
140143314,43,58,57,43,25,4,4,3,237
140143315,60,70,56,49,28,14,4,4,285
140143316,46,46,41,36,26,17,2,4,218
140143317,47,79,74,69,44,13,5,5,336
140143318,47,67,84,101,51,18,5,4,377
140143319,24,69,57,65,32,20,11,9,287
140143320,45,48,33,42,35,13,9,2,227
140143401,30,62,40,56,26,14,5,8,241
140143402,41,50,60,61,42,22,9,9,294
140143403,45,70,47,53,20,12,4,6,257
140143404,28,31,26,23,15,8,2,1,134
140143405,16,49,39,31,26,10,3,2,176
140143406,30,46,25,34,21,11,4,5,176
140143407,29,48,48,34,29,12,5,6,211
140143408,33,42,47,48,29,13,3,4,219
140143409,44,65,45,45,32,14,0,5,250
140143410,27,47,51,37,29,13,1,3,208
140143411,31,43,46,40,25,9,3,1,198
140143412,29,67,53,44,25,10,4,4,236
140143413,51,53,41,54,25,12,7,1,244
140143414,33,48,48,49,19,15,3,6,221
140143415,43,43,47,42,22,13,5,3,218
140143416,47,57,56,32,33,15,7,2,249
140143417,36,44,39,38,30,7,0,2,196
140143418,58,84,63,73,51,21,5,8,363
140143419,44,37,43,40,17,11,4,6,202
140143501,27,50,63,59,39,12,4,7,261
140143502,57,84,82,99,57,33,9,9,430
140143503,28,53,44,41,29,13,3,2,213
140143504,46,99,82,88,54,26,2,6,403
140143505,13,29,36,53,36,13,4,2,186
140143506,88,166,150,172,112,87,25,50,850
140143507,39,91,60,72,35,33,14,10,354
140143508,28,51,54,81,32,19,4,9,278
140143509,34,48,48,50,34,18,3,5,240
140143510,41,66,47,49,17,11,4,3,238
140143511,43,76,61,69,45,21,6,7,328
140143512,36,67,64,59,45,25,6,3,305
140143513,31,66,52,46,31,27,11,4,268
140143514,47,85,91,88,41,27,4,2,385
140143601,33,68,57,49,23,9,3,3,245
140143602,29,56,60,51,23,9,3,2,233
140143603,49,82,71,81,33,20,4,13,353
140143604,31,92,68,63,38,13,3,3,311
140143605,54,72,63,56,39,21,4,4,313
140143606,36,59,56,55,23,15,3,3,250
140143607,41,72,61,59,24,4,1,0,262
140143608,34,76,58,56,28,11,4,1,268
140143609,41,62,50,47,20,4,2,1,227
140143610,36,48,44,35,25,8,5,1,202
140143611,44,76,46,39,29,14,6,5,259
140143612,31,87,60,37,24,11,1,2,253
140143613,32,65,47,52,29,9,0,0,234
140143614,22,48,58,44,24,11,0,1,208
140143701,86,75,71,100,38,30,7,14,421
140143702,29,48,34,38,21,11,6,6,193
140143703,43,44,45,49,33,24,3,2,243
140143704,40,61,45,46,33,18,8,9,260
140143705,43,62,54,43,32,14,8,10,266
140143706,25,53,62,62,38,24,11,14,289
140143707,44,58,60,60,38,22,13,8,303
140143708,56,79,64,57,44,22,2,6,330
140143709,54,74,34,35,27,11,3,2,240
140143710,34,52,43,43,30,18,9,4,233
140143711,63,112,84,82,43,31,6,7,428
140143712,41,60,39,41,34,18,4,7,244
140143713,47,77,41,35,23,13,1,4,241
140143714,48,47,32,37,24,11,6,2,207
140143715,51,59,35,38,17,12,2,3,217
140143716,35,54,39,35,16,9,1,3,192
140143717,49,52,44,43,17,8,1,1,215
140143718,37,47,31,31,15,4,1,0,166
140143719,42,67,54,27,15,4,4,3,216
140143720,50,62,39,38,9,6,4,1,209
140143721,40,37,22,30,17,10,5,2,163
140143801,77,87,73,56,50,20,5,11,379
140143802,59,98,62,66,30,16,4,4,339
140143803,71,101,65,57,36,10,4,2,346
140143804,74,73,60,49,32,14,2,4,308
140143805,40,63,47,42,22,15,6,0,235
140143806,55,70,43,57,21,5,2,1,254
140143807,44,85,48,39,25,5,1,4,251
140143808,57,92,70,70,42,20,7,10,368
140143809,59,54,55,49,20,13,3,1,254
140143810,79,91,66,52,20,7,3,1,319
140143811,60,80,55,34,23,6,2,0,260
140143812,23,65,50,38,26,16,4,3,225
140143813,66,92,49,50,23,12,4,1,297
140143814,83,90,64,38,18,5,2,0,300
140143815,52,71,53,44,20,5,3,0,248
140143816,48,80,41,31,21,8,0,2,231
140143901,35,51,29,27,16,9,5,5,177
140143902,98,91,70,52,34,10,8,14,377
140143903,109,121,59,37,13,4,2,0,345
140143904,51,76,51,24,14,10,3,0,229
140143905,42,59,40,30,12,2,3,3,191
140143906,45,57,41,44,24,8,0,1,220
140143907,38,43,47,35,15,21,6,7,212
140143908,79,81,48,29,13,9,2,0,261
140143909,77,84,50,47,14,9,2,3,286
140143910,102,78,46,20,10,3,0,1,260
140143911,77,85,45,20,11,4,1,0,243
140143912,91,107,54,39,15,14,2,2,324
140143913,32,51,33,31,17,6,4,5,179
140144001,59,72,58,40,15,6,1,0,251
140144002,50,69,39,28,23,7,4,3,223
140144003,43,56,49,40,22,13,5,3,231
140144004,29,59,43,36,18,8,1,6,200
140144005,35,36,24,40,14,2,4,3,158
140144006,60,63,25,19,6,5,0,0,178
140144007,60,57,46,35,23,10,10,6,247
140144008,71,80,66,51,22,17,7,8,322
140144009,77,60,45,32,14,3,4,2,237
140144010,89,72,64,38,31,15,2,4,315
140144011,38,54,59,35,16,15,2,5,224
140144012,81,55,38,53,18,9,2,2,258
140144101,72,72,40,41,19,11,2,0,257
140144102,67,53,40,27,16,7,0,0,210
140144103,58,120,63,35,35,7,1,1,320
140144104,44,55,35,39,17,4,0,1,195
140144105,56,62,49,24,15,7,0,1,214
140144106,54,60,53,35,32,8,0,2,244
140144107,39,69,51,40,16,5,0,2,222
140144108,38,44,33,18,20,4,1,3,161
140144109,42,67,50,36,17,6,4,0,222
140144110,62,87,70,45,21,4,2,0,291
140144111,39,54,40,38,25,12,1,1,210
140144112,60,79,59,66,21,15,1,2,303
140144113,57,86,60,56,27,4,4,0,294
140144114,54,90,66,59,30,7,4,0,310
140144115,56,80,53,45,23,6,0,0,263
140144116,32,64,28,33,27,11,2,1,198
140144117,41,64,55,59,24,13,4,1,261
140144118,80,80,56,26,11,2,0,1,256
140144119,27,58,38,54,33,6,1,0,217
140144201,21,63,36,34,21,12,3,3,193
140144202,22,45,26,26,9,7,1,3,139
140144203,31,47,21,16,16,6,2,0,139
140144204,28,55,26,40,20,5,3,1,178
140144205,31,57,36,37,16,8,3,1,189
140144206,29,67,61,36,23,10,3,0,229
140144207,41,76,54,51,32,15,4,2,275
140144208,51,108,76,72,47,24,2,0,380
140144209,40,66,46,33,11,5,1,0,202
140144210,27,48,47,40,20,9,2,2,195
140144211,35,64,60,48,29,7,3,0,246
140144212,46,75,64,47,27,13,3,2,277
140144213,33,60,47,44,27,10,4,1,226
140144214,34,77,79,70,30,10,2,3,305
140144215,27,52,49,37,27,6,3,0,201
140144216,28,80,79,72,42,18,1,1,321
140144217,28,77,59,49,18,10,4,0,245
140144218,24,51,59,54,52,19,12,11,282
140144219,42,60,80,80,40,16,2,1,321
140144220,41,73,72,79,34,17,7,4,327
140144301,43,67,74,86,36,15,5,4,330
140144302,45,99,97,96,51,30,23,12,453
140144303,29,60,65,75,48,33,14,12,336
140144304,42,42,62,76,53,29,21,28,353
140144305,16,26,42,41,15,19,8,8,175
140144306,76,74,77,85,59,38,27,15,451
140144307,24,48,72,66,42,31,6,17,306
140144308,41,65,80,61,50,48,19,19,383
140144309,27,58,65,83,57,40,10,13,353
140144310,26,53,38,55,26,19,8,1,226
140144311,39,63,56,69,32,15,5,1,280
140144401,194,177,92,49,19,5,3,0,539
140144402,32,48,52,56,35,25,5,6,259
140144403,27,58,74,56,39,24,6,9,293
140144404,31,60,44,37,21,14,1,0,208
140144405,27,65,50,40,22,14,4,3,225
140144406,41,116,111,125,64,20,6,4,487
140144407,51,102,70,83,38,16,3,3,366
140144408,29,65,39,45,19,10,1,0,208
140144409,25,52,51,58,44,32,7,14,283
140144410,46,57,47,52,40,10,2,5,259
140144411,45,86,84,108,64,23,10,4,424
140144501,54,63,64,69,52,40,17,14,373
140144502,59,85,106,95,67,52,15,23,502
140144503,44,62,56,46,33,11,10,9,271
140144504,38,101,65,62,38,15,7,5,331
140144505,57,64,66,81,33,17,0,0,318
140144506,88,82,57,45,16,6,3,1,298
140144507,47,75,63,79,39,27,3,3,336
140144508,49,57,76,65,25,13,2,1,288
140144509,30,68,68,92,50,16,5,1,330
140144510,57,102,80,71,46,22,8,9,395
140144511,33,62,60,71,31,16,7,5,285
140144512,28,66,68,61,35,13,4,3,278
140144513,37,51,47,41,15,6,1,2,200
140144601,45,50,51,54,40,14,7,15,276
140144602,59,92,80,59,40,32,12,7,381
140144603,40,75,63,56,27,22,5,8,296
140144604,35,50,36,39,18,21,8,7,214
140144605,42,42,57,46,28,18,8,6,247
140144606,50,58,59,51,28,22,5,8,281
140144607,42,48,52,36,40,23,6,3,250
140144608,52,47,49,45,22,14,3,3,235
140144609,50,60,60,56,46,22,5,14,313
140144610,49,75,66,55,38,18,20,10,331
140144611,76,79,105,70,37,25,14,5,411
140144612,80,107,55,52,24,12,6,6,342
140144613,35,40,22,16,19,11,2,5,150
140144614,52,93,67,67,44,17,10,9,359
140144615,61,87,51,59,24,22,12,4,320
140144616,45,49,64,53,41,19,11,9,291
140144701,33,50,27,28,12,5,3,0,158
140144702,48,58,44,22,19,5,2,5,203
140144703,85,83,51,40,27,19,1,4,310
140144704,41,48,33,18,9,7,2,0,158
140144705,49,63,43,22,10,3,1,1,192
140144706,72,58,33,31,20,11,2,2,229
140144707,58,69,60,45,34,12,4,4,286
140144708,81,97,60,49,22,17,3,1,330
140144709,54,66,35,17,16,13,2,1,204
140144710,57,58,37,27,7,4,2,0,192
140144711,46,75,49,42,16,13,7,2,250
140144712,142,139,81,52,19,10,1,2,446
140144801,64,63,29,13,3,2,0,0,174
140144802,106,85,37,29,9,2,1,0,269
140144803,114,92,48,19,7,2,0,0,282
140144804,93,75,55,11,5,3,0,2,244
140144805,67,69,48,35,9,7,2,0,237
140144806,51,69,49,27,18,4,1,0,219
140144807,91,91,61,45,15,4,0,1,308
140144808,77,64,38,31,10,5,2,1,228
140144809,33,55,36,23,10,4,0,1,162
140144810,82,121,52,43,28,6,2,1,335
140144811,98,80,40,24,7,4,3,1,257
140144812,66,79,50,32,12,0,0,0,239
140144813,96,84,29,26,18,12,0,1,266
140144814,44,85,51,26,20,10,0,2,238
140144815,113,134,66,45,19,11,0,1,389
140144816,93,65,56,36,8,6,2,2,268
140144901,34,37,31,23,8,13,1,1,148
140144902,56,44,33,22,8,7,5,0,175
140144903,28,30,37,29,17,2,3,2,148
140144904,60,45,33,35,25,5,2,0,205
140144905,52,63,45,39,12,5,0,3,219
140144906,34,45,19,27,11,8,1,3,148
140144907,103,94,65,51,19,21,0,2,355
140144908,64,76,67,42,28,16,6,4,303
140144909,113,115,51,35,7,1,0,0,322
140144910,48,64,24,6,3,1,1,1,148
140144911,46,32,23,14,4,3,0,2,124
140144912,54,54,36,23,7,4,1,1,180
140144913,117,139,39,29,13,4,0,2,343
140144914,72,73,50,25,10,1,0,1,232
140144915,78,87,44,27,10,3,2,1,252
140144916,126,136,45,28,11,1,0,0,347
140144917,73,62,8,8,1,0,1,0,153
140144918,74,56,16,11,3,0,0,1,161
140144919,85,78,39,14,2,0,0,0,218
140144920,77,60,35,19,6,2,0,0,199
140144921,120,95,53,18,8,2,1,0,297
140145001,73,88,56,50,11,8,2,2,290
140145002,49,86,58,56,29,10,4,1,293
140145003,50,62,31,37,19,9,2,3,213
140145004,50,55,50,40,18,12,4,6,235
140145005,50,61,41,36,18,9,1,2,218
140145006,54,56,41,33,14,12,0,1,211
140145007,79,88,56,36,15,5,3,2,284
140145008,53,70,52,37,18,12,4,0,246
140145009,105,105,69,50,18,9,1,1,358
140145010,63,59,55,40,29,8,2,2,258
140145011,65,81,50,35,14,6,5,3,259
140145012,61,68,31,43,21,3,1,0,228
140145013,38,52,48,37,14,6,1,0,196
140145014,54,82,47,32,16,4,4,2,241
140145015,59,83,54,40,23,10,2,4,275
140145101,55,79,45,48,26,11,4,1,269
140145102,63,69,51,41,28,5,3,2,262
140145103,34,63,45,29,20,10,1,1,203
140145104,49,69,47,46,35,19,5,7,277
140145105,45,63,48,44,29,12,3,4,248
140145106,49,86,57,73,32,15,9,5,326
140145107,34,81,68,62,43,21,9,2,320
140145108,48,64,45,52,27,20,4,8,268
140145109,45,78,65,51,45,18,0,10,312
140145110,35,49,54,47,31,14,2,5,237
140145111,42,66,41,40,35,15,8,3,250
140145112,36,90,79,59,45,23,2,6,340
140145113,39,82,69,51,39,22,2,4,308
140145114,38,63,46,56,31,18,10,6,268
140145115,26,26,37,44,28,25,10,8,204
140145116,30,27,31,24,25,18,4,5,164
140145117,56,66,58,90,51,28,19,9,377
140145118,45,73,52,55,32,16,2,7,282
140145119,52,63,69,71,46,36,15,7,359
140145120,62,94,98,93,80,52,24,29,532
140145121,41,39,48,41,40,26,8,15,258
140145201,51,65,50,37,16,3,0,0,222
140145202,71,73,75,76,23,12,4,6,340
140145203,42,51,56,40,21,12,7,3,232
140145204,60,70,88,65,65,39,15,19,421
140145205,36,39,40,20,17,7,1,1,161
140145206,40,53,45,31,15,5,1,1,191
140145207,34,65,49,43,21,7,1,3,223
140145208,41,50,42,53,17,4,4,2,213
140145209,33,48,46,38,14,5,1,2,187
140145210,30,43,44,37,13,11,1,3,182
140145211,24,35,26,36,18,17,5,2,163
140145212,41,44,45,64,44,35,14,12,299
140145213,45,51,51,46,27,16,7,5,248
140145214,45,66,52,39,25,8,4,3,242
140145215,26,40,43,32,30,12,5,9,197
140145216,26,58,50,51,29,22,10,7,253
140145217,27,40,38,45,31,21,15,14,231
140145218,29,40,51,68,47,35,16,29,315
140145219,36,43,67,49,40,35,10,16,296
140145301,73,77,46,24,15,7,1,0,243
140145302,54,70,41,37,14,5,1,0,222
140145303,33,34,26,27,16,4,0,0,140
140145304,28,46,38,32,13,7,1,0,165
140145305,47,63,25,26,18,3,0,0,182
140145306,83,97,50,29,8,5,1,0,273
140145307,44,74,37,41,17,5,2,0,220
140145308,55,78,62,63,18,16,5,5,302
140145309,51,62,36,40,23,9,2,2,225
140145310,76,78,69,39,19,4,0,0,285
140145311,64,75,41,41,22,6,1,1,251
140145312,34,61,43,47,16,6,1,0,208
140145313,48,56,36,32,10,5,3,0,190
140145314,64,60,27,24,15,1,1,1,193
140145315,120,118,61,28,7,4,0,0,338
140145316,31,40,36,29,16,7,1,1,161
140145317,28,44,40,37,17,5,2,1,174
140145318,45,51,43,40,22,4,0,1,206
140145319,38,45,48,49,20,11,0,0,211
140145320,29,41,27,27,11,4,1,1,141
140145401,65,55,35,12,9,1,0,4,181
140145402,62,85,33,14,8,2,1,0,205
140145403,73,85,26,20,6,5,0,1,216
140145404,83,75,34,13,5,2,0,0,212
140145405,60,39,28,9,5,3,0,0,144
140145406,85,117,49,23,5,1,0,0,280
140145407,73,59,15,6,3,1,0,0,157
140145408,79,76,20,14,4,1,0,0,194
140145409,104,80,42,20,4,2,0,0,252
140145410,55,63,24,16,11,3,1,0,173
140145411,48,40,20,4,2,0,0,0,114
140145412,84,90,31,12,2,1,1,2,223
140145413,227,142,32,22,4,0,1,0,428
140145414,129,94,24,6,2,2,0,0,257
140145415,122,92,20,8,1,1,0,0,244
140145416,94,79,16,5,3,0,0,0,197
140145501,68,74,42,30,10,3,0,0,227
140145502,110,58,32,22,5,3,1,0,231
140145503,59,35,15,10,2,4,0,0,125
140145504,59,33,18,10,1,0,1,0,122
140145505,54,49,18,15,5,2,1,0,144
140145506,46,39,17,4,0,0,0,0,106
140145507,67,52,24,3,3,0,1,0,150
140145508,31,8,13,3,1,1,0,0,57
140145509,109,45,9,5,1,0,0,0,169
140145510,80,47,17,11,2,1,0,0,158
140145511,93,76,27,11,4,5,1,0,217
140145512,64,50,28,11,1,1,0,0,155
140145513,66,41,14,6,1,0,0,0,128
140145514,56,51,18,17,7,2,0,0,151
140145515,70,11,7,1,2,0,0,0,91
140145516,105,60,26,9,1,1,0,0,202
140145517,172,125,32,11,0,1,0,1,342
140145518,50,42,23,11,7,0,2,1,136
140145519,130,96,35,19,5,0,0,0,285
140145601,105,75,18,8,6,4,0,1,217
140145602,87,73,30,21,6,2,0,0,219
140145603,121,63,17,18,5,1,0,1,226
140145604,60,59,22,13,5,1,1,0,161
140145605,44,62,27,12,8,4,2,1,160
140145606,68,32,27,14,7,1,0,0,149
140145607,57,55,11,4,1,0,0,2,130
140145608,55,34,20,9,3,0,1,0,122
140145609,42,58,21,10,3,4,0,0,138
140145610,38,37,7,4,3,0,0,0,89
140145611,119,99,36,12,9,3,1,0,279
140145612,69,22,15,5,1,1,0,0,113
140145613,60,58,15,7,3,2,0,0,145
140145614,75,33,7,9,2,0,0,0,126
140145615,55,43,15,11,5,0,0,0,129
140145616,56,48,28,11,2,0,0,0,145
140145617,76,61,26,11,4,1,0,0,179
140145618,91,71,41,10,2,1,0,0,216
140145619,73,51,28,12,1,0,0,0,165
140145701,181,108,59,32,3,0,0,0,383
140145702,100,76,28,13,8,1,1,0,227
140145703,107,87,34,12,7,1,0,0,248
140145704,207,112,55,20,4,1,0,0,399
140145705,66,51,22,10,2,1,0,0,152
140145706,53,43,10,5,2,0,0,0,113
140145707,113,60,17,2,0,2,0,0,194
140145708,25,30,8,6,2,0,0,0,71
140145709,63,46,16,10,2,2,0,1,140
140145710,82,46,13,7,6,1,0,0,155
140145711,69,65,21,12,5,0,0,0,172
140145712,61,59,9,5,1,0,0,0,135
140145713,101,89,28,7,6,1,0,0,232
140145714,130,99,26,3,3,1,0,0,262
140145715,155,106,36,10,3,0,1,0,311
140145716,61,36,5,2,2,1,0,0,107
140145801,61,49,17,6,2,1,0,2,138
140145802,111,100,38,21,6,3,1,2,282
140145803,63,51,29,15,3,3,1,0,165
140145804,96,72,32,15,5,1,1,0,222
140145805,114,82,42,28,9,4,1,0,280
140145806,123,86,44,22,12,4,1,0,292
140145807,93,62,28,10,3,2,1,1,200
140145808,181,90,14,12,2,2,0,0,301
140145809,133,74,33,13,5,4,0,1,263
140145810,49,38,21,8,5,0,1,0,122
140145811,140,104,32,21,3,1,1,0,302
140145812,139,90,33,9,3,0,1,0,275
140145813,32,31,15,10,2,1,0,0,91
140145901,72,81,76,48,15,8,4,1,305
140145902,73,44,19,9,8,3,0,0,156
140145903,116,99,43,21,6,1,0,2,288
140145904,113,78,48,22,4,6,2,0,273
140145905,100,79,35,18,9,4,0,2,247
140145906,94,88,29,14,6,1,0,0,232
140145907,85,73,32,12,11,4,1,0,218
140145908,44,39,22,12,4,0,0,1,122
140145909,120,58,39,15,6,2,0,0,240
140145910,99,66,22,16,8,3,0,0,214
140145911,54,71,28,19,7,0,3,0,182
140145912,64,118,56,53,29,3,1,1,325
140146001,65,79,59,47,21,11,3,6,291
140146002,57,75,44,39,15,8,5,3,246
140146003,48,61,40,38,14,8,2,1,212
140146004,72,80,60,49,26,11,1,1,300
140146005,113,105,62,43,28,10,4,1,366
140146006,69,70,43,43,20,11,3,1,260
140146007,70,67,37,34,13,7,2,1,231
140146008,63,58,34,22,7,4,2,0,190
140146009,91,96,42,24,12,4,1,1,271
140146010,72,62,46,27,10,5,2,2,226
140146011,106,108,67,59,23,12,2,1,378
140146012,52,45,33,19,7,5,2,0,163
140146013,56,73,35,38,13,5,0,0,220
140146014,104,108,54,60,30,11,2,1,370
140146015,80,101,66,50,24,13,1,0,335
140146016,46,75,42,57,20,8,5,3,256
140146017,65,89,65,57,39,15,7,1,338
140146018,75,103,66,47,15,4,6,1,317
140146101,45,62,42,51,46,32,14,19,311
140146102,35,60,50,40,37,27,11,20,280
140146103,17,41,52,42,35,28,13,15,243
140146104,27,29,47,41,33,21,14,14,226
140146105,51,35,50,66,41,43,14,22,322
140146106,18,38,53,51,34,19,13,4,230
140146107,17,26,58,45,40,35,12,21,254
140146108,27,33,68,55,40,39,13,9,284
140146109,19,53,54,49,36,17,4,7,239
140146110,24,46,45,40,36,24,9,7,231
140146111,20,37,64,56,41,29,11,16,274
140146112,46,54,83,115,68,47,28,19,460
140146113,30,42,74,67,64,50,15,31,373
140146114,27,31,46,49,37,50,1,9,250
140146115,20,48,57,63,59,32,13,30,322
140146201,26,79,62,59,26,15,7,4,278
140146202,65,71,59,42,30,12,4,0,283
140146203,50,73,52,45,31,12,10,1,274
140146204,43,36,47,49,30,9,3,2,219
140146205,28,60,48,38,26,8,3,5,216
140146206,25,47,60,85,28,8,3,2,258
140146207,31,48,52,40,36,17,10,9,243
140146208,38,57,52,61,34,23,5,1,271
140146209,63,94,74,59,24,17,7,2,340
140146210,49,74,71,60,31,23,3,9,320
140146211,30,64,102,96,63,43,18,18,434
140146212,31,54,62,69,51,30,4,17,318
140146213,31,66,59,49,35,20,4,8,272
140146301,37,59,41,46,22,8,0,2,215
140146302,37,70,42,43,21,7,1,3,224
140146303,51,55,46,36,16,7,2,2,215
140146304,47,50,48,40,27,13,5,4,234
140146305,67,103,81,72,33,14,5,0,375
140146306,52,80,72,66,22,13,3,5,313
140146307,53,89,56,43,27,12,3,2,285
140146308,48,77,60,56,26,13,6,3,289
140146309,39,63,68,57,31,17,2,3,280
140146310,29,52,51,49,28,7,1,2,219
140146311,42,45,35,51,16,12,3,2,206
140146312,37,35,38,30,20,9,6,2,177
140146313,34,58,38,56,22,16,3,0,227
140146401,51,56,35,44,17,5,2,2,212
140146402,111,126,67,47,30,10,4,1,396
140146403,112,112,41,28,10,1,2,0,306
140146404,118,120,41,25,12,7,2,2,327
140146405,106,70,33,26,16,10,1,1,263
140146406,65,76,41,17,9,5,2,1,216
140146407,72,106,72,68,23,11,1,2,355
140146408,67,81,71,51,25,12,2,2,311
140146409,62,80,72,66,29,8,4,5,326
140146410,44,94,64,71,32,21,7,7,340
140146411,50,57,54,60,29,14,9,5,278
140146501,70,67,36,25,12,5,0,0,215
140146502,102,116,45,41,9,6,2,1,322
140146503,104,67,24,10,6,3,1,0,215
140146504,67,59,20,7,6,2,0,1,162
140146505,42,79,38,34,16,1,2,0,212
140146506,67,90,58,33,18,6,1,3,276
140146507,36,40,39,31,9,11,5,3,174
140146508,56,54,18,12,9,2,1,1,153
140146509,40,54,33,36,16,7,4,1,191
140146510,38,59,40,27,15,6,1,2,188
140146511,40,73,62,53,21,21,4,12,286
140146512,60,104,59,45,20,8,8,3,307
140146513,33,38,35,39,17,15,2,9,188
140146514,56,105,93,76,37,18,10,13,408
140146515,16,34,41,28,25,8,1,2,155
140146516,59,74,79,41,28,22,2,5,310
140146601,156,118,50,19,7,2,0,0,352
140146602,194,119,64,26,10,1,0,0,414
140146603,75,46,15,8,1,0,1,0,146
140146604,101,88,33,8,2,1,0,0,233
140146605,96,66,15,12,3,0,1,0,193
140146606,110,79,30,8,2,0,0,0,229
140146607,113,89,25,11,4,3,0,0,245
140146608,33,28,12,2,2,0,0,0,77
140146609,98,79,30,9,4,1,0,1,222
140146610,93,52,15,3,0,0,0,0,163
140146611,70,45,12,4,2,0,1,0,134
140146612,83,86,23,17,7,1,0,0,217
140146613,90,56,20,6,3,2,0,0,177
140146614,143,154,55,11,2,1,0,3,369
140146701,97,72,30,10,4,1,0,0,214
140146702,43,32,18,6,1,0,0,0,100
140146703,165,117,48,17,12,0,0,0,359
140146704,86,58,18,2,4,2,0,0,170
140146705,94,83,26,3,5,0,0,2,213
140146706,138,106,40,17,3,4,0,0,308
140146707,106,80,12,4,0,0,0,0,202
140146708,114,102,26,12,3,0,0,0,257
140146709,139,94,25,11,2,2,0,0,273
140146710,116,83,22,7,4,1,0,0,233
140146711,227,157,67,15,4,0,2,0,472
140146801,118,55,11,5,4,0,0,0,193
140146802,55,52,17,9,3,3,0,0,139
140146803,177,109,22,7,2,1,0,0,318
140146804,199,163,46,25,2,2,1,0,438
140146805,53,53,8,3,3,0,0,0,120
140146806,93,91,39,23,6,3,0,0,255
140146807,72,52,22,9,6,0,0,0,161
140146808,45,29,11,3,1,0,0,0,89
140146809,134,100,29,6,3,2,1,1,276
140146810,98,81,21,8,2,1,0,0,211
140146811,45,38,17,7,8,3,0,0,118
140146812,67,53,27,14,9,5,2,4,181
140146813,30,35,22,16,6,3,0,2,114
140146814,120,97,51,26,9,5,2,1,311
140146901,111,89,19,8,2,1,0,0,230
140146902,71,40,16,2,1,0,0,0,130
140146903,121,68,12,8,3,1,0,2,215
140146904,94,91,16,15,1,1,0,0,218
140146905,121,75,37,24,8,6,0,0,271
140146906,57,71,46,22,17,9,2,6,230
140146907,54,61,38,19,20,11,3,2,208
140146908,73,62,42,35,21,16,4,7,260
140146909,47,59,37,14,9,4,0,0,170
140146910,47,49,33,22,18,9,3,7,188
140146911,198,161,59,31,13,5,3,4,474
140146912,76,71,27,8,2,1,0,0,185
140146913,39,36,9,1,0,0,0,0,85
140146914,173,149,24,7,0,1,0,0,354
140147001,148,113,26,9,1,0,0,0,297
140147002,125,101,35,17,2,0,0,0,280
140147003,148,138,48,11,5,1,0,0,351
140147004,90,70,24,8,2,0,1,0,195
140147005,173,118,32,9,6,2,0,0,340
140147006,156,145,39,8,1,0,0,0,349
140147007,123,103,22,3,2,1,0,0,254
140147008,124,111,33,8,1,0,0,0,277
140147009,108,101,26,5,1,0,0,0,241
140147010,189,126,24,6,0,0,0,0,345
140147011,97,87,22,9,2,0,0,0,217
140147101,78,67,18,7,5,1,1,0,177
140147102,188,144,34,10,2,2,1,1,382
140147103,120,106,41,13,5,1,0,0,286
140147104,197,128,41,8,1,1,0,0,376
140147105,147,120,17,5,2,0,0,0,291
140147106,175,149,28,11,3,1,0,0,367
140147107,206,153,49,17,1,1,0,1,428
140147108,109,107,31,8,1,0,0,0,256
140147109,210,188,40,7,1,0,0,0,446
140147110,204,152,33,17,3,0,0,0,409
140147111,119,101,29,13,5,0,0,0,267
140147201,299,229,67,27,4,0,0,0,626
140147202,298,280,96,36,5,2,0,0,717
140147203,329,255,57,19,2,0,0,0,662
140147204,243,236,77,23,2,0,0,0,581
140147205,107,117,26,8,1,0,0,0,259
140147206,289,218,61,15,4,0,0,0,587
140147207,375,256,53,9,4,1,0,0,698
140147301,35,52,43,37,30,16,1,7,221
140147302,42,44,45,39,24,14,4,3,215
140147303,34,41,35,33,34,14,2,3,196
140147304,47,72,51,35,24,10,1,3,243
140147305,38,57,51,37,23,12,3,2,223
140147306,61,72,42,49,25,14,4,2,269
140147307,27,63,25,22,19,21,9,1,187
140147308,45,57,53,35,20,9,3,3,225
140147309,64,78,64,52,29,15,4,4,310
140147310,41,46,41,31,22,10,1,1,193
140147311,64,64,47,29,10,8,6,1,229
140147312,49,55,40,35,18,8,1,2,208
140147313,49,53,36,50,23,8,3,1,223
140147401,31,49,60,72,44,30,12,16,314
140147402,33,38,49,45,48,38,5,8,264
140147403,25,39,38,46,24,24,12,9,217
140147404,28,59,43,46,18,13,9,7,223
140147405,37,52,46,51,34,16,10,3,249
140147406,43,70,78,71,44,23,15,17,361
140147407,32,55,59,69,33,22,7,9,286
140147408,47,53,58,55,48,24,9,8,302
140147409,39,63,46,49,30,11,7,5,250
140147410,47,73,51,41,30,16,1,3,262
140147411,41,57,66,83,41,29,9,14,340
140147412,53,99,55,60,32,29,7,6,341
140147413,57,54,52,39,27,8,4,3,244
140147414,43,78,62,53,32,14,2,1,285
140147415,48,73,72,57,33,16,6,7,312
140147416,33,65,41,31,30,11,3,6,220
140147417,49,72,54,42,30,11,3,0,261
140147418,48,76,59,39,24,12,5,1,264
140147501,24,46,74,53,42,42,16,39,336
140147502,26,51,37,41,41,23,15,19,253
140147503,44,48,45,40,39,31,13,15,275
140147504,28,33,33,49,31,27,16,21,238
140147505,19,25,43,49,35,32,18,22,243
140147506,31,54,57,57,46,48,13,18,324
140147507,26,49,53,70,46,45,22,24,335
140147508,16,49,37,59,37,23,17,15,253
140147509,20,41,62,73,70,30,9,19,324
140147510,42,73,72,73,44,33,11,9,357
140147511,41,72,76,75,35,28,11,7,345
140147512,38,49,66,58,30,34,14,12,301
140147513,48,72,99,75,74,39,17,24,448
140147514,41,77,72,85,63,51,24,28,441
140147515,58,71,98,76,49,39,23,10,424
140147516,39,53,58,53,32,28,10,11,284
140147517,50,67,83,64,32,19,7,12,334
140147518,35,27,39,55,57,40,23,33,309
140147519,31,53,68,98,75,58,27,34,444
140147601,61,85,98,78,60,18,11,11,422
140147602,33,65,86,64,29,21,4,6,308
140147603,26,46,43,57,37,25,7,6,247
140147604,43,63,46,64,39,15,11,10,291
140147605,45,61,59,37,55,20,12,6,295
140147606,38,69,115,153,97,75,21,26,594
140147607,22,58,64,42,50,24,11,8,279
140147608,29,54,51,54,34,21,6,5,254
140147609,35,60,64,73,42,20,11,9,314
140147610,44,80,61,54,38,17,2,2,298
140147611,46,68,55,53,27,14,15,9,287
140147612,26,55,65,81,49,30,11,12,329
140147613,29,56,40,50,33,16,5,7,236
140147614,42,58,52,62,41,31,9,4,299
140147615,28,44,49,54,38,24,4,3,244
140147616,36,51,71,85,54,43,15,25,380
140147617,35,45,63,73,57,27,18,32,350
140147701,63,74,76,62,49,14,3,7,348
140147702,37,46,53,56,28,16,3,5,244
140147703,36,70,45,50,25,12,1,2,241
140147704,43,63,49,60,29,20,1,2,267
140147705,35,64,61,70,39,20,5,1,295
140147706,34,77,55,50,31,22,5,1,275
140147707,65,99,68,64,45,12,4,3,360
140147708,38,69,52,54,47,10,3,1,274
140147709,47,64,58,54,31,7,3,1,265
140147710,33,75,71,56,38,12,0,1,286
140147711,37,59,41,43,25,14,2,2,223
140147712,30,57,62,54,37,18,5,10,273
140147713,74,68,79,67,38,47,12,20,405
140147714,24,42,55,57,34,17,13,9,251
140147715,44,54,59,54,44,22,18,10,305
140147716,34,51,61,46,30,10,5,4,241
140147717,38,64,49,88,39,23,9,12,322
140147718,45,60,64,38,26,5,2,1,241
140147719,15,28,52,52,53,44,8,29,281
140147720,40,62,65,81,42,36,10,4,340
140147721,35,36,36,33,24,19,8,11,202
140147722,29,50,58,53,50,23,14,9,286
140147801,67,77,83,55,30,22,5,9,348
140147802,34,44,38,34,16,8,5,7,186
140147803,39,60,42,40,32,16,4,5,238
140147804,34,51,51,47,28,22,8,5,246
140147805,35,54,47,49,33,15,5,4,242
140147806,18,32,39,21,17,5,2,4,138
140147807,44,78,71,58,34,9,5,1,300
140147808,51,61,76,42,33,10,3,2,278
140147809,38,72,69,59,32,23,7,11,311
140147810,49,80,71,58,27,13,1,3,302
140147811,68,98,89,81,31,9,4,0,380
140147812,40,82,62,70,30,13,1,0,298
140147813,30,45,54,45,23,8,1,1,207
140147814,146,153,65,44,11,5,2,0,426
140147815,37,59,41,30,14,1,0,2,184
140147816,27,59,42,39,17,4,6,2,196
140147901,40,84,63,54,37,14,1,5,298
140147902,57,82,74,38,21,10,6,2,290
140147903,43,55,47,40,28,10,0,0,223
140147904,36,63,33,48,20,4,1,3,208
140147905,44,69,52,40,11,7,4,2,229
140147906,59,80,67,60,32,8,3,0,309
140147907,49,91,74,59,33,16,4,3,329
140147908,47,56,42,50,23,7,3,1,229
140147909,81,119,78,50,25,13,8,5,379
140147910,40,62,55,34,28,11,6,8,244
140147911,44,86,51,56,32,24,11,4,308
140147912,30,41,34,30,25,14,9,4,187
140147913,40,49,50,55,34,25,3,15,271
140147914,25,43,37,30,29,12,10,9,195
140147915,50,66,68,68,57,13,14,10,346
140147916,48,67,51,51,36,17,5,3,278
140147917,54,74,56,65,21,9,2,2,283
140147918,51,57,56,46,24,16,1,5,256
140147919,47,48,57,45,45,9,5,2,258
140147920,64,64,54,53,20,10,1,1,267
140148001,120,91,22,9,3,2,0,0,247
140148002,114,72,23,9,3,2,0,0,223
140148003,76,94,15,2,2,1,0,0,190
140148004,93,76,15,4,2,0,0,0,190
140148005,114,104,34,10,4,2,0,0,268
140148006,171,150,35,19,4,0,1,0,380
140148007,81,47,12,11,3,1,0,1,156
140148008,69,52,14,14,2,2,0,1,154
140148009,99,74,22,12,2,2,0,0,211
140148010,115,88,28,5,3,0,0,0,239
140148011,40,50,35,40,26,11,5,2,209
140148012,28,57,36,24,20,12,1,3,181
140148013,29,40,30,21,12,7,0,1,140
140148014,20,18,21,32,22,19,5,4,141
140148101,131,98,30,4,0,1,0,0,264
140148102,189,118,17,15,1,0,1,0,341
140148103,309,224,49,10,6,0,0,0,598
140148104,242,238,56,12,2,0,0,0,550
140148105,242,218,49,15,2,2,0,0,528
140148106,315,268,77,12,5,3,0,0,680
140148107,89,105,29,9,1,0,0,1,234
140148108,120,103,30,9,3,1,1,0,267
140148109,100,107,30,8,3,1,0,0,249
140148110,66,64,25,21,13,4,1,2,196
140148201,154,107,39,11,4,0,0,0,315
140148202,215,161,24,10,1,2,0,1,414
140148203,148,117,43,12,2,0,0,0,322
140148204,245,201,62,22,7,1,2,0,540
140148205,111,71,26,4,1,0,0,0,213
140148206,65,65,13,9,0,0,0,0,152
140148207,169,149,30,5,1,0,0,0,354
140148208,273,234,80,17,8,4,2,1,619
140148209,116,130,52,12,1,0,2,0,313
140148210,64,95,24,7,3,2,1,0,196
140148211,96,90,24,6,1,2,0,0,219
140148301,53,76,52,52,27,10,5,3,278
140148302,53,67,57,68,30,14,5,6,300
140148303,41,74,55,54,23,22,3,6,278
140148304,53,55,38,37,21,10,6,10,230
140148305,46,62,45,40,15,13,3,1,225
140148306,29,37,37,35,23,14,4,4,183
140148307,48,96,59,49,31,22,5,6,316
140148308,19,40,34,39,22,17,4,6,181
140148309,110,106,70,24,14,11,3,1,339
140148310,90,65,27,21,11,1,2,1,218
140148311,35,43,36,58,34,16,9,5,236
140148312,41,54,53,46,39,20,15,10,278
140148313,38,57,52,37,27,14,11,6,242
140148314,38,50,44,51,41,21,6,9,260
140148315,26,42,44,39,19,18,3,3,194
140148316,27,47,34,34,13,5,2,2,164
140148401,40,74,74,59,37,10,1,3,298
140148402,38,79,50,59,40,9,8,4,287
140148403,55,61,67,49,27,8,4,5,276
140148404,26,46,36,50,23,11,1,2,195
140148405,29,77,64,66,35,17,3,2,293
140148406,26,39,49,44,24,2,1,2,187
140148407,24,51,35,35,20,8,0,2,175
140148408,38,66,54,35,26,8,3,4,234
140148409,34,64,52,54,23,15,4,3,249
140148410,37,66,47,48,24,9,2,0,233
140148411,34,72,54,44,22,8,5,4,243
140148412,41,91,57,38,22,8,1,1,259
140148501,29,71,53,57,32,16,7,5,270
140148502,46,61,51,40,19,8,5,0,230
140148503,32,56,44,49,24,9,3,2,219
140148504,32,73,63,55,29,12,3,2,269
140148505,51,80,73,52,32,15,8,0,311
140148506,52,82,79,58,43,11,3,2,330
140148507,56,56,45,39,25,12,4,3,240
140148508,56,96,77,83,49,33,6,13,413
140148509,29,63,95,99,59,27,12,18,402
140148510,26,72,76,59,56,22,13,16,340
140148511,25,60,81,70,58,32,12,16,354
140148512,31,50,63,63,45,29,19,6,306
140148513,47,72,49,80,47,31,11,11,348
140148514,43,74,79,78,45,20,3,11,353
140148515,42,59,39,34,24,16,0,2,216
140148516,45,86,60,57,28,12,2,1,291
140148601,17,24,39,43,25,27,15,26,216
140148602,20,21,29,33,27,32,3,3,168
140148603,27,39,47,54,38,33,13,10,261
140148604,22,50,48,66,54,42,9,26,317
140148605,40,57,63,75,59,34,23,17,368
140148606,26,38,58,75,50,40,11,15,313
140148607,30,56,68,90,57,26,8,14,349
140148608,24,33,54,52,50,21,14,16,264
140148609,28,41,40,46,36,45,16,13,265
140148610,41,64,65,86,68,33,16,14,387
140148611,29,41,44,48,30,30,8,6,236
140148612,29,53,48,48,33,20,12,11,254
140148701,49,65,67,63,37,25,2,6,314
140148702,47,69,59,51,35,13,2,3,279
140148703,21,33,32,45,34,14,4,8,191
140148704,25,46,47,47,32,22,4,5,228
140148705,48,70,92,93,58,30,7,10,408
140148706,31,50,41,47,24,18,4,5,220
140148707,23,52,46,49,32,25,6,13,246
140148708,29,58,92,75,63,80,1,3,401
140148709,22,36,38,49,23,26,6,6,206
140148710,31,38,57,69,38,13,7,9,262
140148711,26,35,58,67,53,24,17,12,292
140148712,32,48,69,57,30,40,7,10,293
140148713,34,26,30,35,29,18,3,2,177
140148801,42,61,47,50,23,11,6,2,242
140148802,35,70,79,59,30,20,6,2,301
140148803,41,67,57,61,36,16,4,4,286
140148804,56,56,60,42,30,15,2,3,264
140148805,21,33,35,19,10,6,4,2,130
140148806,27,72,88,59,22,11,3,6,288
140148807,46,76,64,53,43,11,5,4,302
140148808,45,81,41,43,25,20,4,1,260
140148809,36,66,64,48,33,16,2,2,267
140148810,41,58,68,62,35,13,4,0,281
140148811,44,88,91,78,47,21,7,5,381
140148812,28,51,74,58,44,16,7,10,288
140148813,22,54,66,66,55,27,9,2,301
140148814,34,36,71,69,73,40,16,20,359
140148815,28,54,78,109,42,17,2,1,331
140148901,38,81,61,36,21,11,3,2,253
140148902,35,53,43,37,20,8,1,1,198
140148903,85,116,84,59,32,12,4,4,396
140148904,51,104,80,67,43,19,3,0,367
140148905,29,67,58,43,21,9,1,0,228
140148906,62,79,59,66,35,16,1,4,322
140148907,33,42,54,69,38,20,3,1,260
140148908,32,59,48,46,15,15,3,4,222
140148909,42,77,46,59,31,14,3,4,276
140148910,15,39,55,61,41,13,5,3,232
140148911,5,35,45,40,40,14,10,9,198
140148912,20,43,58,45,41,22,6,13,248
140148913,34,40,55,82,29,14,4,5,263
140148914,23,36,45,66,36,14,5,3,228
140148915,49,88,106,73,37,17,5,2,377
140148916,59,69,95,104,62,43,14,10,456
140149001,127,54,43,27,12,10,1,7,281
140149002,47,82,52,31,30,9,1,4,256
140149003,26,47,34,38,16,15,5,11,192
140149004,37,54,33,41,20,11,1,0,197
140149005,28,62,45,46,25,13,6,8,233
140149006,27,55,69,60,36,32,11,16,306
140149007,43,68,76,76,43,19,14,9,348
140149008,35,71,48,25,23,6,2,0,210
140149009,45,93,58,30,21,8,4,2,261
140149010,28,47,36,36,18,4,6,0,175
140149011,38,51,39,43,22,16,5,4,218
140149012,52,48,55,55,45,21,8,11,295
140149013,39,53,59,73,55,35,21,19,354
140149014,37,68,50,40,25,14,7,3,244
140149015,40,72,56,54,33,9,4,3,271
140149101,46,96,93,85,38,19,3,4,384
140149102,53,68,67,73,34,10,4,1,310
140149103,43,65,51,53,24,16,0,3,255
140149104,59,82,86,78,33,15,6,4,363
140149105,39,77,61,46,18,14,8,15,278
140149106,86,104,69,36,30,15,2,4,346
140149107,100,113,39,49,18,10,0,1,330
140149108,71,104,59,43,14,4,0,0,295
140149109,59,64,38,20,11,4,0,0,196
140149110,99,95,67,33,17,9,1,2,323
140149111,82,92,55,43,15,15,3,3,308
140149112,80,86,74,47,24,8,2,7,328
140149113,41,86,59,54,31,18,7,3,299
140149114,83,102,88,77,37,20,4,9,420
140149115,54,86,69,47,34,11,2,3,306
140149116,43,58,57,46,18,19,4,1,246
140149117,23,70,60,56,40,8,7,1,265
140149118,46,83,64,68,28,12,5,3,309
140149119,44,87,76,60,26,17,1,1,312
140149120,67,68,44,32,16,6,0,1,234
140149201,93,97,48,40,28,6,3,0,315
140149202,49,39,42,20,13,6,2,3,174
140149203,36,47,39,36,16,3,0,1,178
140149204,24,44,52,65,42,14,8,5,254
140149205,49,69,49,48,30,14,4,6,269
140149206,40,59,51,51,27,16,3,2,249
140149207,34,36,37,41,15,17,5,4,189
140149208,33,46,50,31,19,14,4,5,202
140149209,74,92,53,34,23,15,3,3,297
140149210,80,68,46,41,17,3,2,1,258
140149211,87,84,47,33,24,14,3,3,295
140149212,85,100,64,43,21,15,2,1,331
140149213,30,54,42,26,13,6,1,0,172
140149214,52,93,71,57,28,11,1,1,314
140149215,58,76,41,35,24,11,1,0,246
140149216,67,74,66,41,31,11,2,0,292
140149217,49,85,62,53,31,12,6,2,300
140149218,91,71,36,14,5,1,0,1,219
140149301,35,61,53,49,24,9,3,5,239
140149302,31,75,52,48,30,10,2,2,250
140149303,54,84,71,65,40,25,6,6,351
140149304,57,105,92,74,55,27,6,9,425
140149305,45,54,51,65,28,22,3,4,272
140149306,56,76,81,47,56,26,5,14,361
140149307,21,41,57,66,58,17,8,13,281
140149308,55,99,82,93,49,23,6,5,412
140149309,30,59,70,56,32,11,2,2,262
140149310,51,87,68,72,40,22,8,1,349
140149311,49,83,87,70,53,35,17,9,403
140149312,53,87,86,93,58,27,6,3,413
140149313,33,52,50,50,26,11,5,2,229
140149314,34,43,38,32,13,5,3,2,170
140149315,39,51,48,53,29,24,6,5,255
140149316,33,74,50,44,24,13,4,4,246
140149317,52,84,86,86,66,28,14,19,435
140149318,57,75,80,64,16,10,1,3,306
140149319,29,69,68,81,35,26,6,10,324
140149320,11,36,38,41,24,9,0,4,163
140149321,41,62,66,66,34,18,0,1,288
140149401,35,57,74,75,46,13,8,7,315
140149402,34,68,51,50,51,24,6,4,288
140149403,34,48,45,38,34,9,6,10,224
140149404,38,52,79,83,68,48,31,36,435
140149405,23,62,76,75,60,30,8,12,346
140149406,21,68,53,59,39,22,8,9,279
140149407,42,74,75,82,53,48,18,24,416
140149408,29,50,75,93,73,57,22,31,430
140149409,26,48,63,68,53,30,12,12,312
140149410,19,41,56,63,39,21,7,12,258
140149411,21,45,43,64,44,36,10,12,275
140149412,22,48,54,70,47,38,10,11,300
140149413,21,36,48,53,52,32,10,10,262
140149414,18,31,38,39,34,18,18,11,207
140149501,36,56,51,47,23,12,4,4,233
140149502,36,77,58,36,28,7,1,1,244
140149503,25,46,52,40,23,10,4,5,205
140149504,25,43,51,63,56,32,13,26,309
140149505,11,37,63,78,53,33,21,19,315
140149506,16,58,47,60,54,35,18,12,300
140149507,23,32,51,54,38,39,19,22,278
140149508,29,65,70,69,53,31,17,26,360
140149509,29,64,56,57,46,18,3,1,274
140149510,58,77,76,73,41,12,4,3,344
140149511,26,35,60,49,33,26,11,12,252
140149512,27,44,66,62,60,46,24,40,369
140149513,25,50,83,82,62,37,19,15,373
140149514,25,76,90,89,55,22,15,14,386
140149601,33,45,61,59,23,13,2,2,238
140149602,37,51,49,36,30,12,5,7,227
140149603,44,68,68,72,43,25,7,9,336
140149604,32,86,72,60,39,28,6,8,331
140149605,26,47,49,65,31,20,4,7,249
140149606,32,45,46,43,20,12,5,11,214
140149607,31,60,42,39,25,9,6,5,217
140149608,45,68,70,49,40,13,4,8,297
140149609,31,42,46,73,51,17,3,4,267
140149610,34,67,65,80,45,22,5,7,325
140149611,29,57,62,52,36,19,1,4,260
140149612,32,55,70,83,52,17,5,4,318
140149613,18,62,81,94,61,14,2,4,336
140149614,32,60,45,45,31,18,4,3,238
140149615,39,53,50,41,22,14,3,7,229
140149616,35,56,70,75,50,39,14,12,351
140149617,28,67,95,113,66,44,16,19,448
140149701,35,57,77,73,77,56,20,53,448
140149702,27,28,40,34,27,15,16,10,197
140149703,20,20,60,76,35,15,4,4,234
140149704,12,47,37,39,22,14,8,8,187
140149705,26,39,58,54,36,17,2,2,234
140149706,28,68,77,89,56,45,26,22,411
140149707,30,55,60,69,48,44,9,16,331
140149708,49,56,92,83,38,39,19,24,400
140149709,46,77,79,75,44,37,26,24,408
140149710,30,64,59,74,45,26,21,14,333
140149711,37,51,61,89,57,41,20,17,373
140149712,29,40,49,59,41,21,8,17,264
140149713,15,28,41,45,29,14,8,18,198
140149714,59,82,96,100,64,30,24,17,472
140149715,41,61,67,50,45,33,13,15,325
140149716,33,51,60,52,38,26,14,21,295
140149717,67,70,72,85,66,46,24,39,469
140149801,29,68,69,57,31,15,5,8,282
140149802,56,72,93,71,26,27,10,15,370
140149803,22,36,48,50,32,21,12,12,233
140149804,38,37,53,42,30,18,12,15,245
140149805,20,24,28,26,35,18,10,5,166
140149806,45,48,38,48,34,29,6,8,256
140149807,53,65,75,81,74,37,18,11,414
140149808,26,44,43,56,28,26,10,7,240
140149809,55,67,65,65,41,30,3,8,334
140149810,26,44,42,38,22,18,8,15,213
140149811,34,39,51,50,31,22,8,4,239
140149812,17,42,44,61,27,26,10,13,240
140149813,44,77,78,94,63,42,10,14,422
140149901,31,74,63,71,44,32,5,9,329
140149902,55,71,55,73,50,23,6,4,337
140149903,54,75,69,77,43,21,5,3,347
140149904,28,62,42,50,31,18,0,4,235
140149905,29,45,57,53,21,21,2,2,230
140149906,42,64,64,41,54,34,5,3,307
140149907,32,45,46,47,33,21,6,3,233
140149908,48,75,83,92,59,29,21,14,421
140149909,36,55,66,82,40,31,8,4,322
140149910,29,61,75,68,52,33,7,8,333
140149911,17,28,34,42,30,23,8,9,191
140149912,15,44,50,51,35,29,8,7,239
140149913,39,83,89,109,56,36,17,15,444
140210101,9,6,5,1,3,1,0,0,25
140210102,6,7,4,6,2,2,1,0,28
140210103,10,14,12,6,6,2,0,2,52
140210104,22,25,17,19,11,12,2,4,112
140210105,14,16,14,10,10,4,3,3,74
140210106,37,43,38,28,20,5,3,3,177
140210107,31,48,29,30,4,8,2,4,156
140210108,36,50,21,18,15,10,2,4,156
140210109,36,46,41,23,11,14,3,5,179
140210110,23,31,22,26,10,4,3,0,119
140210201,3,2,5,3,2,1,0,0,16
140210202,7,9,4,1,1,2,0,2,26
140210203,4,6,1,3,0,1,0,1,16
140210204,9,14,9,10,8,1,0,0,51
140210205,19,10,18,20,9,10,6,5,97
140210206,14,28,16,17,8,1,3,0,87
140210207,25,47,28,36,5,9,1,1,152
140210208,15,41,16,7,13,6,1,1,100
140210209,48,55,35,38,14,9,1,1,201
140210210,21,33,20,27,7,8,1,4,121
140210211,22,25,15,18,5,2,1,0,88
140210212,29,30,28,17,11,8,0,2,125
140210213,31,22,21,27,23,8,4,10,146
140210301,2,9,17,10,5,1,2,2,48
140210302,25,23,27,22,10,12,0,3,122
140210303,22,39,33,44,29,15,5,4,191
140210304,18,47,46,47,31,20,8,8,225
140210305,17,35,22,23,17,6,3,3,126
140210306,16,20,17,30,12,6,4,5,110
140210307,5,11,8,9,9,2,0,0,44
140210308,17,24,20,22,16,3,4,2,108
140210309,30,36,26,37,19,12,3,11,174
140210310,17,24,28,18,11,4,2,4,108
140210311,18,29,20,24,21,7,3,3,125
140210312,10,28,23,23,14,10,5,3,116
140210313,16,17,19,15,12,12,3,5,99
140210314,26,39,50,57,43,32,15,13,275
140210315,23,37,40,59,36,33,13,9,250
140210316,18,23,28,49,39,35,10,12,214
140210401,12,27,18,16,16,3,1,0,93
140210402,21,13,10,20,12,6,0,1,83
140210403,9,16,21,26,14,14,1,11,112
140210404,9,24,18,21,14,5,3,3,97
140210405,9,16,13,15,18,9,3,3,86
140210406,48,57,57,51,34,17,7,6,277
140210407,44,55,62,56,41,21,9,6,294
140210408,10,16,19,16,14,7,4,2,88
140210409,43,60,81,93,53,30,6,3,369
140210410,24,49,60,59,40,18,6,10,266
140210501,10,5,6,5,7,9,0,3,45
140210502,6,20,24,19,13,5,0,0,87
140210503,4,0,3,1,3,2,0,0,13
140210504,10,15,11,11,11,4,0,2,64
140210505,6,11,13,10,4,5,3,3,55
140210506,3,10,27,37,30,9,4,1,121
140210507,12,32,39,76,42,13,3,2,219
140210508,11,37,46,84,38,15,1,2,234
140210601,15,20,11,11,2,6,0,1,66
140210602,5,7,2,6,1,1,2,2,26
140210603,1,9,5,4,3,1,1,0,24
140210604,8,14,3,15,7,2,0,0,49
140210605,11,18,13,18,15,7,2,6,90
140210606,5,3,3,1,3,1,0,2,18
140210607,8,16,7,6,9,2,2,6,56
140210608,27,43,57,57,23,23,9,13,252
140210609,40,71,62,61,36,13,5,2,290
140210610,27,37,37,28,24,14,6,2,175
140210611,42,67,83,91,67,38,16,13,417
140210612,53,67,82,82,61,15,3,8,371
140210613,25,45,57,69,36,22,2,3,259
140210614,55,72,72,106,63,28,15,7,418
140210615,31,77,76,100,65,29,22,16,416
140210616,30,59,68,82,37,24,10,8,318
140210701,11,8,14,9,6,8,2,4,62
140210702,31,26,41,30,27,13,3,7,178
140210703,7,26,21,18,7,6,0,4,89
140210704,12,24,35,29,30,19,9,12,170
140210705,40,53,59,73,59,47,17,24,372
140210706,18,38,58,74,64,23,16,14,305
140210707,23,32,53,51,56,32,23,19,289
140210708,20,24,42,74,55,25,26,11,277
140210709,18,29,45,56,41,30,8,16,243
140210710,18,27,31,54,32,19,10,9,200
140210711,19,44,49,63,22,31,5,15,248
140210712,10,31,41,57,23,19,10,9,200
140210713,10,14,12,8,6,7,0,2,59
140210714,20,14,22,31,24,21,11,21,164
140210715,19,32,49,56,43,32,11,24,266
140210716,19,20,26,34,29,10,9,9,156
140210801,7,9,2,15,2,5,1,2,43
140210802,23,19,24,30,22,21,7,6,152
140210803,9,19,32,49,85,137,5,12,348
140210804,24,53,59,63,41,29,16,18,303
140210805,24,47,61,78,40,37,14,12,313
140210806,9,13,18,25,23,17,4,9,118
140210807,50,57,54,73,57,36,24,20,371
140210808,19,20,46,58,43,26,11,10,233
140210809,42,54,82,71,57,44,19,27,396
140210810,29,38,57,62,36,15,11,10,258
140210811,24,39,48,46,35,20,10,9,231
140210812,21,28,43,62,40,17,9,11,231
140210813,22,39,39,56,49,35,11,12,263
140210814,17,29,40,51,55,32,21,24,269
140210901,34,50,58,41,33,20,1,5,242
140210902,35,62,60,52,27,11,8,5,260
140210903,26,39,41,60,36,11,2,1,216
140210904,23,47,39,47,33,6,2,0,197
140210905,45,46,44,33,12,5,2,2,189
140210906,34,63,69,51,30,15,6,7,275
140210907,57,60,36,32,12,8,0,0,205
140210908,44,59,38,21,12,5,1,0,180
140210909,45,47,44,30,20,12,4,2,204
140210910,53,48,65,56,26,23,6,11,288
140210911,64,98,100,61,46,20,7,7,403
140210912,29,50,51,45,13,9,5,2,204
140210913,71,65,69,61,26,8,3,3,306
140210914,52,89,76,64,30,7,7,0,325
140211001,48,61,93,94,49,26,7,6,384
140211002,47,75,61,55,20,8,4,4,274
140211003,73,91,69,51,26,6,3,2,321
140211004,75,86,74,68,42,14,6,7,372
140211005,26,47,58,44,37,17,6,5,240
140211006,27,64,73,81,41,23,5,3,317
140211007,19,28,49,33,28,13,2,1,173
140211008,53,86,53,43,38,18,4,6,301
140211009,43,82,52,31,22,9,0,1,240
140211010,61,92,71,53,29,7,2,3,318
140211011,54,72,77,63,54,40,8,15,383
140211012,20,81,93,101,66,51,12,17,441
140211013,26,56,66,82,64,35,15,26,370
140211014,28,71,100,113,67,24,15,4,422
140211015,5,25,14,38,24,13,3,4,126
140211016,14,26,52,56,45,20,10,9,232
140211101,26,41,49,53,30,18,8,6,231
140211102,23,40,53,52,28,24,16,18,254
140211103,21,42,47,47,25,11,3,4,200
140211104,26,42,52,67,38,11,5,2,243
140211105,46,82,62,43,18,12,2,0,265
140211106,20,32,22,18,14,4,1,4,115
140211107,23,57,65,59,28,14,6,4,256
140211108,43,51,49,79,21,14,7,4,268
140211109,38,71,78,95,66,22,8,4,382
140211110,20,37,35,46,32,10,3,0,183
140211111,18,48,45,56,29,7,4,4,211
140211112,61,84,76,99,43,14,7,2,386
140211113,37,54,70,68,33,10,8,1,281
140211114,22,41,42,53,40,18,5,2,223
140211115,19,63,54,44,21,12,3,0,216
140211116,38,50,53,42,27,8,3,1,222
140211117,36,77,57,62,27,4,2,1,266
140211118,54,74,82,78,36,18,7,2,351
140211119,42,77,65,61,32,14,5,4,300
140211201,32,47,34,44,16,11,0,4,188
140211202,25,33,28,32,23,12,5,6,164
140211203,39,56,54,61,39,15,4,6,274
140211204,40,56,52,36,23,12,4,3,226
140211205,30,60,54,48,30,13,3,7,245
140211206,38,48,57,44,27,13,3,1,231
140211207,25,46,49,32,22,12,7,4,197
140211208,24,48,20,21,19,3,1,3,139
140211209,34,35,24,21,15,6,1,1,137
140211210,50,72,50,54,18,6,2,4,256
140211211,46,57,58,53,27,14,1,4,260
140211212,11,32,47,44,21,22,5,5,187
140211213,37,48,32,38,22,9,2,10,198
140211214,55,67,55,45,24,17,1,3,267
140211301,42,55,46,53,24,16,2,4,242
140211302,30,36,29,27,13,17,3,2,157
140211303,51,41,34,42,28,9,2,1,208
140211304,36,38,36,38,19,9,3,2,181
140211305,61,70,63,53,28,18,7,4,304
140211306,38,57,40,42,20,7,3,3,210
140211307,23,32,39,37,21,16,2,3,173
140211308,60,73,72,63,47,17,10,9,351
140211309,35,41,39,27,22,18,6,4,192
140211310,59,54,44,46,18,13,2,2,238
140211311,53,64,37,31,11,5,2,0,203
140211312,36,59,46,36,18,9,3,0,207
140211313,67,79,56,27,23,8,0,0,260
140211314,52,77,59,54,23,7,0,6,278
140211401,43,53,42,37,28,5,1,4,213
140211402,29,59,29,32,6,11,0,0,166
140211403,60,59,40,33,12,4,1,0,209
140211404,47,73,66,51,38,10,3,2,290
140211405,44,60,61,59,40,14,5,2,285
140211406,30,45,54,42,31,20,8,15,245
140211407,62,95,81,69,41,18,3,5,374
140211408,28,58,33,37,27,12,5,6,206
140211409,37,45,36,44,25,12,1,4,204
140211410,37,64,48,48,28,18,2,2,247
140211411,38,61,56,62,39,22,7,7,292
140211412,32,41,37,50,32,16,10,6,224
140211501,54,47,47,33,17,10,1,3,212
140211502,50,70,44,41,23,18,4,6,256
140211503,22,39,48,49,29,13,3,7,210
140211504,49,79,53,49,23,9,2,2,266
140211505,40,55,48,34,21,6,4,4,212
140211506,48,81,56,60,25,11,2,2,285
140211507,21,51,52,53,24,20,1,4,226
140211508,22,17,27,21,12,8,2,3,112
140211509,27,29,38,37,23,7,4,4,169
140211510,37,38,40,42,24,12,5,5,203
140211511,41,62,34,43,17,9,3,0,209
140211601,31,53,57,59,38,21,10,8,277
140211602,81,84,82,67,40,29,6,4,393
140211603,41,44,46,41,31,11,2,2,218
140211604,24,37,46,56,36,26,8,16,249
140211605,25,41,30,53,36,19,23,13,240
140211606,29,44,33,45,42,21,14,9,237
140211607,45,67,52,48,28,14,6,5,265
140211608,54,62,44,41,18,17,4,5,245
140211609,43,50,41,39,22,14,7,7,223
140211610,37,37,40,45,31,18,9,6,223
140211611,37,53,64,82,46,35,16,14,347
140211701,17,46,46,64,33,16,2,3,227
140211702,21,35,57,62,31,11,1,2,220
140211703,14,41,42,70,30,9,3,0,209
140211704,18,42,38,66,44,11,4,1,224
140211705,27,42,32,51,24,12,4,2,194
140211706,54,76,55,67,44,18,6,8,328
140211707,18,44,41,97,69,28,2,0,299
140211708,30,70,75,129,80,31,3,3,421
140211709,32,52,75,112,82,46,10,9,418
140211710,40,56,63,82,48,29,2,1,321
140211801,39,50,43,70,19,5,3,4,233
140211802,23,29,40,44,36,23,8,14,217
140211803,24,31,50,45,23,13,6,3,195
140211804,66,91,53,47,22,10,1,2,292
140211805,39,83,61,63,34,13,3,2,298
140211806,24,35,45,40,37,18,4,12,215
140211807,24,37,48,46,34,28,11,17,245
140211808,32,29,37,42,40,35,16,27,258
140211809,20,45,67,63,37,26,12,12,282
140211810,43,67,62,63,41,19,5,5,305
140211811,48,51,37,43,26,23,2,2,232
140211812,67,95,83,74,41,12,4,9,385
140211813,43,73,74,90,49,35,11,17,392
140211814,36,60,60,43,22,3,0,3,227
140211815,46,82,63,69,50,12,4,4,330
140211816,40,63,72,64,50,12,5,13,319
140211901,21,47,46,56,45,19,1,3,238
140211902,83,49,34,54,35,13,8,7,283
140211903,26,39,42,36,20,10,4,1,178
140211904,13,32,25,40,33,17,1,1,162
140211905,15,30,25,48,49,18,13,2,200
140211906,32,60,41,36,13,12,4,2,200
140211907,21,46,31,35,23,7,4,3,170
140211908,10,28,38,44,20,13,4,1,158
140211909,14,32,40,84,56,22,5,1,254
140211910,38,64,65,70,50,19,5,5,316
140211911,31,71,61,65,36,15,2,6,287
140211912,15,34,51,51,23,18,6,5,203
140211913,17,37,41,57,42,15,2,5,216
140212001,21,25,35,33,25,21,12,10,182
140212002,19,21,35,38,29,19,6,9,176
140212003,32,60,63,59,46,29,11,16,316
140212004,22,23,59,50,35,24,13,14,240
140212005,33,40,60,68,50,30,10,16,307
140212006,14,29,31,33,35,31,10,20,203
140212007,20,41,49,69,43,27,19,25,293
140212008,26,46,39,49,35,21,12,5,233
140212009,27,36,42,39,24,14,12,13,207
140212010,25,37,37,42,30,19,7,18,215
140212011,12,49,52,42,19,9,2,0,185
140212012,58,62,50,49,20,8,2,2,251
140212013,33,43,55,50,34,15,5,3,238
140212014,31,50,70,80,52,30,12,16,341
140212015,56,80,59,63,32,13,3,3,309
140212016,24,41,37,43,26,9,8,2,190
140212017,20,44,39,41,28,10,5,7,194
140212018,23,37,48,61,41,35,16,12,273
140212101,9,57,44,76,48,16,5,2,257
140212102,22,36,29,51,22,14,7,8,189
140212103,21,29,27,44,22,23,11,7,184
140212104,7,14,12,10,7,4,0,1,55
140212105,39,57,48,57,29,21,9,12,272
140212106,37,45,73,68,33,17,8,11,292
140212107,30,43,55,50,20,14,4,3,219
140212108,31,42,52,39,30,13,3,3,213
140212109,24,52,40,46,20,17,6,4,209
140212110,29,46,48,69,50,39,14,16,311
140212111,13,19,22,19,8,5,2,4,92
140212112,25,31,29,23,22,16,4,7,157
140212113,20,49,54,55,46,25,12,13,274
140212114,10,37,33,49,29,12,11,11,192
140212115,25,41,36,45,24,10,6,5,192
140212116,31,51,61,72,46,19,8,6,294
140212117,36,39,31,33,16,10,6,2,173
140212118,36,67,61,88,43,40,15,19,369
140212119,15,58,46,49,12,2,0,0,182
140212120,15,56,50,51,16,1,0,1,190
140280101,4,6,8,0,3,2,1,1,25
140280102,17,34,23,28,10,10,5,16,143
140280103,25,21,24,12,6,6,1,3,98
140280104,42,44,54,31,38,22,6,13,250
140280105,24,32,34,20,15,18,9,14,166
140280106,16,11,11,5,5,7,2,14,71
140280107,7,3,4,0,6,1,4,1,26
140280108,17,18,19,17,13,11,4,4,103
140280109,28,37,24,51,24,18,12,12,206
140280110,12,20,54,107,92,82,7,12,386
140280111,42,58,45,43,31,17,12,14,262
140280201,53,54,68,74,52,55,15,40,411
140280202,40,54,51,42,36,27,8,9,267
140280203,32,45,42,58,44,28,11,13,273
140280204,53,61,87,96,75,58,5,13,448
140280205,27,50,51,39,20,14,7,15,223
140280206,40,59,36,35,18,7,3,3,201
140280207,49,63,47,28,20,7,4,3,221
140280208,44,67,62,61,43,27,12,21,337
140280209,59,82,47,40,40,24,6,6,304
140280210,40,38,48,38,43,13,6,10,236
140280211,58,74,83,59,40,23,11,11,359
140280212,46,85,72,54,38,21,6,7,329
140280213,50,65,53,55,44,30,10,14,321
140280214,46,72,61,59,41,16,11,8,314
140280215,33,73,67,78,53,26,17,15,362
140280216,53,63,71,81,51,34,10,14,377
140280301,34,45,52,52,45,24,18,26,296
140280302,34,65,57,69,33,46,8,14,326
140280303,44,67,67,56,45,32,5,8,324
140280304,56,81,83,59,45,28,5,8,365
140280305,57,73,63,61,51,21,7,10,343
140280306,53,75,51,36,19,3,0,3,240
140280307,50,78,55,39,13,11,4,5,255
140280308,78,59,41,33,13,5,0,3,232
140280309,70,98,40,47,25,14,7,2,303
140280310,37,64,54,56,37,31,8,7,294
140280311,36,54,43,57,37,30,26,21,304
140280312,28,22,25,41,32,16,2,9,175
140280401,7,9,2,1,0,1,1,3,24
140280402,25,21,11,16,11,7,5,5,101
140280403,8,6,8,11,14,58,2,3,110
140280404,26,28,15,15,11,9,8,7,119
140280405,11,14,13,7,8,10,6,9,78
140280406,33,26,38,45,23,8,6,18,197
140280407,30,32,35,37,33,16,9,21,213
140280408,34,33,41,32,24,25,11,11,211
140280409,45,45,46,38,35,33,6,20,268
140280410,27,25,55,37,25,31,9,14,223
140280501,31,15,15,16,23,44,2,17,163
140280502,23,23,18,19,22,12,7,10,134
140280503,13,12,7,7,2,3,4,0,48
140280504,25,34,20,18,8,4,4,3,116
140280505,36,37,40,39,38,27,13,19,249
140280506,34,34,50,59,36,41,15,18,287
140280507,36,34,46,47,45,41,10,16,275
140280508,33,47,49,52,21,56,3,6,267
140280509,49,61,45,39,13,9,4,3,223
140280510,44,47,43,52,21,15,4,5,231
140280511,7,24,32,58,36,38,10,13,218
140280512,30,33,42,37,30,22,10,13,217
140280513,34,46,40,46,19,16,8,5,214
140280514,69,74,84,82,44,21,11,9,394
140280515,26,21,22,12,12,5,7,9,114
140280601,5,3,2,3,4,3,1,0,21
140280602,24,25,18,15,8,2,1,2,95
140280603,35,41,34,16,5,5,4,5,145
140280604,8,9,9,8,9,6,4,3,56
140280605,5,4,3,1,1,4,0,1,19
140280606,54,58,33,38,8,2,2,3,198
140280607,71,56,60,46,28,11,7,3,282
140280701,9,13,12,10,4,4,3,1,56
140280702,15,10,8,10,6,5,0,4,58
140280703,12,5,5,5,1,2,1,1,32
140280704,3,3,3,1,2,0,0,1,13
140280705,7,7,4,4,2,0,0,0,24
140280706,20,20,11,9,6,7,3,3,79
140350101,6,6,6,0,1,0,0,0,19
140350102,6,2,2,2,0,1,0,1,14
140350103,7,19,7,7,5,4,0,1,50
140350104,14,7,5,1,2,2,0,0,31
140350105,3,6,4,7,1,2,1,0,24
140350106,12,9,10,10,1,2,1,1,46
140350107,20,26,31,25,7,6,3,2,120
140350108,78,71,62,61,57,20,8,8,365
140350109,45,75,66,50,45,10,5,3,299
140350110,27,39,49,40,32,14,7,16,224
140350201,5,5,8,6,3,1,0,0,28
140350202,11,9,5,7,1,1,0,0,34
140350203,8,3,4,3,2,1,0,0,21
140350204,5,3,3,1,5,0,1,0,18
140350205,7,6,3,3,1,0,0,0,20
140350206,18,23,21,23,5,8,4,1,103
140350207,9,2,2,5,3,1,1,0,23
140350208,3,8,7,3,8,3,0,3,35
140350209,9,5,4,3,1,0,0,0,22
140350210,51,31,41,37,22,14,6,4,206
140350211,40,36,36,47,29,17,5,7,217
140350212,86,101,81,56,28,10,0,1,363
140350213,61,91,72,75,33,8,3,3,346
140350214,60,66,68,51,21,8,5,1,280
140350215,61,75,67,59,32,15,4,7,320
140350301,8,6,7,7,6,4,0,0,38
140350302,5,2,5,3,2,1,0,0,18
140350303,13,14,19,20,13,3,1,1,84
140350304,12,22,15,12,8,4,1,0,74
140350305,18,21,15,9,8,7,1,0,79
140350306,12,14,19,8,10,4,0,0,67
140350307,54,42,28,32,21,7,1,2,187
140350308,7,15,5,8,3,1,4,0,43
140350309,20,10,7,3,4,1,0,2,47
140350310,32,47,30,24,18,8,1,4,164
140350311,55,65,58,63,30,18,7,4,300
140350312,55,96,49,49,19,8,2,3,281
140350313,40,60,51,55,35,11,0,4,256
140350314,34,46,45,57,36,8,2,1,229
140350315,62,71,61,59,26,9,6,1,295
140350316,67,82,56,43,13,6,3,2,272
140350317,87,100,73,58,30,13,4,6,371
140350318,79,96,75,66,31,13,8,3,371
140350401,3,13,4,3,4,0,1,0,28
140350402,21,11,11,6,7,1,1,0,58
140350403,14,20,14,16,8,1,0,0,73
140350404,30,49,53,36,23,19,2,6,218
140350405,39,66,48,40,30,22,5,12,262
140350406,48,69,72,73,48,13,8,9,340
140350407,51,83,56,52,16,10,2,1,271
140350408,46,58,31,38,14,2,1,0,190
140350409,41,56,51,59,18,8,5,0,238
140350410,57,47,34,36,22,7,1,0,204
140350411,60,54,23,34,9,8,0,0,188
140350412,66,55,50,45,25,18,4,3,266
140350413,55,61,55,36,26,6,5,4,248
140350414,53,55,57,52,33,33,8,4,295
140350415,26,41,83,65,37,19,15,5,291
140350501,4,8,0,1,0,0,0,0,13
140350502,18,10,11,4,2,1,0,0,46
140350503,14,11,3,3,3,0,0,0,34
140350504,14,14,6,7,5,0,0,1,47
140350505,11,8,7,5,4,2,0,1,38
140350506,5,8,12,5,4,2,0,0,36
140350507,6,1,5,4,0,0,1,0,17
140350508,35,47,53,48,30,14,4,1,232
140350509,35,56,35,43,19,14,4,7,213
140350510,35,54,48,28,34,11,6,5,221
140350511,61,63,58,43,19,11,2,2,259
140350512,67,78,96,71,41,15,5,8,381
140350513,64,83,66,43,18,13,2,3,292
140350514,18,35,47,49,31,13,10,2,205
140420101,8,12,5,5,5,5,1,1,42
140420102,4,4,7,6,6,0,2,1,30
140420103,7,10,20,6,10,4,0,2,59
140420104,5,7,4,10,6,2,1,1,36
140420105,17,15,16,26,10,4,4,4,96
140420106,5,8,6,8,4,8,1,1,41
140420107,9,6,16,14,10,4,2,3,64
140420108,16,16,16,9,11,8,3,6,85
140420109,51,86,66,75,55,14,5,2,354
140420110,51,80,38,36,18,9,0,1,233
140420111,45,69,70,48,38,14,2,2,288
140420112,28,37,26,15,16,11,0,0,133
140420201,3,9,5,5,7,4,1,1,35
140420202,4,12,18,19,10,0,0,1,64
140420203,12,4,10,7,6,6,2,1,48
140420204,3,7,7,4,2,5,0,3,31
140420205,12,18,22,20,6,8,1,3,90
140420206,5,4,6,5,5,3,1,1,30
140420207,8,13,6,10,1,5,0,1,44
140420208,19,28,19,22,21,10,6,5,130
140420209,19,18,31,18,18,12,2,8,126
140420210,41,58,55,35,19,8,4,5,225
140420301,21,16,20,15,16,6,3,0,97
140420302,8,14,14,18,10,6,5,5,80
140420303,3,16,16,8,6,6,2,1,58
140420304,8,11,10,15,6,1,1,1,53
140420305,4,10,18,15,6,3,0,0,56
140420306,3,1,3,1,2,0,0,0,10
140420307,17,39,32,34,21,17,2,3,165
140420308,32,39,37,31,22,16,5,5,187
140420309,58,67,44,59,29,14,1,5,277
140420310,56,69,49,85,41,14,10,2,326
140420311,57,75,49,43,28,11,2,1,266
140420312,23,39,24,15,13,2,2,3,121
140420313,92,136,75,67,38,8,5,1,422
140420314,72,106,88,66,40,13,6,3,394
140420401,31,55,68,83,47,23,7,6,320
140420402,52,64,47,45,19,8,3,4,242
140420403,40,59,51,44,27,8,5,3,237
140420404,73,101,87,66,44,13,2,3,389
140420405,80,104,80,67,36,6,3,1,377
140420406,41,72,61,89,46,14,3,4,330
140420407,42,63,83,80,35,18,10,7,338
140420408,47,68,77,64,42,13,7,7,325
140420409,38,54,51,58,36,22,8,4,271
140420410,59,65,70,37,37,12,6,6,292
140420411,64,90,76,59,28,10,7,5,339
140420412,48,67,62,65,28,20,4,4,298
140420413,43,68,85,71,44,24,6,8,349
140420414,46,36,47,38,40,23,6,6,242
140420415,43,55,86,80,57,38,16,13,388
140420416,29,44,55,49,17,15,1,1,211
140420417,21,35,50,49,34,22,6,8,225
140420418,12,42,56,93,48,27,5,8,291
140420419,19,39,47,49,31,5,6,4,200
140420501,3,4,7,6,3,2,0,1,26
140420502,0,6,3,9,5,0,1,0,24
140420503,5,8,1,5,2,1,0,0,22
140420504,9,8,9,7,5,3,1,1,43
140420505,4,8,2,6,5,3,1,1,30
140420506,4,5,8,8,6,2,0,0,33
140420507,7,5,8,6,10,2,1,1,40
140420508,13,17,11,20,13,2,3,1,80
140420509,1,9,10,18,10,5,1,1,55
140420510,33,40,30,34,24,6,7,2,176
140420511,42,47,27,33,15,5,3,3,175
140420512,45,28,45,46,30,20,3,5,222
140420513,40,50,47,35,24,6,8,4,214
140420514,62,63,48,60,26,7,1,1,268
140420515,33,42,42,29,25,9,5,2,187
140420516,34,68,30,30,19,14,2,0,197
140420517,56,75,58,52,40,18,10,9,318
140420601,49,53,47,34,34,32,6,10,265
140420602,50,58,51,33,29,18,1,3,243
140420603,53,87,71,58,43,18,6,5,341
140420604,82,90,64,46,21,5,1,0,309
140420605,88,91,49,38,18,10,1,0,295
140420606,83,113,76,37,18,5,2,3,337
140420607,90,68,38,32,9,5,0,0,242
140420608,98,134,85,65,26,11,4,1,424
140420609,63,93,62,58,19,6,2,2,305
140420610,58,76,35,19,13,2,2,1,206
140420611,90,118,46,27,12,5,1,2,301
140420612,65,43,35,22,8,3,1,1,178
140420613,105,101,56,23,13,3,0,1,302
140420614,87,97,59,32,20,2,0,0,297
140420615,35,55,57,66,46,34,8,16,317
140420616,56,77,81,98,49,18,1,2,382
140420617,81,86,60,46,16,7,1,1,298
140420618,48,54,34,36,18,10,1,3,204
140420619,55,56,32,22,9,3,1,0,178
140420620,72,56,30,10,7,1,2,0,178
140420621,42,91,80,126,57,16,3,1,416
140420701,57,77,79,71,48,28,7,10,377
140420702,66,76,68,59,29,16,7,4,325
140420703,71,101,78,78,46,17,7,10,408
140420704,87,91,59,32,19,6,0,0,294
140420705,111,106,81,44,20,8,3,1,374
140420706,70,71,50,39,21,4,0,2,257
140420707,81,94,54,53,22,7,1,1,313
140420708,70,83,64,52,32,8,1,1,311
140420709,68,85,72,67,27,26,1,2,348
140420710,47,58,67,68,45,30,10,19,344
140420711,47,109,130,170,80,28,13,10,587
140420712,42,67,51,49,22,12,6,7,256
140420713,49,54,64,42,23,14,2,1,249
140420714,43,50,33,22,14,4,2,0,168
140420715,34,48,60,70,72,22,13,20,339
140420801,79,67,40,24,11,3,1,0,225
140420802,56,54,24,17,9,0,1,0,161
140420803,107,106,44,37,22,6,4,2,328
140420804,60,63,28,16,6,3,0,0,176
140420805,100,88,54,39,12,7,2,0,302
140420806,62,74,49,32,21,6,2,0,246
140420807,75,96,53,36,15,5,2,1,283
140420808,58,65,39,32,14,4,1,1,214
140420809,55,99,50,47,16,13,1,0,281
140420810,83,105,76,51,22,10,2,0,349
140420811,71,67,38,38,8,6,0,0,228
140420812,70,117,55,53,22,8,2,0,327
140420813,34,67,35,33,6,1,1,0,177
140420814,80,69,49,29,18,7,2,0,254
140420815,31,67,60,67,30,24,4,8,291
140420816,35,50,48,55,38,27,9,14,276
140420817,48,67,31,23,16,7,0,0,192
140420818,35,87,55,60,32,7,2,0,278
140420819,49,81,91,92,54,27,10,12,416
140420820,68,80,28,16,8,2,3,0,205
140420821,51,69,35,16,6,6,0,1,184
140420822,28,47,47,48,17,6,0,3,196
140420823,39,77,46,42,23,11,2,2,242
140420901,17,34,64,40,46,23,5,9,238
140420902,70,76,61,56,26,13,2,1,305
140420903,54,80,53,42,14,6,1,2,252
140420904,23,44,51,63,32,15,6,8,242
140420905,27,56,70,107,40,9,1,2,312
140420906,41,52,87,71,53,10,4,2,320
140420907,29,56,36,51,22,12,2,0,208
140420908,56,65,30,35,13,4,3,0,206
140420909,101,114,82,50,22,9,0,2,380
140420910,46,53,50,28,23,7,0,1,208
140420911,65,58,35,25,11,5,0,1,200
140420912,36,44,21,9,9,1,1,2,123
140420913,74,71,52,41,16,3,3,0,260
140420914,130,89,48,38,18,3,1,1,328
140420915,63,82,43,43,14,6,1,1,253
140420916,41,70,48,85,34,10,0,0,288
140420917,45,58,47,52,28,14,4,2,250
140420918,51,71,44,44,18,6,3,0,237
140420919,33,80,55,64,29,20,6,2,289
140420920,35,62,51,59,23,13,5,8,256
140420921,34,54,60,52,35,17,12,4,268
140420922,65,67,29,24,10,4,0,1,200
140420923,58,65,35,16,8,4,1,2,189
140420924,56,67,40,36,12,2,0,0,213
140420925,71,63,40,30,13,3,0,1,221
140421001,11,10,8,11,4,2,2,4,52
140421002,9,6,12,9,2,5,2,1,46
140421003,0,3,0,0,0,0,0,0,3
140421004,4,6,8,2,1,1,2,3,27
140421005,7,8,9,7,3,5,0,0,39
140421006,3,3,6,7,4,2,0,1,26
140421007,6,6,4,4,5,1,0,1,27
140421008,64,59,36,36,23,5,1,2,226
140421009,46,70,53,56,25,12,7,6,275
140421010,38,52,36,54,27,21,5,3,236
140421011,45,52,25,35,16,8,2,1,184
140421012,81,63,54,46,25,4,5,0,278
140421013,54,45,37,44,24,11,1,0,216
140421014,46,46,41,40,25,12,2,1,213
140421015,50,89,50,54,17,9,0,1,270
140421016,71,93,53,65,46,14,6,2,350
140421101,33,42,46,62,32,11,3,2,231
140421102,28,69,56,44,20,4,3,0,224
140421103,15,62,61,60,43,12,5,0,258
140421104,28,68,64,39,32,14,2,5,252
140421105,53,61,62,86,46,13,3,1,325
140421106,24,47,46,46,29,11,11,5,219
140421107,44,62,80,103,76,38,23,12,438
140421108,47,91,89,82,47,28,10,7,401
140421109,42,86,59,81,61,21,8,6,364
140421110,55,72,64,61,29,7,0,1,289
140421111,46,59,62,69,37,9,7,1,290
140421112,51,70,61,70,29,10,1,2,294
140421113,34,60,41,40,16,9,1,2,203
140490101,10,15,6,3,2,3,1,0,40
140490102,16,13,6,3,4,2,1,1,46
140490103,12,13,7,14,3,3,4,6,62
140490104,8,9,2,8,4,1,3,2,37
140490105,13,10,8,11,6,2,1,0,51
140490106,5,5,4,2,2,2,1,2,23
140490107,9,4,4,4,1,1,0,2,25
140490108,18,10,6,4,8,3,8,2,59
140490109,34,25,14,8,6,13,4,5,109
140490110,6,2,2,1,4,0,1,2,18
140490111,14,16,15,33,23,10,10,9,130
140490112,24,29,17,16,15,10,3,8,122
140490113,57,54,55,53,39,24,13,20,315
140490114,39,54,47,36,20,18,11,6,231
140490115,13,24,23,37,30,22,14,19,182
140490116,68,54,69,63,35,29,19,24,361
140490201,25,28,24,38,36,22,7,20,200
140490202,13,5,12,6,1,3,4,1,45
140490203,13,6,9,4,0,2,0,0,34
140490204,22,18,15,13,7,3,1,2,81
140490205,5,3,6,6,3,1,0,0,24
140490206,7,8,2,6,2,0,1,0,26
140490207,5,6,16,8,6,7,1,3,52
140490208,4,0,3,1,1,0,0,0,9
140490209,13,5,2,2,3,0,0,0,25
140490210,15,18,5,7,4,1,0,0,50
140490211,29,23,11,19,21,9,4,10,126
140490212,2,6,7,5,2,3,1,2,28
140490213,20,16,8,7,12,3,1,2,69
140490214,25,22,31,25,19,12,5,8,147
140490215,14,19,24,7,12,5,2,3,86
140490301,26,28,23,25,22,30,5,13,172
140490302,24,33,26,31,19,25,4,13,175
140490303,48,59,54,60,44,24,8,17,314
140490304,20,30,25,30,25,19,6,19,174
140490305,20,32,46,51,42,15,13,15,234
140490306,17,30,28,33,26,14,6,11,165
140490307,23,48,64,66,36,14,7,9,267
140490308,29,49,50,43,28,16,11,11,237
140490309,55,86,64,45,33,8,10,5,306
140490310,53,62,47,37,19,12,5,5,240
140490311,32,70,63,66,42,27,14,15,329
140490312,38,56,39,52,39,24,6,11,265
140490313,34,40,44,38,31,20,6,11,224
140490314,28,46,32,35,18,22,14,13,208
140490315,30,35,26,15,4,9,1,1,121
140490316,46,46,40,39,23,12,4,6,216
140490317,29,60,42,31,15,10,6,3,196
140490318,51,63,43,38,18,12,1,3,229
140490319,65,91,64,74,29,20,8,7,358
140490320,41,69,62,54,38,22,9,5,300
140490321,27,43,42,38,34,15,11,5,215
140490322,45,68,58,58,41,28,12,16,326
140490323,31,47,30,28,25,20,14,16,211
140490324,15,12,32,23,34,20,13,18,167
140490325,36,46,54,59,29,22,13,13,272
140560101,17,21,11,11,7,3,0,0,70
140560102,11,20,16,9,6,3,0,2,67
140560103,14,7,11,12,5,6,1,0,56
140560104,51,64,105,75,50,28,3,5,381
140560105,52,66,75,101,48,33,7,7,389
140560106,46,81,85,88,41,21,4,0,366
140560107,58,89,55,49,21,8,3,2,285
140560108,49,75,73,76,35,22,10,5,345
140560109,30,39,57,56,42,21,5,13,263
140560110,36,60,56,67,31,20,5,3,278
140560111,59,69,35,40,30,9,7,2,251
140560112,66,76,45,26,23,6,2,0,244
140560113,74,83,59,56,30,5,0,2,309
140560114,37,68,55,38,16,10,2,1,227
140560115,39,53,40,40,18,2,0,0,192
140560116,52,83,48,35,13,5,2,1,239
140560117,55,97,67,73,39,23,5,1,360
140560118,37,68,55,55,20,11,2,0,248
140560201,5,12,8,7,4,1,0,1,38
140560202,5,6,2,5,1,1,0,0,20
140560203,2,4,1,1,1,0,0,0,9
140560204,44,71,44,36,11,3,3,2,214
140560205,33,61,79,69,48,20,6,7,323
140560206,53,87,76,55,22,10,4,2,309
140560207,49,53,26,18,9,2,1,0,158
140560208,51,76,49,30,18,7,1,0,232
140560209,33,60,62,52,27,13,4,0,251
140560210,65,75,67,75,39,10,0,4,335
140560211,72,106,83,58,23,17,3,2,364
140560212,61,71,92,69,33,20,8,2,356
140560213,33,63,103,143,90,29,10,5,476
140560214,44,60,90,122,76,32,12,14,450
140560301,2,2,0,1,0,1,0,0,6
140560302,7,10,6,6,3,2,0,0,34
140560303,3,13,12,12,12,7,4,1,64
140560304,6,13,9,18,8,4,1,0,59
140560305,11,4,3,10,8,2,0,0,38
140560306,0,3,2,5,2,0,0,0,12
140560307,2,4,2,2,1,0,0,0,11
140560308,6,7,5,5,5,1,0,0,29
140560309,7,17,8,6,2,1,0,1,42
140560310,3,7,6,15,4,9,1,3,48
140560311,63,68,62,50,40,15,2,3,303
140560312,71,84,54,47,18,13,1,1,289
140560313,82,93,71,63,30,9,4,2,354
140560314,59,79,54,39,22,5,2,1,261
140560315,49,58,42,25,16,8,0,1,199
140560316,61,63,50,57,32,15,4,8,290
140560317,28,35,37,43,28,8,5,0,184
140560318,30,46,41,36,16,8,6,5,188
140560319,54,86,78,76,43,8,6,2,353
140560320,34,57,42,58,15,4,2,0,212
140560401,2,11,14,4,3,0,0,0,34
140560402,10,13,9,10,2,2,0,0,46
140560403,2,5,1,1,2,0,0,0,11
140560404,2,3,0,7,0,0,0,0,12
140560405,6,10,9,5,5,3,0,0,38
140560406,1,6,8,5,1,2,0,1,24
140560407,75,83,73,66,42,30,2,11,382
140560408,25,31,40,30,9,11,3,3,152
140560409,23,51,57,45,22,16,2,2,218
140560410,33,33,39,44,26,13,13,3,204
140560411,69,58,53,28,17,7,5,0,237
140560412,44,37,34,42,17,10,3,4,191
140560413,46,76,53,63,25,22,8,5,298
140560414,63,76,58,47,34,5,4,3,290
140560415,52,69,45,64,26,12,1,5,274
140560501,8,9,2,4,2,1,0,0,26
140560502,6,4,4,2,4,1,0,0,21
140560503,3,6,3,4,1,0,0,0,17
140560504,11,13,11,7,1,1,2,1,47
140560505,4,1,1,2,0,2,0,0,10
140560506,9,15,13,15,6,5,2,1,66
140560507,13,22,13,5,1,3,1,0,58
140560508,50,56,34,30,22,11,1,1,205
140560509,53,48,42,32,19,3,1,3,201
140560601,14,16,14,10,7,2,1,1,65
140560602,10,7,7,6,7,0,0,1,38
140560603,5,9,3,6,5,1,0,0,29
140560604,3,6,4,2,3,2,0,0,20
140560605,5,9,8,2,4,2,0,0,30
140560606,7,3,4,6,3,1,0,0,24
140560607,3,7,5,5,5,3,0,0,28
140560608,8,12,17,9,3,1,0,1,51
140560609,16,17,21,11,8,8,0,1,82
140560610,5,13,7,11,2,2,1,1,42
140560611,12,16,12,8,7,1,0,1,57
140560612,18,17,10,13,6,4,1,1,70
140560613,11,17,16,14,8,3,0,2,71
140560614,7,3,3,8,1,0,0,0,22
140560615,46,66,44,44,33,14,6,6,259
140560616,48,56,36,40,32,7,6,4,229
140560617,48,62,53,52,31,14,5,5,270
140560618,41,52,34,35,14,3,5,5,189
140560701,48,65,44,35,24,9,2,4,231
140560702,36,63,48,31,28,9,2,1,218
140560703,37,72,49,64,41,16,7,4,290
140560704,41,66,45,45,31,15,3,1,247
140560705,38,62,43,28,13,9,3,2,198
140560706,61,100,57,55,45,13,4,5,340
140560707,53,66,30,34,16,8,3,3,213
140560708,79,93,50,78,37,11,0,2,350
140560709,88,85,86,77,34,27,3,0,400
140560710,40,48,33,54,30,16,3,4,228
140560711,67,80,71,74,42,13,3,5,355
140560712,57,76,78,82,49,37,12,18,409
140560713,50,63,60,57,42,27,12,6,317
140560714,66,77,42,22,16,5,0,2,230
140630101,3,7,8,5,5,0,1,1,30
140630102,8,7,5,4,3,2,0,0,29
140630103,10,6,2,3,1,1,0,0,23
140630104,1,2,5,1,2,0,1,0,12
140630105,3,6,5,3,1,0,0,0,18
140630106,3,15,7,8,4,0,0,0,37
140630107,1,6,4,1,3,1,1,0,17
140630108,2,3,6,5,0,3,0,0,19
140630109,66,86,48,37,34,6,1,0,278
140630201,6,7,4,9,4,1,0,0,31
140630202,11,14,12,13,12,5,2,1,70
140630203,3,7,4,8,7,0,0,1,30
140630204,2,8,5,8,5,2,0,0,30
140630205,2,5,4,1,2,1,1,0,16
140630206,6,10,3,8,6,0,0,0,33
140630207,4,11,3,5,2,2,1,1,29
140630208,6,7,8,6,5,1,0,0,33
140630209,4,5,6,3,4,2,0,0,24
140630210,2,12,13,6,3,0,0,1,37
140630211,6,7,4,6,4,2,0,0,29
140630212,66,89,77,52,34,10,3,4,335
140630213,65,72,53,45,19,7,5,2,268
140630214,46,55,37,34,18,9,4,1,204
140630215,36,28,23,22,16,8,6,3,142
140630301,2,4,3,2,2,1,0,0,14
140630302,7,8,6,10,3,3,0,0,37
140630303,27,25,22,19,7,4,1,3,108
140630304,37,44,47,51,42,21,6,1,249
140630305,34,67,56,69,29,12,1,4,272
140630306,55,96,59,68,25,9,0,0,312
140630307,60,90,35,35,18,6,3,0,247
140630308,56,50,49,55,20,14,5,7,256
140630309,36,55,45,45,9,6,1,1,198
140630310,56,68,43,31,17,6,1,0,222
140630311,30,66,62,56,40,11,9,9,283
140630401,2,3,3,2,1,1,0,0,12
140630402,3,9,4,5,2,0,0,0,23
140630403,2,7,3,1,1,0,0,0,14
140630404,3,7,4,6,3,0,0,0,23
140630405,0,4,5,13,3,5,0,0,30
140630406,0,1,1,4,2,1,0,0,9
140630407,63,80,77,53,24,14,7,4,322
140630408,53,81,54,52,20,3,2,1,266
140630409,49,49,37,35,12,8,1,0,191
140630410,48,54,48,30,13,2,1,0,196
140630411,35,58,51,30,14,4,1,0,193
140630412,36,45,32,36,14,1,1,2,167
140630413,75,97,62,49,34,12,1,2,332
140630414,55,75,51,52,21,7,2,0,263
140630415,39,31,43,47,28,13,5,6,212
140630501,18,21,9,4,8,6,0,0,66
140630502,11,21,12,5,1,0,1,1,52
140630503,13,6,4,4,0,0,0,0,27
140630504,43,50,40,25,11,12,0,4,185
140630505,70,76,57,45,20,10,4,0,282
140630506,52,62,62,51,34,9,4,2,276
140630507,64,56,53,41,10,4,2,1,231
140630508,62,82,49,50,21,13,1,4,282
140630509,43,54,44,30,18,4,0,0,193
140630510,60,63,72,84,31,22,10,9,351
140630511,45,47,48,45,18,13,2,3,221
140630512,47,45,50,25,14,6,1,0,188
140630513,82,90,52,43,17,3,1,0,288
140630514,64,83,43,45,17,7,1,1,261
140630515,82,92,81,54,20,8,3,0,340
140630516,73,79,57,49,25,8,5,0,296
140630517,28,31,32,14,15,6,4,1,131
140630601,0,2,1,1,1,0,0,0,5
140630602,0,1,1,2,0,0,0,0,4
140630603,9,7,14,8,4,2,0,0,44
140630604,8,8,8,10,3,1,0,0,38
140630605,1,4,4,2,7,2,0,0,20
140630606,5,7,8,8,3,0,0,0,31
140630607,76,95,48,39,24,9,0,0,291
140630608,47,68,49,36,13,5,1,0,219
140630609,64,83,43,50,27,19,5,5,296
140630610,60,85,50,39,11,4,3,0,252
140630611,59,86,65,58,26,8,3,1,306
140630612,64,72,32,36,19,4,0,1,228
140630613,55,68,65,72,22,8,1,2,293
140630614,23,25,32,26,15,15,3,3,142
140630615,40,68,65,47,22,8,3,0,253
140630701,22,30,21,14,6,3,1,3,100
140630702,15,10,8,7,6,4,0,0,50
140630703,7,8,8,6,5,1,0,0,35
140630704,7,6,8,2,1,2,0,2,28
140630705,9,8,9,8,4,3,0,0,41
140630706,49,67,78,52,16,16,1,1,280
140630707,58,76,60,41,18,5,3,2,263
140630708,84,105,56,39,23,3,1,1,312
140630709,68,103,64,43,17,10,2,1,308
140630710,15,22,22,26,15,8,7,5,120
140630711,48,27,33,40,23,18,15,13,217
140630801,2,6,5,6,3,2,0,0,24
140630802,4,10,8,5,4,0,0,0,31
140630803,13,12,8,7,1,1,1,1,44
140630804,12,10,11,7,11,1,0,3,55
140630805,5,4,4,5,2,0,0,0,20
140630806,5,5,7,3,0,1,0,0,21
140630807,28,31,37,20,14,6,8,7,151
140630808,62,66,44,46,23,3,3,1,248
140630809,59,60,31,39,19,9,1,1,219
140630810,48,69,48,49,22,3,0,0,239
140630811,47,46,40,41,16,7,3,0,200
140630812,54,53,39,39,11,6,4,2,208
140630901,3,5,5,6,1,1,0,0,21
140630902,9,12,5,4,4,2,1,1,38
140630903,13,28,13,8,6,4,1,0,73
140630904,20,16,11,11,4,2,1,1,66
140630905,2,0,2,12,6,5,2,1,30
140630906,5,3,4,4,4,0,1,0,21
140630907,4,9,8,3,5,3,0,0,32
140630908,5,8,8,7,4,2,2,1,37
140630909,17,13,9,9,6,1,0,1,56
140630910,46,65,28,21,18,7,6,0,191
140630911,47,44,34,36,12,9,4,1,187
140630912,53,60,43,38,19,7,3,1,224
140630913,39,41,32,33,17,14,5,4,185
140630914,53,43,48,67,42,26,4,7,290
140630915,55,89,71,65,39,9,3,1,332
140630916,71,92,52,61,20,13,2,1,312
140630917,18,29,17,28,22,11,2,2,129
140630918,69,80,62,46,17,5,0,1,280
140630919,59,73,31,23,18,10,0,0,214
140630920,53,63,59,48,26,14,5,4,272
140630921,57,72,56,53,42,15,4,2,301
140630922,67,78,80,65,33,14,7,9,353
140630923,29,43,41,29,33,10,3,1,189
140631001,23,21,39,27,26,14,6,9,165
140631002,51,88,68,50,21,17,7,6,308
140631003,59,101,80,71,28,7,4,3,353
140631004,39,49,52,68,10,10,0,1,229
140631005,56,57,38,27,16,0,0,0,194
140631006,62,91,53,41,12,2,0,1,262
140631007,50,88,74,91,36,7,6,4,356
140631008,64,75,43,35,14,2,0,2,235
140631009,64,83,49,35,17,7,1,0,256
140631010,48,60,49,35,19,10,1,1,223
140631011,72,73,48,25,16,4,0,0,238
140631012,76,93,59,66,28,11,8,3,344
140631013,64,76,78,67,48,28,11,9,381
140631101,32,70,74,91,45,35,7,12,366
140631102,37,44,47,71,42,17,9,16,283
140631103,34,50,41,49,24,8,3,5,214
140631104,39,73,58,48,24,13,3,10,268
140631105,88,116,73,54,30,10,1,2,374
140631106,37,78,37,37,7,3,0,0,199
140631107,41,66,51,60,28,2,0,0,248
140631108,31,49,48,52,23,8,7,8,226
140631109,27,38,33,50,35,7,0,5,195
140631110,59,78,91,79,32,15,0,1,355
140631111,66,85,50,36,16,0,0,1,254
140631112,65,48,20,14,4,4,1,0,156
140631113,87,98,64,31,20,5,0,1,306
140631114,81,72,45,25,14,3,1,0,241
140631115,47,70,54,37,12,2,0,2,224
140631116,80,97,68,61,35,21,3,5,370
140631201,32,59,52,48,22,9,4,1,227
140631202,44,71,38,33,12,7,2,0,207
140631203,57,84,47,48,13,7,1,3,260
140631204,66,48,26,22,5,2,2,0,171
140631205,80,92,69,80,32,5,1,1,360
140631206,67,80,64,48,37,13,7,3,319
140631207,61,79,63,44,25,6,3,0,281
140631208,56,77,56,42,20,5,3,1,260
140631209,48,77,75,61,39,23,4,14,341
140631210,31,68,76,70,54,26,16,13,354
140631211,44,63,65,63,24,13,7,9,288
140631212,63,81,60,55,33,10,4,1,307
140631213,44,73,57,50,24,8,3,5,264
140631214,53,70,66,62,40,25,8,4,328
140631215,36,63,67,67,46,16,9,15,319
140631216,31,48,61,72,45,23,7,5,292
140631301,68,71,72,62,45,24,5,4,351
140631302,33,48,44,37,27,10,3,3,205
140631303,75,97,65,56,30,10,3,3,339
140631304,58,62,41,49,20,12,2,0,244
140631305,82,101,102,80,33,21,5,0,424
140631306,73,83,57,53,14,2,2,0,284
140631307,60,42,32,29,8,4,2,0,177
140631308,90,76,44,40,12,4,0,0,266
140631309,90,121,55,53,17,6,1,0,343
140631310,28,42,36,43,6,2,1,0,158
140631311,51,79,39,37,20,6,0,0,232
140631312,44,45,44,41,17,9,1,2,203
140631313,36,44,46,38,14,9,3,2,192
140631314,53,85,51,67,27,8,2,0,293
140700101,16,19,16,9,7,5,3,9,84
140700102,6,8,6,3,3,4,1,4,35
140700103,29,20,14,19,12,4,3,5,106
140700104,12,10,6,3,2,1,2,3,39
140700105,31,26,11,14,9,8,3,4,106
140700201,9,13,14,3,1,2,2,3,47
140700202,9,3,5,9,5,2,1,4,38
140700203,26,20,16,5,12,4,4,5,92
140700204,6,8,4,7,1,2,0,2,30
140700205,34,16,16,9,1,2,2,0,80
140700206,24,27,14,8,14,4,2,2,95
140700207,8,10,10,9,13,9,2,2,63
140700208,8,6,7,4,4,4,2,2,37
140700209,17,9,9,4,4,2,1,2,48
140700210,28,24,11,9,7,4,2,3,88
140700211,25,21,15,14,9,1,5,2,92
140700212,22,26,26,27,23,8,2,1,135
140700213,50,75,56,48,23,15,7,6,280
140770101,6,2,0,0,1,3,0,1,13
140770102,2,2,1,2,0,0,1,0,8
140770103,13,6,12,3,2,6,1,1,44
140770104,5,3,3,4,3,4,1,1,24
140770105,4,14,4,8,5,4,1,5,45
140770106,5,10,9,7,7,5,2,1,46
140770107,13,10,9,4,2,1,1,4,44
140770108,3,3,7,3,4,5,1,0,26
140770109,6,6,3,3,5,4,3,1,31
140770110,25,22,21,22,14,8,3,7,122
140770201,9,11,11,8,5,2,2,2,50
140770202,20,21,5,17,7,8,1,4,83
140770203,11,17,15,14,41,21,3,2,124
140770204,35,28,24,32,21,41,4,5,190
140770205,15,13,14,6,3,3,0,1,55
140770206,5,8,1,1,2,0,0,1,18
140770207,13,11,9,9,5,3,3,3,56
140770208,16,16,9,9,2,4,1,1,58
140770209,9,14,6,3,2,0,0,0,34
140770210,44,67,45,37,19,11,4,3,230
140770211,47,46,29,38,17,10,4,5,196
140770212,13,12,5,9,8,8,1,0,56
140770213,15,14,13,6,4,3,1,2,58
140840101,12,17,10,8,1,1,0,1,50
140840102,6,13,8,14,4,2,2,0,49
140840103,11,13,10,7,8,0,0,0,49
140840104,4,3,4,4,1,3,0,0,19
140840105,6,8,2,2,2,0,1,1,22
140840106,65,97,74,69,32,13,5,1,356
140840107,80,77,53,34,13,5,0,2,264
140840108,76,96,91,64,40,10,5,2,384
140840109,57,67,59,56,36,9,9,5,298
140840110,69,59,55,47,29,10,10,4,283
140840111,33,60,54,72,35,26,7,9,296
140840201,4,7,8,0,4,1,0,0,24
140840202,11,5,4,3,1,1,2,0,27
140840203,7,6,6,4,1,0,0,0,24
140840204,13,9,5,8,5,4,0,2,46
140840205,5,10,5,4,2,2,0,0,28
140840206,12,14,10,8,9,4,0,1,58
140840207,8,8,9,8,10,1,1,0,45
140840208,6,8,11,6,3,1,2,1,38
140840209,28,25,27,24,7,6,2,4,123
140840210,53,73,60,52,27,10,5,1,281
140840301,7,6,12,3,1,1,0,1,31
140840302,4,10,15,1,9,5,3,1,48
140840303,5,7,6,3,1,3,1,1,27
140840304,6,7,4,5,1,1,2,0,26
140840305,12,6,8,5,5,5,1,0,42
140840306,1,5,6,3,5,1,1,0,22
140840307,5,4,1,7,4,1,2,1,25
140840308,12,1,7,5,2,2,0,1,30
140840309,10,7,6,5,0,1,0,0,29
140840310,5,7,3,3,2,2,0,0,22
140840311,2,9,2,2,0,2,0,1,18
140840312,12,9,2,8,2,0,0,0,33
140840313,59,45,42,31,19,10,5,1,212
140840314,45,49,44,34,33,13,6,1,225
140840315,42,39,32,29,21,4,7,1,175
140840316,31,30,31,34,15,7,4,5,157
140840401,14,11,10,2,3,1,0,0,41
140840402,9,14,9,9,7,4,1,1,54
140840403,5,1,3,1,2,0,1,1,14
140840404,21,10,15,13,6,7,2,2,76
140840405,14,17,16,23,12,6,0,0,88
140840406,54,58,43,32,18,7,1,1,214
140840407,45,69,53,40,16,7,1,0,231
140840408,44,69,58,61,33,15,7,6,293
140840409,43,76,72,60,31,10,8,6,306
140840501,41,51,48,54,29,27,7,10,267
140840502,46,34,30,44,18,7,7,11,197
140840503,28,35,43,36,28,21,3,9,203
140840504,45,71,71,53,46,24,5,13,328
140840505,41,49,48,59,32,14,9,6,258
140840506,52,53,53,41,19,13,7,7,245
140840507,48,64,48,42,24,15,3,5,249
140840508,72,101,70,57,31,8,4,3,346
140840509,75,80,38,36,16,7,3,1,256
140840510,61,79,36,21,13,3,1,3,217
140840511,75,102,47,39,13,5,3,2,286
140840512,68,73,56,49,27,20,8,10,311
140840513,62,53,55,54,24,7,2,0,257
140840514,77,92,68,67,39,16,4,2,365
140840515,90,79,49,30,16,4,3,0,271
140840516,99,101,54,35,19,2,1,1,312
140840517,60,57,38,32,17,7,1,2,214
140840518,62,66,44,38,18,7,5,5,245
140840519,48,63,43,43,28,6,2,5,238
140840520,47,63,35,23,13,5,3,0,189
140840521,48,89,56,50,26,15,4,7,295
140840522,70,101,62,32,10,7,1,0,283
140840523,45,56,61,49,25,15,3,6,260
140840524,26,58,46,48,28,16,2,5,229
140840525,35,62,56,31,9,6,0,4,203
140840526,29,57,31,50,24,12,3,3,209
140840527,28,41,37,41,21,4,1,2,175
140910101,42,34,32,54,38,18,5,8,231
140910102,22,21,23,27,15,9,1,1,119
140910103,62,67,36,27,13,10,5,2,222
140910104,72,67,35,32,16,9,1,1,233
140910105,22,27,18,16,4,1,1,3,92
140910106,49,67,48,28,21,4,5,2,224
140910107,83,60,44,31,15,7,0,1,241
140910108,73,69,48,32,17,6,2,0,247
140910109,41,34,32,19,12,8,1,4,151
140910110,67,51,40,26,13,5,1,1,204
140910111,36,52,41,22,11,8,3,2,175
140910112,48,63,39,44,5,1,5,0,205
140910113,48,90,53,47,26,5,3,1,273
140910114,32,52,49,45,44,8,6,11,247
140910115,14,33,22,20,8,4,2,3,106
140910116,45,54,49,29,24,6,3,5,215
140910117,34,41,26,27,16,4,3,2,153
140910118,58,49,47,49,14,12,2,1,232
140910119,29,38,24,33,12,8,0,1,145
140910201,23,15,9,21,8,10,2,4,92
140910202,6,5,11,8,4,1,2,2,39
140910203,27,18,19,10,1,2,0,2,79
140910204,23,14,7,3,2,0,1,0,50
140910205,3,0,0,0,0,0,0,1,4
140910206,9,6,3,2,2,1,0,1,24
140910207,3,0,1,0,0,0,0,0,4
140910208,0,1,1,1,2,1,0,0,6
140910209,51,70,51,43,29,15,3,5,267
140910210,72,57,36,33,21,16,8,7,250
140910211,24,23,22,17,8,3,1,1,99
140910212,3,1,0,0,0,0,0,0,4
140910301,0,2,1,0,1,2,0,0,6
140910302,1,1,5,3,3,1,1,0,15
140910303,50,45,38,44,21,12,3,5,218
140910304,45,59,61,58,32,23,3,10,291
140910305,45,60,45,33,21,12,6,2,224
140910306,28,54,37,30,16,9,3,2,179
140910307,32,53,38,36,24,9,6,5,203
140910308,38,60,33,41,21,17,6,8,224
140910309,63,73,71,39,19,7,6,6,284
140910310,35,66,37,28,20,4,4,2,196
140910311,30,45,47,26,19,6,2,5,180
140910401,47,38,63,49,38,20,1,9,265
140910402,48,59,69,52,29,23,6,4,290
140910403,51,52,51,39,19,19,2,3,236
140910404,47,67,61,35,29,15,7,2,263
140910405,79,73,46,20,26,15,3,3,265
140910406,66,58,63,31,18,5,0,2,243
140910407,69,98,64,50,30,7,3,1,322
140910408,39,62,53,39,18,9,4,3,227
140910409,92,111,66,41,19,13,3,0,345
140910410,52,40,27,15,8,3,1,1,147
140910411,67,93,61,51,23,13,6,5,319
140910412,33,30,12,19,11,2,0,3,110
140910413,73,113,63,65,27,10,1,5,357
140910414,65,69,40,34,16,2,3,1,230
140910415,38,57,45,47,26,16,3,15,247
140910416,32,48,38,28,20,8,3,1,178
140910417,57,75,64,59,32,20,7,13,327
140910418,45,75,47,35,40,10,0,0,252
140910419,36,36,49,35,22,8,4,12,202
140910420,38,55,63,59,36,23,8,12,294
140910501,1,1,0,2,0,0,1,0,5
140910502,18,38,30,27,17,14,3,6,153
140910503,51,60,40,39,34,8,4,8,244
140910504,64,79,63,55,34,15,3,3,316
140910505,45,52,50,65,28,23,7,11,281
140910506,41,54,39,31,25,5,5,2,202
140910507,30,48,34,29,12,5,2,1,161
140910508,18,36,17,13,12,2,2,1,101
140910509,36,52,30,33,19,12,5,4,191
140910510,29,54,25,40,27,15,5,5,200
140910601,0,0,0,1,0,0,0,0,1
140910602,18,17,17,15,14,9,4,9,103
140910603,6,2,6,7,0,1,1,0,23
140910604,2,4,5,3,2,1,1,0,18
140910605,5,6,3,3,3,1,0,0,21
140910606,43,51,48,45,37,12,7,11,254
140910607,52,69,58,69,28,25,5,2,308
140910608,51,83,56,52,32,11,4,7,296
140910609,39,60,34,21,11,7,5,2,179
140910610,54,93,70,48,40,11,3,6,325
140910611,37,54,43,35,23,10,6,5,213
140910612,24,41,36,30,22,12,6,9,180
140910613,33,52,47,37,28,19,8,3,227
140910614,34,62,46,26,18,8,2,1,197
140910615,29,44,40,30,16,10,3,1,173
140910616,28,45,32,26,17,11,3,3,165
140910617,37,59,27,32,23,11,0,2,191
140910618,20,28,31,26,18,10,5,4,142
140910701,3,4,2,1,2,1,0,0,13
140910702,26,57,39,33,22,11,6,4,198
140910703,84,88,60,43,31,20,6,5,337
140910704,36,59,50,44,26,7,5,1,228
140910705,46,60,31,33,19,8,2,1,200
140910706,31,42,29,21,13,10,1,4,151
140910707,51,60,53,66,29,11,1,0,271
140910708,64,89,49,45,21,6,3,2,279
140910709,91,91,55,48,22,18,6,4,335
140910710,33,52,36,31,10,3,1,1,167
140910711,56,77,64,52,23,9,5,2,288
140910712,89,74,63,33,16,11,2,1,289
140910713,66,106,78,74,40,27,7,14,412
140910714,36,56,45,58,29,15,8,4,251
140910715,83,93,63,66,21,13,10,7,356
140910716,67,88,56,39,28,4,3,3,288
140910717,30,33,31,28,18,19,4,5,168
140910718,66,99,51,42,27,12,8,3,308
140910719,48,46,37,26,15,8,3,6,189
140910720,72,106,64,82,30,26,10,9,399
140910721,43,89,74,80,52,40,8,15,401
140910722,40,82,66,68,41,17,10,8,332
140910723,33,41,38,53,39,24,11,7,246
140910801,7,4,0,0,0,0,0,0,11
140910802,17,18,13,12,8,5,0,1,74
140910803,0,0,2,1,0,1,0,0,4
140910804,16,22,18,18,10,11,1,3,99
140910805,37,53,36,13,19,4,4,0,166
140910806,35,51,37,35,24,9,4,3,198
140910807,29,43,39,33,13,5,7,5,174
140910808,33,30,19,22,11,7,5,7,134
140910809,46,53,41,36,25,9,2,2,214
140910810,30,55,51,43,28,12,6,5,230
140910811,25,48,36,34,18,7,2,1,171
140910812,44,52,42,40,30,22,3,10,243
140910813,37,78,74,58,38,17,9,4,315
140910901,37,60,51,56,36,13,1,1,255
140910902,20,45,33,34,22,6,1,2,163
140910903,36,51,33,24,6,4,1,0,155
140910904,49,70,60,76,35,26,3,6,325
140910905,54,70,81,71,40,27,8,7,358
140910906,35,88,67,54,35,8,4,2,293
140910907,33,49,69,44,36,9,5,4,249
140910908,52,81,54,42,20,5,3,0,257
140910909,60,59,58,34,18,6,1,0,236
140910910,59,48,29,16,9,7,2,0,170
140910911,47,53,20,4,4,1,0,0,129
140910912,42,60,51,40,17,9,0,0,219
140910913,22,46,52,46,19,16,7,7,215
140910914,38,48,78,62,39,19,9,7,300
140910915,43,55,74,74,48,17,5,12,328
140910916,52,70,54,79,52,19,10,10,346
140910917,43,53,56,46,28,9,4,2,241
140910918,49,43,28,13,4,2,1,0,140
140910919,33,56,47,40,28,8,3,2,217
140910920,39,54,51,52,27,19,6,7,255
140910921,39,62,85,72,72,41,19,23,413
140910922,25,59,87,88,61,33,19,14,386
140910923,0,0,0,0,0,0,0,0,0
140911001,29,56,41,41,33,7,2,5,214
140911002,29,60,39,50,20,10,3,1,212
140911003,34,57,51,42,24,9,4,1,222
140911004,65,82,76,65,39,9,3,0,339
140911005,19,70,43,56,22,6,1,2,219
140911006,32,80,68,74,25,10,1,0,290
140911007,35,37,26,37,15,4,0,1,155
140911008,55,55,54,44,24,6,1,0,239
140911009,53,66,45,28,20,9,0,1,222
140911010,30,71,61,48,13,11,1,3,238
140911011,31,60,47,52,16,11,1,0,218
140911012,42,59,51,38,12,5,2,0,209
140911013,50,85,56,38,32,11,1,1,274
140911014,47,53,25,31,16,6,0,0,178
140911015,56,72,50,34,15,7,2,0,236
140911016,42,66,36,28,11,6,3,0,192
140911017,41,67,44,35,10,2,0,0,199
140911018,44,68,47,35,12,6,2,1,215
140911019,33,59,31,32,18,7,0,1,181
140911020,18,36,30,16,6,4,1,1,112
140911101,80,77,25,21,9,2,0,0,214
140911102,73,42,16,15,8,4,0,0,158
140911103,33,48,47,32,21,8,2,0,191
140911104,50,49,42,32,14,6,1,0,194
140911105,68,70,58,49,23,11,4,4,287
140911106,41,32,10,15,2,3,1,0,104
140911107,60,44,22,12,6,2,0,0,146
140911108,52,73,36,24,13,2,0,0,200
140911109,65,61,38,22,9,6,1,0,202
140911110,85,108,63,39,14,11,1,1,322
140911111,66,48,27,10,3,3,0,0,157
140911112,34,79,48,43,34,6,2,1,247
140911113,42,59,24,46,5,6,2,1,185
140911114,49,44,36,40,12,3,1,1,186
140911115,66,56,41,38,17,0,3,0,221
140911116,43,41,46,24,13,3,3,1,174
140911117,38,39,22,11,9,1,1,0,121
140911118,39,63,48,29,11,5,2,1,198
140911201,64,90,64,57,26,10,3,1,315
140911202,47,78,36,43,20,8,1,0,233
140911203,47,88,52,44,21,8,2,0,262
140911204,51,71,70,50,30,10,5,4,291
140911205,49,91,64,58,38,12,2,3,317
140911206,33,47,45,39,24,4,0,0,192
140911207,36,56,68,49,34,29,3,2,277
140911208,46,45,66,86,48,34,10,10,345
140911209,33,53,41,54,19,16,0,2,218
140911210,36,70,49,44,37,18,7,11,272
140911211,35,56,58,64,26,27,10,4,280
140911212,21,38,42,37,19,14,1,3,175
140911213,40,55,42,48,24,8,4,2,223
140911214,43,62,48,59,37,17,1,6,273
140911215,45,70,46,48,48,15,7,4,283
140911216,25,44,23,24,10,8,1,1,136
140911217,25,46,45,36,23,8,1,0,184
140911218,34,63,31,37,14,11,3,1,194
140911219,38,82,58,46,35,9,5,2,275
140911220,37,63,44,35,21,11,2,8,221
140911221,17,48,51,51,26,15,5,7,220
140911222,32,61,45,53,24,18,0,1,234
140911223,19,36,37,33,19,15,8,6,173
140911301,3,1,0,0,0,1,0,0,5
140911302,1,3,2,2,1,0,0,0,9
140911303,5,8,8,2,4,1,0,0,28
140911304,1,0,2,2,0,0,0,0,5
140911305,1,3,3,0,0,0,0,0,7
140911306,1,3,3,1,1,0,0,0,9
140911307,0,3,1,1,1,0,0,0,6
140911308,3,2,0,2,0,0,0,0,7
140911309,21,35,23,19,7,3,1,2,111
140911310,14,37,21,17,2,6,2,1,100
140911311,43,67,55,52,37,18,8,7,287
140911312,29,43,32,33,19,6,4,4,170
140911313,41,44,46,49,29,23,5,6,243
140911314,29,32,23,26,12,6,5,2,135
140911315,29,42,51,58,33,16,8,2,239
140911316,17,25,22,22,10,3,0,2,101
140911317,17,42,44,16,0,5,2,0,126
140911318,11,41,25,24,9,5,2,3,120
140911319,10,31,23,35,8,0,0,0,107
140911320,16,33,25,15,8,5,0,2,104
140911321,17,23,10,17,12,5,3,2,89
140911322,16,23,22,9,6,4,2,2,84
140911323,21,40,36,44,27,11,3,1,183
140911401,6,2,0,3,3,0,0,0,14
140911402,4,3,4,6,2,1,1,1,22
140911403,2,1,4,0,3,0,0,0,10
140911404,0,7,2,2,2,0,2,2,17
140911405,7,4,7,10,3,0,1,0,32
140911406,28,33,27,20,21,5,3,2,139
140911407,77,81,51,43,27,15,6,1,301
140911408,50,64,47,42,17,11,2,4,237
140911409,49,48,71,56,29,21,3,6,283
140911410,72,77,69,70,35,21,13,7,364
140911411,42,35,43,30,18,11,8,4,191
140911412,37,38,50,39,26,12,5,2,209
140911413,77,79,51,47,19,5,1,2,281
140911414,73,72,36,35,19,11,1,3,250
140911415,19,48,37,28,13,12,6,6,169
140911501,0,2,0,1,2,0,0,0,5
140911502,27,29,28,21,16,10,6,4,141
140911503,24,45,43,36,26,15,6,6,201
140911504,42,41,49,27,19,7,5,5,195
140911505,43,45,28,31,13,7,1,1,169
140911506,48,59,40,38,14,6,0,4,209
140911507,32,34,44,38,31,15,5,10,209
140911508,41,44,43,39,26,11,7,2,213
140911509,46,62,34,36,22,12,4,2,218
140911510,43,57,46,51,27,12,4,3,243
140911601,1,4,1,0,0,1,0,0,7
140911602,3,9,2,4,0,0,0,0,18
140911603,1,1,0,0,0,0,1,0,3
140911604,3,3,1,0,0,1,0,0,8
140911605,15,15,11,5,9,4,0,3,62
140911606,4,6,2,6,3,2,2,0,25
140911607,1,0,0,1,1,2,0,0,5
140911608,22,49,23,20,16,6,3,1,140
140911609,23,43,17,22,13,8,2,2,130
140911610,17,28,12,11,8,4,2,2,84
140911701,1,1,0,0,0,0,0,0,2
140911702,0,0,0,2,0,0,0,0,2
140911703,0,3,1,3,1,1,0,0,9
140911704,1,1,0,0,0,0,0,0,2
140911705,0,0,1,2,0,0,1,0,4
140911706,39,45,53,35,30,19,6,9,236
140911707,22,34,27,32,19,16,5,4,159
140911708,43,67,42,27,9,5,1,2,196
140911709,52,57,43,33,21,10,4,4,224
140911710,29,43,26,24,14,8,2,3,149
140911711,46,47,32,18,18,4,3,2,170
140911712,19,42,30,27,11,9,3,1,142
140911713,47,78,45,49,20,13,2,5,259
140911714,28,50,33,22,18,8,1,1,161
140911715,16,30,18,14,10,7,1,2,98
140911801,3,2,0,1,1,0,0,0,7
140911802,0,1,2,2,0,0,0,0,5
140911803,1,3,3,1,0,2,0,1,11
140911804,8,11,17,15,10,4,3,1,69
140911805,11,12,16,3,7,5,0,0,54
140911806,24,41,23,11,12,3,2,1,117
140911807,23,24,14,10,6,6,3,4,90
140911808,31,48,39,35,20,10,8,3,194
140911809,28,51,47,29,9,4,1,2,171
140911810,11,14,3,6,2,0,0,0,36
140911901,5,11,5,4,9,5,2,0,41
140911902,7,5,15,5,1,0,1,0,34
140911903,0,1,0,0,0,0,0,0,1
140911904,4,3,2,1,1,2,1,0,14
140911905,5,2,1,0,2,0,0,1,11
140911906,37,55,35,36,22,7,0,3,195
140911907,24,37,25,15,12,10,2,1,126
140911908,37,74,44,33,19,11,5,2,225
140911909,24,46,38,39,36,13,1,3,200
140911910,25,35,47,41,29,11,1,6,195
140911911,45,69,55,59,25,22,4,6,285
140911912,9,19,6,6,2,0,0,0,42
140911913,28,53,36,30,26,12,4,7,196
140911914,25,46,23,26,11,6,4,6,147
140980101,2,1,2,1,0,0,0,0,6
140980102,2,3,4,8,1,0,0,0,18
140980103,5,5,11,9,0,2,1,0,33
140980104,4,6,3,7,3,2,0,0,25
140980105,3,3,2,4,0,1,0,0,13
140980106,2,2,3,7,4,0,0,0,18
140980107,4,8,2,1,1,1,0,0,17
140980108,26,49,43,39,15,4,1,0,177
140980109,35,59,59,48,25,10,1,3,240
140980110,37,40,68,54,29,14,7,7,256
140980111,48,69,39,24,20,12,1,1,214
140980112,51,62,35,35,13,7,0,2,205
140980113,71,75,40,43,12,3,0,1,245
140980114,32,57,41,43,20,15,5,0,213
140980115,30,75,47,54,21,11,1,5,244
140980116,63,87,35,41,15,4,2,0,247
140980117,48,71,59,53,29,20,7,3,290
140980201,2,2,2,2,1,1,0,0,10
140980202,5,13,5,7,3,1,2,0,36
140980203,19,21,15,14,11,1,2,1,84
140980204,6,12,7,13,4,2,1,0,45
140980205,7,11,8,9,1,1,0,0,37
140980206,3,5,3,4,3,0,0,0,18
140980207,3,4,5,5,1,1,0,0,19
140980208,68,82,47,37,21,3,0,2,260
140980209,44,43,24,39,21,10,3,3,187
140980210,61,71,57,41,23,4,4,4,265
140980211,47,73,49,74,45,12,5,1,306
140980301,3,7,2,6,0,0,0,1,19
140980302,4,4,5,6,3,1,3,0,26
140980303,7,2,5,2,0,0,0,0,16
140980304,61,70,37,39,22,13,3,0,245
140980305,55,69,50,55,45,19,4,2,299
140980306,70,108,47,48,24,8,4,3,312
140980307,58,62,41,30,15,4,2,0,212
140980308,64,95,57,47,24,7,0,1,295
140980309,46,44,42,34,26,11,3,2,208
140980310,42,44,40,37,19,12,3,3,200
140980311,37,43,48,72,30,14,4,3,251
140980401,3,7,5,1,5,1,0,0,22
140980402,3,11,10,15,4,2,4,0,49
140980403,3,4,7,5,3,1,1,0,24
140980404,3,4,7,5,1,0,0,0,20
140980405,2,6,5,4,4,0,0,0,21
140980406,7,10,13,7,6,3,0,0,46
140980407,26,46,37,45,28,11,8,6,207
140980408,46,61,31,42,29,13,7,4,233
140980409,19,25,27,12,11,6,1,1,102
140980501,2,4,3,6,2,0,0,0,17
140980502,10,22,13,9,6,1,0,2,63
140980503,2,10,4,2,2,2,0,1,23
140980504,3,3,5,0,1,0,0,0,12
140980505,14,33,8,32,13,7,1,1,109
140980506,11,31,40,31,13,7,1,1,135
140980507,5,12,7,9,4,1,1,0,39
140980508,4,4,3,7,2,0,0,0,20
140980509,8,15,8,7,7,3,1,1,50
140980510,36,70,46,63,31,18,7,3,274
140980511,38,69,58,48,20,10,2,2,247
140980512,47,68,61,67,29,14,2,4,292
140980513,41,64,61,34,15,14,2,1,232
140980514,43,57,44,29,16,6,3,3,201
140980515,36,52,56,37,25,14,1,5,226
140980516,76,76,30,17,3,0,0,0,202
140980517,72,92,55,51,24,4,0,0,298
140980601,7,7,7,2,0,2,0,0,25
140980602,19,24,12,10,5,2,0,0,72
140980603,4,15,12,7,3,2,0,2,45
140980604,16,12,9,4,2,2,0,0,45
140980605,7,9,3,7,5,2,0,1,34
140980606,8,13,12,7,4,3,1,2,50
140980607,18,23,9,13,6,4,2,0,75
140980608,13,29,22,15,8,3,3,0,93
140980609,10,12,4,7,3,0,0,0,36
140980701,6,10,5,2,0,3,1,0,27
140980702,14,8,10,9,6,1,1,1,50
140980703,16,6,7,8,9,3,0,0,49
140980704,10,17,11,13,11,5,2,1,70
140980705,0,8,9,3,0,0,0,0,20
140980706,12,9,5,2,2,0,1,0,31
140980707,15,14,11,6,7,2,0,0,55
140980708,9,18,8,7,2,1,2,1,48
140980801,9,14,9,6,7,3,0,1,49
140980802,7,13,9,10,5,2,3,0,49
140980803,16,14,13,13,8,4,0,0,68
140980804,20,15,12,12,6,4,1,2,72
140980805,4,6,6,4,0,0,0,0,20
140980806,11,13,20,16,9,2,0,0,71
140980807,33,57,39,25,11,3,2,1,171
140980808,75,77,46,39,28,9,5,1,280
140980809,48,45,41,40,15,11,1,4,205
140980810,31,41,29,30,9,6,3,3,152
140980811,29,24,15,22,15,0,1,0,106
140980901,7,16,5,10,5,2,0,1,46
140980902,23,33,33,29,21,4,2,0,145
140980903,10,16,13,10,9,2,1,0,61
140980904,32,44,37,47,20,10,8,4,202
140980905,41,67,51,47,15,5,3,1,230
140980906,45,80,48,61,20,10,1,0,265
140980907,74,87,52,32,12,3,0,1,261
140980908,60,83,41,37,15,7,1,0,244
140980909,38,72,63,47,26,7,3,4,260
140980910,27,62,55,44,16,6,4,1,215
140980911,24,35,24,22,8,4,1,0,118
140980912,74,94,77,60,35,14,6,5,365
140980913,78,93,47,39,13,8,1,0,279
140980914,57,63,55,52,26,9,1,0,263
140981001,1,4,3,0,3,1,0,0,12
140981002,2,4,7,3,3,0,0,0,19
140981003,22,35,45,32,20,17,3,4,178
140981004,6,17,10,10,6,2,0,0,51
140981005,7,15,6,4,12,3,0,0,47
140981006,10,9,8,7,2,2,0,0,38
140981007,6,13,12,11,10,3,1,0,56
140981008,8,12,17,13,9,5,0,0,64
140981009,36,36,26,29,20,8,11,2,168
140981010,30,56,50,39,18,7,2,0,202
140981011,32,71,61,68,40,22,8,5,307
140981012,44,52,48,34,19,12,6,4,219
140981013,45,58,52,67,31,16,6,7,282
140981014,35,64,47,53,30,13,2,1,245
140981101,15,28,16,9,11,2,5,0,86
140981102,18,21,19,17,12,4,2,0,93
140981103,5,5,4,3,4,1,0,0,22
140981104,5,7,6,3,1,0,0,0,22
140981105,4,11,6,3,5,2,0,1,32
140981106,24,18,22,14,13,3,1,2,97
140981107,14,12,16,14,8,1,1,0,66
140981108,7,10,5,10,3,3,0,0,38
140981109,28,61,59,50,30,19,1,4,252
140981110,37,45,35,43,23,6,3,3,195
140981111,69,74,53,39,23,10,5,2,275
140981201,11,10,23,15,6,4,3,2,74
140981202,14,20,18,20,7,5,3,0,87
140981203,9,21,26,24,21,5,5,2,113
140981204,24,33,23,28,16,7,2,1,134
140981205,4,7,9,6,6,2,1,0,35
140981206,12,19,21,14,18,7,2,4,97
140981207,32,58,62,54,29,18,5,5,263
140981208,77,79,41,42,20,4,1,0,264
140981209,41,48,45,31,12,6,2,2,187
140981210,34,55,44,28,23,8,1,0,193
140981211,34,53,28,33,19,9,0,1,177
140981212,41,39,51,43,23,11,1,5,214
140981301,11,12,9,11,2,3,1,0,49
140981302,14,4,12,14,3,1,0,0,48
140981303,5,5,12,9,7,1,1,1,41
140981304,8,9,7,9,7,1,1,0,42
140981305,11,8,8,6,2,0,0,0,35
140981306,5,12,4,4,3,1,0,0,29
140981307,7,2,4,1,0,0,0,0,14
140981308,7,10,6,4,3,1,1,0,32
140981309,24,22,10,4,2,2,0,1,65
140981310,27,21,8,3,6,2,0,0,67
140981311,55,38,35,53,29,13,6,4,233
140981312,52,88,68,60,28,18,8,7,329
140981313,27,28,30,26,26,13,6,9,165
140981401,8,14,9,14,8,3,0,2,58
140981402,17,4,10,10,2,2,0,1,46
140981403,19,12,13,1,5,0,0,0,50
140981404,8,16,10,11,5,4,0,1,55
140981405,17,10,7,10,6,2,2,1,55
140981406,8,7,10,8,4,1,1,1,40
140981407,10,12,6,5,3,0,0,2,38
140981408,1,11,9,2,2,4,1,1,31
140981409,27,29,20,30,14,9,2,1,132
140981410,32,58,52,51,42,21,2,12,270
140981501,42,70,72,83,25,17,3,11,323
140981502,42,59,77,75,31,23,6,8,321
140981503,26,62,94,85,40,33,11,4,355
140981504,30,58,61,83,35,16,1,5,289
140981505,33,52,54,46,41,10,2,3,241
140981506,21,47,50,54,29,9,4,3,217
140981507,64,79,60,45,19,15,4,2,288
140981508,29,71,47,55,25,9,2,1,239
140981509,37,73,81,67,43,19,8,2,330
140981510,54,89,62,69,42,21,5,4,346
140981511,20,55,64,75,51,11,2,0,278
140981512,9,28,26,55,37,9,0,1,165
140981513,63,94,77,57,35,25,6,2,359
140981514,49,89,72,70,26,13,3,2,324
140981515,62,76,52,39,12,3,3,0,247
140981601,39,44,63,74,39,15,4,5,283
140981602,33,70,88,95,47,22,11,5,371
140981603,29,51,42,38,11,13,3,6,193
140981604,23,67,36,41,20,12,1,7,207
140981605,78,119,79,73,32,13,5,0,399
140981606,19,43,48,33,16,13,3,1,176
140981607,36,47,44,47,33,6,7,5,225
140981608,14,23,42,70,34,8,1,1,193
140981609,91,93,98,69,49,23,5,4,432
140981610,82,108,78,57,36,19,6,10,396
140981611,124,108,61,37,9,6,1,0,346
140981612,150,114,42,24,16,5,1,1,353
140981613,72,58,26,18,9,1,1,1,186
140981614,73,72,27,19,3,3,0,0,197
140981615,67,62,27,13,4,2,1,0,176
140981701,55,75,87,97,67,32,13,10,436
140981702,21,50,49,74,46,22,13,8,283
140981703,37,60,80,70,28,14,5,3,297
140981704,32,51,49,56,11,6,2,1,208
140981705,77,102,91,70,35,21,2,3,401
140981706,43,51,42,51,29,9,6,5,236
140981707,24,55,45,44,23,9,2,2,204
140981708,39,69,72,70,38,21,5,4,318
140981709,27,43,68,46,37,19,5,4,249
140981710,38,83,60,55,18,11,1,0,266
140981711,62,89,78,48,35,11,1,0,324
140981712,58,99,84,107,56,22,7,2,435
140981713,39,81,62,47,30,12,4,1,276
140981801,70,121,79,74,39,25,6,3,417
140981802,63,110,76,74,46,22,4,4,399
140981803,73,72,97,106,70,20,11,5,454
140981804,62,107,91,99,45,21,10,6,441
140981805,38,82,80,84,64,26,3,5,382
140981806,47,86,58,53,27,16,5,3,295
140981807,45,97,50,80,29,8,3,3,315
140981808,47,75,68,66,43,21,5,6,331
140981809,62,81,98,118,60,23,6,3,451
140981810,78,113,102,76,51,11,7,4,442
140981811,54,90,80,57,29,5,2,2,319
140981812,56,73,61,65,31,12,4,3,305
140981813,46,59,78,57,36,23,7,7,313
140981901,26,34,54,42,22,16,3,4,201
140981902,59,87,104,142,94,66,19,24,595
140981903,39,64,70,68,46,26,14,8,335
140981904,25,44,41,38,41,20,12,11,232
140981905,23,34,48,44,33,11,12,8,213
140981906,22,51,48,45,31,22,3,9,231
140981907,32,36,34,46,39,18,9,9,223
140981908,40,53,52,48,38,24,8,5,268
140981909,40,64,33,35,26,11,2,6,217
140981910,48,52,59,43,21,2,4,3,232
140981911,65,74,79,40,26,16,9,3,312
140981912,59,85,60,78,33,12,6,2,335
140982001,28,35,16,16,11,6,2,1,115
140982002,72,63,37,33,19,5,1,0,230
140982003,95,88,46,35,19,4,0,0,287
140982004,66,56,29,20,5,1,1,1,179
140982005,47,53,23,14,2,0,0,0,139
140982006,117,96,66,31,16,4,3,1,334
140982007,95,79,58,13,5,5,1,0,256
140982008,120,104,70,42,22,7,4,4,373
140982009,44,61,46,38,23,9,4,4,229
140982010,75,93,53,41,22,11,0,0,295
140982011,77,62,30,7,4,3,0,0,183
140982012,66,76,39,21,5,4,0,0,211
140982013,94,78,24,19,4,3,1,0,223
140982014,96,83,24,16,10,1,0,0,230
140982015,53,50,23,15,10,2,2,0,155
140982016,108,99,46,18,12,1,0,0,284
140982017,102,101,54,37,19,3,0,0,316
140982018,122,124,54,34,10,3,1,1,349
140982019,37,25,9,12,5,4,1,0,93
140982020,81,81,24,7,5,2,0,0,200
140982021,98,86,31,14,6,1,0,0,236
140982022,93,69,24,11,7,4,0,2,210
140982101,14,43,64,69,40,19,7,5,261
140982102,24,36,36,49,25,9,6,3,188
140982103,81,127,85,72,30,14,7,3,419
140982104,55,87,56,30,25,6,1,0,260
140982105,46,66,60,40,15,8,1,1,237
140982106,59,54,39,24,15,4,1,2,198
140982107,81,73,43,21,8,5,2,0,233
140982108,87,100,75,48,24,10,2,1,347
140982109,86,115,65,50,15,4,3,1,339
140982110,52,81,72,63,38,19,1,2,328
140982111,65,95,74,46,35,19,3,4,341
140982112,27,37,50,80,22,25,8,5,254
140982113,40,46,56,57,51,22,10,5,287
140982114,50,73,79,64,31,21,11,11,340
140982201,61,90,71,91,54,24,6,2,399
140982202,56,117,88,87,37,10,0,2,397
140982203,41,72,86,96,33,14,0,3,345
140982204,18,36,54,41,28,14,5,5,201
140982205,60,124,73,83,41,12,2,3,398
140982206,59,97,67,78,47,10,2,0,360
140982207,31,67,74,81,52,18,6,6,335
140982208,23,41,76,76,41,26,12,9,304
140982209,29,62,46,69,36,19,5,5,271
140982210,46,63,68,80,44,31,12,13,357
140982211,36,56,65,45,37,30,12,18,299
140982212,41,43,43,33,47,11,7,5,230
140982301,72,110,75,65,25,8,2,1,358
140982302,41,74,67,51,16,11,4,1,265
140982303,41,61,55,40,24,8,2,1,232
140982304,65,102,94,84,46,15,4,4,414
140982305,31,57,42,31,12,4,1,0,178
140982306,58,69,69,36,23,7,2,3,267
140982307,39,42,37,46,16,11,2,1,194
140982308,44,87,80,72,27,18,1,3,332
140982309,28,56,51,67,33,18,1,4,258
140982310,27,50,56,69,27,20,2,3,254
140982311,30,58,64,50,35,23,1,1,262
140982312,54,102,97,90,52,20,4,4,423
140982313,47,83,69,79,30,20,2,4,334
140982314,17,34,44,72,31,13,8,3,222
140982401,84,122,48,28,7,5,0,1,295
140982402,86,67,33,14,7,5,0,0,212
140982403,39,40,24,19,8,6,0,2,138
140982404,84,101,70,34,30,9,0,0,328
140982405,154,114,39,32,21,6,2,0,368
140982406,124,108,70,45,16,9,1,2,375
140982407,66,79,23,10,9,1,1,0,189
140982408,82,66,31,10,10,2,0,0,201
140982409,85,115,58,38,9,5,1,0,311
140982410,93,89,47,45,16,7,1,0,298
140982411,132,112,70,35,8,7,0,1,365
140982412,74,105,58,47,22,8,0,1,315
140982413,91,98,66,42,21,5,3,1,327
140982414,96,121,60,44,26,8,0,1,356
140982415,69,79,39,27,11,1,0,3,229
140982416,81,93,56,35,19,4,2,0,290
140982417,82,108,45,40,24,6,2,1,308
140982418,61,75,53,31,16,2,0,0,238
140982419,49,63,31,16,6,3,0,1,169
140982420,77,123,64,60,24,5,3,0,356
140982421,51,79,53,38,21,6,1,2,251
140982501,71,77,63,51,35,7,1,3,308
140982502,73,101,90,65,34,10,3,2,378
140982503,48,71,76,52,28,13,0,2,290
140982504,47,60,66,55,34,16,4,1,283
140982505,55,78,81,79,43,25,10,5,376
140982506,50,86,75,76,43,28,9,11,378
140982507,34,54,75,71,54,31,13,18,350
140982508,31,67,67,79,48,24,10,9,335
140982509,26,58,48,49,28,18,3,3,233
140982510,41,63,55,40,26,10,4,5,244
140982511,48,77,93,92,57,29,20,11,427
140982512,55,75,76,71,62,30,23,25,417
140982601,52,74,58,57,29,15,4,1,290
140982602,54,84,52,54,38,11,6,0,299
140982603,43,107,103,116,45,24,5,4,447
140982604,67,102,89,74,32,14,2,3,383
140982605,33,59,55,66,40,20,9,9,291
140982606,32,59,57,44,35,18,4,2,251
140982607,61,76,74,74,24,13,4,2,328
140982608,42,64,60,69,39,19,8,11,312
140982609,26,46,58,60,34,24,6,6,260
140982610,28,42,43,66,30,28,10,10,257
140982611,36,49,57,47,41,25,7,7,269
140982612,29,44,59,78,40,19,11,12,292
140982613,15,32,31,38,27,19,2,9,173
140982701,67,74,56,71,45,32,10,13,368
140982702,43,86,88,82,41,25,4,12,381
140982703,77,114,65,63,35,8,4,1,367
140982704,69,70,42,26,15,4,0,0,226
140982705,58,69,62,40,29,12,4,0,274
140982706,51,75,48,50,28,5,1,0,258
140982707,78,84,72,53,31,13,2,2,335
140982708,52,73,53,82,35,11,2,3,311
140982801,71,91,83,75,35,23,3,2,383
140982802,49,89,72,72,32,9,2,1,326
140982803,58,61,34,23,15,4,1,0,196
140982804,42,53,41,26,17,6,3,0,188
140982805,45,42,43,34,30,9,5,3,211
140982806,28,44,47,48,32,15,6,12,232
140982807,23,43,52,38,30,13,12,9,220
140982808,41,58,35,23,17,8,0,0,182
140982809,52,74,69,42,22,11,2,2,274
140982810,53,71,47,48,17,11,3,5,255
140982811,33,46,30,35,20,13,4,6,187
140982812,54,60,55,57,27,15,5,1,274
140982901,41,57,47,53,30,14,8,4,254
140982902,49,58,62,50,34,16,9,7,285
140982903,40,42,35,25,9,9,3,0,163
140982904,45,61,37,40,27,5,3,1,219
140982905,29,39,43,37,19,13,5,8,193
140982906,57,67,39,29,21,12,6,4,235
140982907,35,41,22,20,15,2,2,1,138
140982908,43,50,31,29,7,6,0,1,167
140982909,34,33,45,39,20,8,3,1,183
140982910,36,67,50,52,37,14,0,3,259
140982911,31,51,44,55,24,16,4,6,231
140982912,29,35,33,48,38,19,6,9,217
140982913,35,50,54,58,34,20,12,4,267
140982914,47,60,67,69,43,16,3,5,310
141050101,24,15,15,9,9,5,2,3,82
141050102,11,5,4,6,1,1,4,3,35
141050103,30,29,22,23,11,3,2,4,124
141050104,4,5,9,8,5,2,1,0,34
141050105,4,8,5,1,1,1,0,0,20
141050106,14,20,17,12,10,1,2,3,79
141050107,17,16,10,4,6,2,0,1,56
141050108,17,25,13,14,5,5,2,5,86
141050109,34,27,25,16,13,4,1,7,127
141050110,11,10,17,11,11,9,1,3,73
141050111,7,12,11,10,10,2,7,2,61
141050112,31,40,40,28,19,15,7,9,189
141050113,31,36,29,43,22,11,6,18,196
141050114,46,66,36,50,37,16,12,12,275
141050201,8,4,6,2,2,4,0,0,26
141050202,1,3,3,6,1,1,1,0,16
141050203,10,14,7,10,7,7,3,5,63
141050204,9,5,7,5,2,2,1,2,33
141050205,7,13,10,20,8,6,3,4,71
141050206,17,5,8,19,5,8,2,0,64
141050207,11,5,3,1,4,3,0,0,27
141050208,15,21,8,9,4,9,2,2,70
141050209,12,14,10,4,7,1,1,0,49
141050210,17,24,32,32,14,12,1,3,135
141050211,36,59,51,40,40,14,3,4,247
141050212,38,47,47,36,30,10,2,6,216
141050213,48,62,38,32,17,5,1,6,209
141050214,48,53,46,53,28,16,4,6,254
141050215,68,73,64,45,34,17,6,4,311
141050216,70,64,89,69,29,25,5,5,356
141050217,65,60,45,61,33,22,16,10,312
141050301,0,6,3,5,1,2,0,0,17
141050302,6,11,9,8,5,1,0,4,44
141050303,7,10,12,13,7,4,1,1,55
141050304,6,2,8,4,1,0,2,0,23
141050305,13,25,20,23,15,7,3,3,109
141050306,6,6,6,7,9,6,3,1,44
141050307,8,10,7,7,3,1,0,2,38
141050308,18,36,22,29,22,10,5,4,146
141050309,76,71,69,75,41,18,9,8,367
141050310,44,64,62,56,42,11,6,8,293
141050311,33,29,34,26,15,9,7,6,159
141050312,23,44,55,42,27,24,4,9,228
141050313,55,60,67,67,43,24,13,13,342
141050314,60,56,69,50,37,23,8,12,315
141050315,62,67,52,79,39,20,7,6,332
141050316,64,60,61,60,31,9,2,0,287
141050401,4,1,2,4,1,1,0,0,13
141050402,12,8,7,11,6,5,0,1,50
141050403,2,5,4,4,3,2,0,1,21
141050404,12,12,9,11,5,4,1,1,55
141050405,10,9,5,9,4,3,2,2,44
141050406,12,8,6,7,8,7,0,4,52
141050407,10,14,6,10,8,7,5,4,64
141050408,5,5,2,5,5,5,0,0,27
141050409,6,10,6,9,3,3,2,1,40
141050410,17,26,21,11,16,3,2,1,97
141050411,1,6,4,6,2,4,0,0,23
141050412,3,10,3,13,6,4,2,1,42
141050413,8,2,7,5,7,2,0,0,31
141050414,15,15,31,27,28,14,4,7,141
141050415,35,54,51,53,30,17,2,2,244
141050416,18,18,14,14,8,5,4,4,85
141050501,10,7,4,12,6,3,1,0,43
141050502,15,19,19,18,13,11,5,2,102
141050503,66,39,36,50,26,13,10,8,248
141050504,27,44,29,26,18,12,2,8,166
141050505,22,56,66,79,53,33,11,14,334
141050506,26,45,65,63,28,10,5,1,243
141050507,32,45,45,55,36,15,3,3,234
141050508,34,55,61,58,48,26,4,15,301
141050509,17,20,34,67,37,20,12,4,211
141050510,37,69,51,70,30,27,4,6,294
141050511,35,50,41,50,28,6,4,2,216
141050512,35,36,48,42,38,16,6,4,225
141050513,26,26,26,29,22,7,3,2,141
141050514,47,82,80,65,54,30,14,20,392
141050515,49,54,48,35,33,15,8,5,247
141050601,15,15,10,13,10,2,3,0,68
141050602,15,15,12,14,10,6,4,4,80
141050603,9,16,8,6,8,5,1,4,57
141050604,18,19,13,24,22,7,5,5,113
141050605,11,14,16,20,10,11,3,5,90
141050606,19,29,37,42,24,16,3,3,173
141050607,28,37,35,40,28,10,5,3,186
141050608,56,62,60,52,39,16,8,5,298
141050609,46,72,56,76,31,13,4,2,300
141050610,60,74,62,77,46,28,7,12,366
141050611,28,52,68,68,43,32,12,14,317
141050612,41,63,92,85,46,36,9,12,384
141050613,11,14,21,22,22,4,2,3,99
141120101,3,0,4,2,2,1,1,3,16
141120102,12,11,7,1,2,1,1,5,40
141120103,13,12,3,8,5,2,2,1,46
141120104,15,22,15,16,13,6,2,5,94
141120105,11,8,5,7,4,3,0,6,44
141120106,23,17,19,13,9,5,0,0,86
141120107,5,5,3,5,2,0,0,4,24
141120108,5,10,10,14,5,0,1,3,48
141120109,27,38,37,42,26,15,7,6,198
141120110,26,40,35,45,22,18,5,6,197
141120111,30,34,26,24,9,10,0,1,134
141120112,42,39,54,49,44,33,13,19,293
141120113,31,47,48,41,18,11,5,2,203
141120114,20,28,16,19,19,5,2,4,113
141120115,22,30,34,41,20,14,6,9,176
141120201,41,36,41,26,21,8,9,5,187
141120202,10,4,3,2,2,1,1,0,23
141120203,4,3,4,1,3,2,0,3,20
141120204,4,2,3,4,3,2,0,1,19
141120205,3,6,4,0,2,2,2,1,20
141120206,12,5,13,8,4,6,1,3,52
141120207,18,18,29,24,18,10,11,9,137
141120301,2,14,5,9,1,3,0,0,34
141120302,19,22,19,11,13,4,0,3,91
141120303,6,10,8,5,2,7,0,1,39
141120304,30,46,40,32,20,11,6,3,188
141120305,10,18,12,12,8,9,2,1,72
141120306,42,28,19,15,8,2,5,5,124
141120307,20,13,10,14,5,5,0,1,68
141120308,8,12,5,7,2,0,2,0,36
141120309,14,10,16,7,11,7,1,2,68
141120310,43,40,39,28,30,17,4,5,206
141120311,38,30,30,31,25,16,13,9,192
141120312,44,47,52,40,36,19,10,9,257
141120313,32,46,44,51,28,17,6,11,235
141120314,12,17,12,13,5,3,1,3,66
141190101,30,55,47,52,35,29,9,15,272
141190102,9,20,15,14,5,6,1,3,73
141190103,4,15,11,11,6,3,0,2,52
141190104,2,3,6,2,3,0,0,1,17
141190105,0,5,7,9,5,0,0,0,26
141190106,39,61,44,31,20,8,1,1,205
141190107,34,47,36,34,20,11,3,5,190
141190108,58,72,69,67,34,20,6,3,329
141190109,58,83,72,86,52,14,7,4,376
141190110,40,35,28,25,14,11,1,0,154
141190111,39,70,53,51,33,7,2,0,255
141190112,55,73,84,57,39,12,2,2,324
141190113,52,60,61,42,27,7,1,0,250
141190114,24,48,55,70,48,28,5,4,282
141190115,60,65,78,57,41,11,3,2,317
141190201,3,1,6,2,1,1,0,0,14
141190202,2,7,2,2,2,3,1,2,21
141190203,2,7,3,1,1,0,0,0,14
141190204,7,5,0,1,2,0,1,0,16
141190205,16,13,5,13,4,3,0,1,55
141190206,3,1,1,1,2,0,0,0,8
141190207,2,2,0,0,0,0,0,0,4
141190208,0,1,1,0,1,1,0,0,4
141190209,4,0,2,11,4,2,0,0,23
141190210,4,2,1,5,2,1,0,0,15
141190211,2,5,8,6,2,3,0,1,27
141190212,33,22,28,21,15,20,4,5,148
141190213,60,88,49,57,33,18,9,3,317
141190214,36,55,40,56,26,17,6,6,242
141190215,50,36,40,42,30,9,2,4,213
141190301,14,19,27,21,16,10,2,1,110
141190302,12,19,10,20,11,12,2,3,89
141190303,12,10,21,13,7,3,2,3,71
141190304,8,2,15,7,4,0,1,3,40
141190305,3,4,4,13,2,4,0,2,32
141190306,54,64,67,53,21,17,10,5,291
141190307,45,58,55,60,32,21,7,6,284
141190308,49,57,59,64,38,11,5,2,285
141190309,13,15,28,17,9,11,2,1,96
141190310,48,52,39,51,31,12,5,2,240
141190311,39,46,40,46,32,15,3,7,228
141190312,35,31,40,37,39,8,4,5,199
141190313,25,37,40,52,36,14,5,3,212
141190314,80,92,75,75,57,17,6,1,403
141190315,61,87,63,56,35,11,3,2,318
141190316,48,68,73,83,37,18,6,4,337
141190401,1,3,2,2,4,0,1,0,13
141190402,6,3,8,6,6,1,0,0,30
141190403,8,2,1,3,2,2,0,0,18
141190404,3,7,10,6,0,2,0,1,29
141190405,4,2,4,6,4,0,0,0,20
141190406,2,8,7,10,6,3,1,2,39
141190407,7,12,10,17,8,4,2,2,62
141190408,7,6,15,8,6,8,2,3,55
141190409,11,21,27,25,21,4,5,6,120
141190410,58,86,79,71,49,13,12,6,374
141190411,72,91,71,85,44,19,9,1,392
141190412,54,59,50,48,28,6,3,3,251
141190413,83,81,64,59,41,14,3,4,349
141190414,53,76,49,56,38,13,5,3,293
141190415,49,67,47,35,22,8,4,1,233
141190416,18,51,49,50,19,11,2,7,207
141190417,38,51,43,36,22,11,4,7,212
141190418,99,102,68,63,39,14,2,2,389
141190419,79,89,53,36,13,8,1,1,280
141190420,40,45,64,58,36,18,5,5,271
141190501,18,17,24,8,5,4,5,1,82
141190502,1,2,3,6,3,0,0,0,15
141190503,12,8,12,19,8,4,1,1,65
141190504,13,20,15,9,10,2,0,2,71
141190505,6,11,5,10,5,1,0,0,38
141190506,6,8,5,6,3,1,4,1,34
141190507,5,1,2,3,0,0,0,0,11
141190508,7,11,5,5,1,5,2,1,37
141190509,3,3,4,4,2,0,0,0,16
141190510,1,3,5,2,2,1,1,1,16
141190511,44,51,55,67,28,16,7,4,272
141190512,54,66,49,46,33,20,3,1,272
141190513,58,54,35,33,22,11,5,3,221
141190514,49,56,73,61,38,14,7,1,299
141190515,34,63,53,40,27,12,4,5,238
141190601,40,62,80,59,49,23,15,22,350
141190602,56,72,62,75,40,21,5,11,342
141190603,45,59,58,64,42,15,6,7,296
141190604,48,70,41,50,27,7,3,2,248
141190605,47,67,83,93,52,25,10,7,384
141190606,37,79,60,71,71,32,12,15,377
141190607,58,82,72,49,29,12,4,2,308
141190608,46,69,45,40,17,5,1,2,225
141190609,54,52,51,54,25,12,6,1,255
141190610,30,43,52,42,43,22,9,7,248
141190611,45,56,57,46,36,30,7,6,283
141190612,45,57,58,58,33,17,8,7,283
141190613,60,76,36,35,16,8,0,2,233
141190614,24,44,46,27,16,0,2,0,159
141190615,29,54,45,51,28,7,3,3,220
141190616,26,36,41,67,39,17,2,7,235
141190617,17,28,57,75,27,9,3,2,218
141190618,21,66,55,56,35,11,4,6,254
141190619,28,50,62,68,44,24,11,8,295
141190620,28,61,57,45,45,29,9,13,287
141190621,24,55,51,64,47,22,17,9,289
141190701,41,55,50,66,50,17,10,15,304
141190702,39,64,66,59,44,16,7,8,303
141190703,59,86,89,92,58,41,13,6,444
141190704,49,81,62,90,44,22,7,8,363
141190705,37,82,69,82,45,23,2,2,342
141190706,50,95,69,83,44,14,1,5,361
141190707,61,94,52,63,26,8,2,0,306
141190708,49,55,59,70,41,23,15,6,318
141190709,31,47,50,78,53,25,6,5,295
141190710,67,108,64,59,34,17,3,1,353
141190711,28,42,63,48,33,9,2,3,228
141190712,38,56,46,57,36,19,3,5,260
141190713,29,57,40,64,43,24,7,7,271
141190714,32,43,44,43,28,14,8,3,215
141190801,23,30,59,62,50,38,13,12,287
141190802,28,40,43,31,31,20,7,12,212
141190803,25,45,38,54,18,6,3,4,193
141190804,59,64,40,35,30,11,2,0,241
141190805,42,57,48,50,22,11,6,1,237
141190806,31,40,46,43,27,17,7,4,215
141190807,26,37,60,48,21,23,7,6,228
141190808,53,74,69,79,46,19,5,2,347
141190809,60,91,68,64,28,15,2,3,331
141190810,79,81,62,57,34,14,2,2,331
141190811,69,82,50,53,35,8,2,3,302
141190812,51,68,76,55,44,18,9,5,326
141190813,62,71,63,55,29,11,3,4,298
141190814,62,78,57,46,30,16,1,8,298
141190815,72,89,88,80,37,19,10,7,402
141190816,51,59,55,28,32,11,6,2,244
141190817,28,43,55,50,32,15,10,8,241
141190901,24,54,58,57,40,7,4,4,248
141190902,52,58,63,55,33,15,3,8,287
141190903,30,54,34,30,26,5,2,0,181
141190904,39,56,61,47,30,5,3,3,244
141190905,47,64,54,54,22,12,2,1,256
141190906,48,59,41,40,26,5,5,2,226
141190907,35,59,41,46,14,13,0,1,209
141190908,56,62,50,50,18,4,1,0,241
141190909,59,78,60,47,18,8,1,2,273
141190910,47,57,34,29,5,6,0,0,178
141190911,47,70,76,64,26,10,2,0,295
141190912,69,90,69,85,43,15,2,1,374
141190913,45,59,35,23,18,3,1,0,184
141190914,49,89,68,66,32,12,1,2,319
141190915,30,66,41,60,25,6,0,3,231
141190916,32,59,70,86,38,11,6,6,308
141190917,70,91,70,79,32,5,2,0,349
141260101,9,9,7,13,4,1,1,0,44
141260102,11,7,12,5,7,1,2,2,47
141260103,10,10,2,11,8,1,1,4,47
141260104,14,12,11,4,4,3,0,4,52
141260105,4,1,4,1,0,2,0,0,12
141260106,9,5,6,6,0,3,1,2,32
141260107,15,7,9,8,3,1,0,1,44
141260108,7,15,6,12,4,3,2,4,53
141260109,24,32,16,19,14,6,3,5,119
141260201,15,5,8,4,3,5,3,4,47
141260202,3,2,0,2,1,1,0,0,9
141260203,6,4,12,3,0,4,4,0,33
141260204,7,11,11,10,9,4,1,7,60
141260205,4,6,5,6,0,2,0,1,24
141260206,41,30,43,44,28,17,6,14,223
141260207,6,7,8,4,3,4,2,0,34
141260208,24,18,28,40,22,11,10,12,165
141260301,3,5,2,2,1,0,1,2,16
141260302,1,2,0,0,0,0,0,0,3
141260303,20,26,21,20,9,7,5,7,115
141260304,44,40,42,58,45,23,7,8,267
141260305,10,12,5,6,6,4,1,2,46
141260306,11,8,6,4,5,1,4,1,40
141260307,29,25,46,30,24,17,8,12,191
141260308,34,37,50,54,44,19,7,6,251
141260309,28,44,19,43,15,13,3,0,165
141260310,18,41,24,21,13,6,1,1,125
141260311,45,69,71,37,18,9,7,4,260
141260312,46,59,50,37,34,17,1,1,245
141260313,28,31,55,32,38,21,6,9,220
141260314,35,45,57,55,52,37,9,11,301
141260401,19,25,16,16,12,8,0,0,96
141260402,9,4,6,7,4,2,2,1,35
141260403,5,9,9,5,4,1,0,1,34
141260404,14,22,20,18,12,9,3,5,103
141260405,10,6,9,4,7,5,1,0,42
141260406,18,30,35,21,22,7,4,3,140
141260501,7,7,0,2,0,1,0,0,17
141260502,17,14,21,12,15,12,5,2,98
141260503,3,0,2,1,0,0,0,0,6
141260504,9,11,17,33,15,9,5,7,106
141260505,10,14,16,23,12,15,2,2,94
141260506,2,15,11,12,10,2,5,6,63
141260507,7,22,20,19,17,12,6,9,112
141260508,15,41,47,57,32,21,10,10,233
141260509,32,38,48,77,51,42,17,16,321
141260510,22,30,50,52,38,22,4,5,223
141260511,21,49,69,49,24,21,7,8,248
141260512,52,78,88,70,41,24,10,7,370
141260513,14,21,25,31,22,21,5,8,147
141260514,16,26,37,56,23,23,12,10,203
141260515,17,17,31,25,21,2,6,3,122
141260516,8,34,34,49,38,27,8,8,206
141260517,16,31,38,31,19,24,5,6,170
141260518,12,16,24,28,20,12,6,5,123
141260601,15,22,2,11,11,3,2,2,68
141260602,6,5,7,4,1,1,1,2,27
141260603,13,29,24,29,11,6,2,2,116
141260604,20,23,23,19,10,9,1,5,110
141260605,23,30,22,19,14,7,6,4,125
141260606,1,1,1,1,0,1,2,0,7
141260607,28,34,29,15,18,5,1,5,135
141260608,34,45,36,36,13,16,1,5,186
141260609,23,45,31,31,15,8,4,3,160
141260610,33,53,41,20,12,11,3,8,181
141260611,7,14,6,2,3,1,0,3,36
141260701,32,50,30,29,10,2,1,3,157
141260702,34,52,45,49,19,9,6,9,223
141260703,41,50,23,22,14,5,3,1,159
141260704,21,36,44,40,31,17,8,5,202
141260705,58,78,43,38,23,9,2,3,254
141260706,56,58,41,36,13,4,2,6,216
141260707,26,40,50,42,26,10,1,4,199
141260708,35,59,60,60,32,13,4,4,267
141260709,35,51,50,27,27,7,2,1,200
141260710,33,26,22,23,14,8,5,10,141
141260711,34,32,47,35,22,18,6,8,202
141260712,34,53,68,51,27,21,3,1,258
141260713,16,30,11,15,14,1,1,1,89
141330101,5,5,3,1,4,0,1,2,21
141330102,17,15,21,13,17,10,3,3,99
141330103,25,10,24,27,20,11,9,6,132
141330104,21,15,27,24,10,14,2,7,120
141330105,35,44,61,41,37,25,8,17,268
141330106,9,1,2,4,4,1,1,1,23
141330107,8,6,12,6,5,3,0,0,40
141330108,27,37,44,39,23,18,9,21,218
141330109,9,15,17,8,12,13,5,11,90
141330110,39,48,65,41,35,26,9,8,271
141330111,33,49,60,60,47,32,19,15,315
141330112,30,31,58,48,41,23,12,18,261
141330201,27,32,44,23,23,8,6,2,165
141330202,17,17,15,11,9,3,2,2,76
141330203,9,13,14,13,11,0,0,3,63
141330204,55,41,59,56,31,19,8,6,275
141330205,14,14,18,15,12,7,0,6,86
141330206,10,13,14,12,11,6,6,2,74
141330207,18,36,31,13,17,7,2,2,126
141330208,47,49,36,29,15,15,7,4,202
141330209,31,37,20,11,7,5,0,2,113
141330210,15,18,11,12,4,5,3,2,70
141330211,42,34,37,29,16,14,3,4,179
141330212,31,49,37,28,15,7,4,1,172
141330213,70,88,74,68,26,15,3,4,348
141330214,36,63,56,46,19,12,3,6,241
141330215,8,14,14,10,5,3,1,2,57
141330216,30,51,36,35,24,7,5,7,195
141330301,18,13,10,14,7,4,6,7,79
141330302,25,25,28,14,14,11,3,5,125
141330303,18,5,16,7,3,6,6,5,66
141330304,33,28,24,27,15,7,7,6,147
141330305,25,23,16,17,17,9,4,8,119
141330306,14,10,17,17,11,12,6,5,92
141330307,67,93,72,48,44,12,7,12,355
141330308,27,20,17,19,9,14,6,12,124
141330309,36,49,35,46,23,17,3,6,215
141330401,3,5,11,3,0,1,0,1,24
141330402,5,7,6,9,7,4,2,4,44
141330403,10,7,8,8,9,3,1,3,49
141330404,10,16,6,12,9,9,0,0,62
141330405,29,29,25,23,9,7,5,3,130
141330406,10,16,8,10,3,4,1,3,55
141330407,15,13,10,14,7,4,3,6,72
141330408,23,34,21,24,14,6,5,2,129
141330409,70,82,78,60,46,18,6,9,369
141330410,23,51,15,23,8,9,4,1,134
141330411,41,39,40,25,13,7,4,6,175
141330501,40,71,62,59,47,21,5,12,317
141330502,51,60,40,33,13,9,2,2,210
141330503,51,44,46,35,26,12,2,7,223
141330504,39,49,46,40,35,11,7,11,238
141330505,25,22,44,43,43,21,17,23,238
141330506,48,72,55,63,47,13,11,7,316
141330507,76,75,48,41,20,9,2,2,273
141330508,55,91,41,36,16,7,2,2,250
141330509,59,70,52,26,17,9,2,1,236
141330510,63,106,73,61,31,15,3,3,355
141330511,56,60,48,58,33,19,8,5,287
141330512,34,50,81,70,37,37,15,12,336
141330513,19,40,63,54,29,25,7,4,241
141330514,15,26,37,30,10,7,1,3,129
141330515,40,58,76,86,61,29,14,15,379
141330516,40,57,59,57,27,14,4,5,263
141330517,27,45,48,50,33,20,3,8,234
141330601,63,80,69,38,30,10,1,0,291
141330602,82,102,80,81,34,19,4,4,406
141330603,49,74,54,53,36,12,4,3,285
141330604,35,54,47,45,39,18,1,2,241
141330605,44,41,54,71,28,22,7,8,275
141330606,28,45,43,27,17,10,4,3,177
141330607,37,35,52,66,31,35,7,26,289
141330608,39,47,58,44,22,16,4,7,237
141330609,73,89,43,31,13,5,5,2,261
141330610,73,74,74,40,14,7,1,4,287
141330611,32,36,51,38,27,11,2,5,202
141330612,25,46,37,38,12,15,1,3,177
141330613,36,76,71,80,49,20,9,6,347
141330614,27,68,72,72,46,24,5,11,325
141330615,35,66,44,44,26,10,2,4,231
141330616,37,54,49,48,28,14,7,2,239
141330617,24,44,43,46,22,11,1,4,195
141400101,2,9,5,10,7,2,3,3,41
141400102,4,7,4,11,6,5,0,3,40
141400103,16,24,22,26,14,9,2,2,115
141400104,7,8,10,9,2,2,1,0,39
141400105,6,5,7,7,1,1,1,1,29
141400106,3,1,1,4,6,0,1,1,17
141400107,4,7,6,6,1,2,2,0,28
141400108,12,6,7,7,7,3,3,2,47
141400109,72,73,59,52,25,7,4,1,293
141400110,39,40,37,25,24,11,5,2,183
141400111,47,39,58,44,32,15,3,1,239
141400112,51,49,54,50,25,9,4,4,246
141400113,16,9,11,7,5,9,5,2,64
141400201,12,7,8,7,6,5,0,1,46
141400202,21,16,21,24,8,4,3,2,99
141400203,7,6,9,14,9,6,2,2,55
141400204,11,19,17,23,15,7,2,1,95
141400205,1,6,6,3,6,4,2,2,30
141400206,9,20,12,21,11,4,5,2,84
141400207,3,5,5,5,1,3,1,1,24
141400208,9,6,12,12,10,4,6,1,60
141400209,6,9,12,12,6,2,1,0,48
141400210,1,4,6,4,4,1,3,2,25
141400211,31,53,35,28,21,4,3,1,176
141400212,45,54,42,42,25,16,5,5,234
141400213,16,30,17,20,10,4,1,1,99
141400301,35,44,63,89,68,30,11,10,350
141400302,42,93,101,80,48,19,8,5,396
141400303,36,70,42,40,16,9,1,1,215
141400304,25,54,52,44,25,12,3,2,217
141400305,43,54,73,75,40,19,4,3,311
141400306,67,64,46,58,24,11,4,4,278
141400307,53,67,56,69,34,9,6,2,296
141400308,38,85,65,77,43,19,3,5,335
141400309,32,47,46,44,26,14,3,1,213
141400310,75,57,55,43,25,9,4,5,273
141400311,45,70,44,44,14,10,3,2,232
141400312,32,55,42,72,33,14,1,1,250
141400313,27,30,24,34,14,1,0,1,131
141400401,53,58,53,27,14,10,1,3,219
141400402,36,66,68,45,11,6,3,1,236
141400403,35,49,50,31,16,5,0,0,186
141400404,60,59,38,28,15,5,3,0,208
141400405,58,65,38,22,23,4,1,2,213
141400406,50,66,64,35,21,8,1,0,245
141400407,56,80,74,69,32,15,4,3,333
141400408,37,57,69,76,61,30,9,7,346
141400409,36,80,76,78,51,23,4,8,356
141400410,42,53,47,45,35,13,4,3,242
141400411,24,39,46,42,21,12,2,2,188
141400412,58,73,83,67,42,14,3,2,342
141400413,32,76,81,80,56,28,13,10,376
141400501,14,16,12,11,10,6,0,1,70
141400502,13,15,20,17,10,9,3,2,89
141400503,7,3,8,10,3,2,2,0,35
141400504,11,6,4,5,9,5,0,3,43
141400505,12,6,6,12,11,6,2,5,60
141400506,4,4,13,11,8,6,3,2,51
141400507,2,1,2,1,0,2,1,1,10
141400508,79,76,70,48,27,5,2,4,311
141400509,86,62,51,53,20,15,1,2,290
141400510,20,26,19,15,14,6,3,0,103
141400511,62,71,56,59,40,19,7,13,327
141400512,29,54,53,45,22,11,6,2,222
141400513,50,46,42,30,19,10,4,1,202
141400514,78,76,49,48,24,10,5,2,292
141400515,48,67,48,45,29,17,3,8,265
141400516,51,86,46,46,25,17,5,3,279
141400517,46,50,49,29,17,8,4,4,207
141400518,49,41,47,34,20,6,3,3,203
141400519,43,49,44,33,25,5,2,3,204
141400520,88,84,72,56,50,15,7,11,383
141400601,3,5,1,6,1,0,0,0,16
141400602,3,6,5,2,7,3,1,1,28
141400603,4,6,3,2,3,1,0,1,20
141400604,16,12,20,16,10,5,7,3,89
141400605,10,5,14,14,11,6,4,4,68
141400606,8,7,11,7,6,5,1,2,47
141400607,7,6,8,6,6,7,3,1,44
141400608,9,11,5,5,11,2,2,1,46
141400609,1,5,3,3,7,4,2,1,26
141400610,67,75,75,81,43,20,7,6,374
141400611,50,66,51,43,17,9,4,3,243
141400612,38,44,31,33,29,11,7,4,197
141400613,13,23,19,20,17,9,8,6,115
141400614,77,46,42,38,19,17,4,8,251
141400615,16,33,40,28,15,6,6,3,147
141400616,63,83,91,64,43,20,9,5,378
141400617,50,53,37,23,16,7,2,1,189
141400618,58,56,35,19,10,4,2,0,184
141400619,62,85,66,58,30,14,2,11,328
141400701,34,61,53,42,31,13,8,3,245
141400702,89,111,56,61,19,6,0,2,344
141400703,48,78,51,47,16,2,0,1,243
141400704,45,64,34,36,9,8,2,0,198
141400705,48,82,94,76,43,25,7,14,389
141400706,66,105,71,66,34,32,8,8,390
141400707,52,75,27,30,11,0,1,2,198
141400708,68,52,24,14,17,2,0,1,178
141400709,43,50,45,44,26,19,3,3,233
141400710,44,70,72,68,51,33,17,13,368
141400711,66,95,75,62,20,11,2,0,331
141400712,65,72,34,31,11,4,0,0,217
141400713,70,93,71,64,28,14,4,3,347
141400714,37,53,66,46,37,21,13,12,285
141400715,49,88,55,35,32,17,4,4,284
141400716,91,107,50,39,23,6,0,1,317
141400717,15,25,25,26,12,8,2,3,116
141400718,77,100,74,56,25,10,3,2,347
141400719,42,79,60,50,37,12,5,7,292
141400720,35,45,60,59,39,21,10,10,279
141400801,16,18,29,39,27,14,5,13,161
141400802,7,11,15,23,15,14,9,4,98
141400803,8,20,23,24,28,20,9,12,144
141400804,8,29,31,44,28,21,6,10,177
141400805,4,7,12,14,16,8,7,5,73
141400806,3,8,8,6,7,2,2,2,38
141400807,5,12,10,23,14,9,3,5,81
141400808,6,10,20,18,16,5,2,3,80
141400809,44,74,71,40,37,12,9,7,294
141400810,14,27,50,48,54,33,8,25,259
141400811,30,45,44,44,22,21,5,4,215
141400812,63,81,75,65,41,17,3,6,351
141400813,67,75,48,48,30,10,2,1,281
141400814,23,32,40,52,28,19,9,10,213
141400815,44,59,62,42,24,12,4,2,249
141400816,64,85,50,29,12,6,1,0,247
141400817,55,66,55,54,35,9,3,2,279
141400818,34,74,54,60,54,15,9,7,307
141400819,29,55,59,61,39,12,6,5,266
141400820,78,94,64,64,28,17,6,4,355
141400821,29,42,38,36,24,6,3,1,179
141400901,10,7,12,8,8,7,6,6,64
141400902,5,2,2,7,6,3,2,2,29
141400903,13,10,18,8,12,6,4,4,75
141400904,15,26,27,30,18,11,4,7,138
141400905,2,12,14,15,8,2,3,3,59
141400906,3,3,21,22,16,14,3,2,84
141400907,5,4,14,4,3,4,2,2,38
141400908,59,76,50,44,29,16,5,4,283
141400909,63,81,55,55,26,10,8,1,299
141400910,37,53,47,43,34,25,7,13,259
141400911,82,82,60,69,41,14,3,2,353
141400912,53,67,27,34,20,8,1,0,210
141400913,58,86,53,51,20,4,0,0,272
141400914,52,76,44,58,32,18,11,11,302
141400915,64,131,75,57,32,10,4,1,374
141400916,41,58,22,37,17,8,3,7,193
141401001,13,13,19,17,9,6,1,5,83
141401002,9,7,16,7,12,8,5,5,69
141401003,4,10,12,21,7,4,5,8,71
141401004,7,10,9,6,9,1,3,2,47
141401005,5,2,8,10,5,5,1,3,39
141401006,14,36,24,19,16,11,5,2,127
141401007,20,23,35,25,10,7,4,5,129
141401008,37,54,39,32,9,7,3,1,182
141401009,43,55,48,43,18,7,3,2,219
141401010,39,77,61,48,30,12,3,4,274
141401011,37,59,68,60,20,17,6,5,272
141401012,80,94,80,68,25,11,5,1,364
141401013,43,51,22,32,11,0,2,0,161
141401014,45,60,38,40,16,8,6,2,215
141401015,59,78,53,60,23,4,5,2,284
141401016,74,97,69,74,22,9,1,2,348
141401017,55,71,57,51,33,18,11,10,306
141401101,14,30,29,35,20,6,0,2,136
141401102,24,63,50,44,27,8,1,2,219
141401103,59,109,85,68,27,12,0,1,361
141401104,50,80,31,31,15,9,3,1,220
141401105,75,90,56,48,21,7,2,0,299
141401106,42,55,30,41,17,2,4,1,192
141401107,62,56,40,31,19,2,1,0,211
141401108,49,114,111,92,59,20,5,5,455
141401109,25,47,58,69,31,10,2,0,242
141401110,48,85,70,51,25,9,2,1,291
141401111,53,77,48,36,17,6,0,0,237
141401112,66,68,46,20,17,1,0,1,219
141401113,73,92,59,41,15,8,0,1,289
141401114,80,89,49,36,20,6,1,1,282
141401115,57,56,39,29,11,3,0,1,196
141401116,74,76,27,28,7,3,1,0,216
141401117,56,53,31,23,12,4,1,4,184
141401118,92,119,51,44,11,5,0,1,323
141401119,82,111,46,39,16,9,2,1,306
141401120,63,109,79,59,29,7,1,3,350
141401121,65,86,61,81,36,4,1,1,335
141401201,25,46,31,61,21,12,0,3,199
141401202,29,45,41,37,19,2,1,0,174
141401203,23,43,43,52,34,26,9,13,243
141401204,34,57,43,53,29,14,4,2,236
141401205,31,55,73,76,67,27,10,7,346
141401206,36,64,69,49,49,41,13,32,353
141401207,47,82,71,53,25,12,0,0,290
141401208,52,67,64,52,25,9,1,1,271
141401209,60,78,56,36,20,7,2,2,261
141401210,56,64,59,67,47,19,9,13,334
141401211,79,94,65,58,49,14,8,7,374
141401212,33,72,64,64,32,26,9,3,303
141401213,44,78,63,46,20,6,3,2,262
141401214,51,67,46,28,11,8,1,1,213
141401215,55,69,48,27,14,6,1,1,221
141401216,59,71,30,24,15,9,0,0,208
141401217,113,85,40,22,7,4,0,0,271
141401218,40,64,38,28,12,6,1,0,189
141401219,46,47,54,36,17,12,8,6,226
141401301,56,66,43,28,12,6,0,1,212
141401302,56,76,42,34,10,2,1,0,221
141401303,67,57,30,32,11,6,1,0,204
141401304,56,84,37,41,29,4,0,3,254
141401305,60,80,52,43,24,11,4,1,275
141401306,60,68,52,36,15,5,3,1,240
141401307,36,54,42,36,19,3,1,1,192
141401308,55,55,27,29,11,1,2,1,181
141401309,72,83,36,33,14,6,1,0,245
141401310,52,65,44,39,16,7,3,0,226
141401311,73,64,49,39,10,3,2,2,242
141401312,46,75,46,34,14,6,2,3,226
141401313,70,81,49,49,20,8,4,2,283
141401314,48,67,30,26,24,1,2,4,202
141401315,44,61,74,70,47,23,13,10,342
141401316,39,62,66,53,26,13,5,2,266
141401317,39,48,62,71,50,24,16,14,324
141401318,31,36,52,66,28,13,5,2,233
141401401,46,75,74,59,36,19,4,7,320
141401402,33,71,68,56,24,7,3,1,263
141401403,37,75,54,45,18,10,2,0,241
141401404,75,93,48,34,15,2,0,0,267
141401405,82,80,52,43,19,6,1,0,283
141401406,45,63,43,27,14,2,0,0,194
141401407,79,77,39,24,8,4,1,1,233
141401408,25,38,34,21,20,9,2,1,150
141401409,50,53,29,33,6,4,3,1,179
141401410,44,52,32,32,7,9,0,2,178
141401411,44,87,53,33,18,2,3,0,240
141401412,54,78,68,60,33,17,4,1,315
141401413,57,83,85,100,40,14,2,0,381
141401414,34,64,109,102,43,24,9,4,389
141401415,55,83,67,54,35,18,2,2,316
141401416,70,71,64,60,35,11,3,1,315
141401417,50,87,52,36,27,8,1,0,261
141401418,59,90,53,55,23,14,6,2,302
141401419,19,55,62,59,37,24,9,11,276
141401420,40,47,45,33,22,7,6,2,202
141401421,42,46,51,49,19,11,4,2,224
141401422,19,51,47,40,23,12,1,1,194
141401423,34,48,54,76,27,14,4,3,260
141401501,13,12,12,17,9,5,4,2,74
141401502,7,15,2,19,6,4,2,1,56
141401503,13,18,7,11,10,3,2,3,67
141401504,7,11,7,18,12,13,4,7,79
141401505,9,15,19,16,11,5,4,5,84
141401506,6,10,8,15,3,5,0,2,49
141401507,32,47,54,45,25,18,7,0,228
141401508,36,40,30,27,26,8,9,1,177
141401509,65,61,48,38,27,4,3,2,248
141401510,71,84,47,59,28,10,3,6,308
141401511,66,83,52,39,26,15,4,0,285
141401512,69,85,72,62,32,9,1,1,331
141401513,89,93,85,89,43,24,8,10,441
141401514,20,29,18,17,15,5,5,2,111
141401515,18,23,24,17,10,7,0,2,101
141401601,11,7,3,9,3,3,1,3,40
141401602,6,12,15,12,6,4,2,2,59
141401603,7,10,12,9,7,4,2,0,51
141401604,1,2,4,1,2,1,0,0,11
141401605,9,11,27,10,14,6,5,4,86
141401606,10,9,13,10,10,25,0,0,77
141401607,49,53,38,40,21,10,1,2,214
141401608,78,103,58,54,27,19,11,12,362
141401609,49,64,47,36,24,15,2,7,244
141401610,67,81,71,63,41,18,5,11,357
141401611,86,103,58,57,26,13,4,2,349
141401612,44,66,48,41,23,8,1,0,231
141401613,43,51,34,27,29,4,3,0,191
141401614,50,63,54,41,26,25,5,3,267
141401615,38,48,47,41,18,6,4,4,206
141401701,10,11,11,5,11,5,2,4,59
141401702,4,9,12,16,12,4,4,5,66
141401703,8,1,8,11,6,4,0,0,38
141401704,3,6,4,4,2,3,0,1,23
141401705,8,18,19,15,11,5,3,5,84
141401706,5,11,9,8,6,5,3,2,49
141401707,3,4,5,4,2,2,0,1,21
141401708,9,8,13,22,10,5,2,4,73
141401709,16,22,17,25,15,9,2,1,107
141401710,13,13,16,12,11,4,2,2,73
141401711,53,78,75,64,48,20,19,8,365
141401712,37,57,44,25,26,6,7,0,202
141401713,42,64,23,24,18,1,2,0,174
141401714,83,109,62,62,34,11,5,1,367
141401715,42,46,60,60,41,20,4,12,285
141401716,39,50,42,41,22,11,2,3,210
141401717,53,71,52,40,24,18,6,2,266
141401718,10,8,12,13,3,9,6,7,68
141401719,61,46,52,47,33,13,4,2,258
141401720,55,53,43,24,18,6,3,0,202
141401801,34,61,57,33,21,7,3,2,218
141401802,38,57,43,52,40,11,8,5,254
141401803,42,60,51,50,17,8,2,1,231
141401804,26,62,31,57,31,8,3,3,221
141401805,48,46,44,31,27,24,4,3,227
141401806,43,55,50,55,36,16,13,5,273
141401807,52,54,36,33,17,9,2,5,208
141401808,58,101,59,35,23,15,2,1,294
141401809,70,95,54,25,26,1,2,2,275
141401810,72,60,44,20,13,3,0,1,213
141401811,68,73,44,43,18,6,1,1,254
141401812,38,70,52,42,24,8,3,2,239
141401901,56,90,86,71,34,23,5,1,366
141401902,48,77,44,32,18,4,1,0,224
141401903,48,44,40,20,9,4,0,0,165
141401904,57,52,40,21,13,3,0,3,189
141401905,13,27,27,35,24,7,1,3,137
141401906,53,70,45,26,10,9,5,3,221
141401907,44,46,50,35,22,5,1,0,203
141401908,51,55,52,28,16,6,1,0,209
141401909,37,45,71,63,33,15,3,1,268
141401910,48,103,98,101,47,5,1,1,404
141401911,43,60,51,37,24,8,5,0,228
141470101,8,4,3,6,6,2,0,0,29
141470102,21,27,41,44,31,7,7,5,183
141470103,20,36,34,37,23,13,4,6,173
141470104,36,66,66,64,39,26,11,10,318
141470105,52,80,79,60,57,21,7,10,366
141470106,32,44,53,58,34,25,3,5,254
141470107,17,50,43,68,59,34,13,10,294
141470108,10,23,36,32,36,14,6,9,166
141470109,26,35,67,96,75,34,21,22,376
141470110,51,64,75,73,50,31,7,12,363
141470111,50,60,62,58,43,12,7,10,302
141470112,53,53,51,52,20,11,3,3,246
141470113,31,33,45,48,28,21,6,2,214
141470114,36,48,76,53,37,24,13,8,295
141470201,29,45,29,42,15,9,1,5,175
141470202,76,92,93,95,78,46,17,13,510
141470203,7,8,5,12,9,7,1,2,51
141470204,24,44,52,46,19,13,5,12,215
141470205,39,49,52,52,41,26,14,17,290
141470206,17,13,6,7,8,4,1,2,58
141470207,34,39,62,64,48,28,11,13,299
141470208,26,44,51,46,32,26,10,11,246
141470209,18,39,35,47,41,16,9,10,215
141470210,24,49,62,83,72,44,13,8,355
141470211,31,48,44,59,29,15,5,3,234
141470212,25,38,38,39,34,13,11,5,203
141470213,10,47,44,45,43,14,9,13,225
141470301,6,5,3,7,7,3,2,0,33
141470302,26,28,13,16,11,3,4,4,105
141470303,35,20,25,20,15,5,5,4,129
141470304,14,29,24,21,23,9,4,1,125
141470305,26,23,11,11,6,6,1,3,87
141470306,3,8,5,5,0,1,1,0,23
141470307,27,26,37,27,16,13,3,2,151
141470308,42,48,62,69,67,32,11,13,344
141470309,36,58,50,52,30,19,5,4,254
141470310,48,72,53,58,34,19,6,6,296
141470311,33,44,41,34,20,11,7,5,195
141470312,19,39,30,26,17,8,2,7,148
141470313,13,33,19,32,7,7,1,6,118
141470314,23,36,24,19,12,10,2,1,127
141470401,9,8,14,10,4,5,1,3,54
141470402,10,8,9,6,2,2,2,0,39
141470403,14,11,7,14,7,6,1,2,62
141470404,3,4,2,0,3,0,0,0,12
141470405,27,42,27,29,23,7,5,6,166
141470406,18,36,27,24,15,9,4,6,139
141470407,49,74,69,62,26,22,6,5,313
141470408,55,82,73,74,32,10,6,2,334
141470409,35,38,43,28,17,12,2,1,176
141470410,32,52,42,49,32,13,6,6,232
141470411,58,60,44,29,32,16,2,0,241
141470412,64,64,66,61,46,23,11,16,351
141470413,41,38,29,40,15,9,1,2,175
141470501,9,5,5,4,2,4,1,0,30
141470502,7,6,3,8,3,1,0,0,28
141470503,12,8,8,9,7,0,0,0,44
141470504,7,16,9,9,5,0,2,1,49
141470505,4,7,3,3,3,1,0,0,21
141470506,1,3,0,4,1,2,0,0,11
141470507,24,27,29,14,12,4,1,3,114
141470508,32,38,28,43,31,13,9,2,196
141470601,34,27,17,20,19,9,3,4,133
141470602,13,23,13,6,12,3,1,1,72
141470603,33,48,14,25,7,4,0,3,134
141470604,20,32,21,23,14,5,1,0,116
141470605,15,28,15,13,12,7,0,0,90
141470606,26,46,30,29,14,11,1,1,158
141470607,21,38,27,18,7,9,1,2,123
141470608,37,43,37,30,12,6,4,1,170
141470609,24,39,19,27,12,13,2,0,136
141470610,35,38,25,29,16,10,2,3,158
141470701,6,2,6,5,4,2,0,2,27
141470702,3,2,3,2,0,1,1,0,12
141470703,6,4,3,0,3,0,1,0,17
141470704,12,7,8,11,4,3,0,2,47
141470705,1,0,0,1,0,0,0,0,2
141470706,5,5,5,3,7,1,1,1,28
141470707,8,9,2,4,3,2,0,2,30
141470708,8,6,9,5,3,3,2,0,36
141470709,15,16,4,15,6,2,2,1,61
141470710,13,27,17,16,12,8,2,2,97
141470711,22,30,15,22,5,4,1,1,100
141470712,11,20,11,9,5,1,2,3,62
141470713,14,10,8,9,0,2,2,1,46
141470714,37,31,26,27,22,11,2,4,160
141470801,36,53,63,65,31,9,4,2,263
141470802,32,58,70,84,37,21,7,14,323
141470803,34,55,66,73,49,32,16,18,343
141470804,24,43,57,48,24,21,11,13,241
141470805,54,74,92,97,78,45,17,13,470
141470806,58,86,73,86,48,24,13,12,400
141470807,33,65,55,69,37,20,10,8,297
141470808,58,80,65,45,31,15,2,2,298
141470809,62,80,48,35,20,7,3,2,257
141470810,35,51,42,31,8,4,1,0,172
141470811,41,60,58,44,18,8,2,1,232
141470812,52,69,60,73,42,24,10,13,343
141470813,66,84,49,37,10,13,3,1,263
141470814,61,72,51,37,20,6,4,3,254
141470815,46,78,40,43,24,4,2,1,238
141470816,68,58,34,30,9,1,2,1,203
141470817,46,38,16,13,7,2,0,0,122
141470901,36,50,58,73,46,35,10,11,319
141470902,42,54,89,85,70,33,12,28,413
141470903,50,67,100,80,66,28,11,11,413
141470904,26,44,60,29,27,16,3,8,213
141470905,30,47,42,53,32,8,7,5,224
141470906,52,66,79,65,41,22,6,5,336
141470907,39,44,32,26,15,10,2,4,172
141470908,49,73,59,68,40,14,2,3,308
141470909,61,62,47,26,22,7,0,1,226
141470910,35,53,47,34,22,12,2,4,209
141470911,34,65,37,36,27,7,2,2,210
141470912,49,79,70,81,43,22,7,10,361
141470913,63,87,82,78,51,12,5,4,382
141470914,55,62,59,48,17,8,1,1,251
141470915,52,64,60,52,24,11,2,2,267
141470916,39,60,57,50,26,5,3,4,244
141470917,32,38,37,42,30,9,3,4,195
141470918,30,43,46,50,25,17,5,9,225
141470919,34,39,51,65,38,14,12,12,265
141471001,36,66,39,53,20,5,2,1,222
141471002,39,58,62,62,24,18,4,6,273
141471003,50,53,31,25,13,10,3,1,186
141471004,34,73,41,40,27,7,0,0,222
141471005,61,106,71,47,22,9,3,1,320
141471006,56,65,46,32,16,9,1,0,225
141471007,44,67,44,46,21,10,4,1,237
141471008,51,78,85,72,37,24,8,8,363
141471009,51,58,43,46,25,18,2,5,248
141471010,62,77,92,75,46,22,7,6,387
141471011,63,93,72,89,61,32,13,18,441
141471012,42,40,46,47,41,39,9,12,276
141471013,36,53,65,56,40,24,11,8,293
141471014,47,86,85,112,64,37,10,6,447
141471015,44,80,89,87,68,45,20,27,460
141540101,7,7,7,5,2,2,1,0,31
141540102,11,9,8,8,1,6,0,2,45
141540103,25,17,21,15,8,10,2,4,102
141540104,14,15,14,10,13,10,9,4,89
141540105,9,1,3,4,2,1,1,0,21
141540106,3,2,0,0,1,0,1,0,7
141540107,7,8,8,5,2,1,1,2,34
141540201,11,7,4,10,6,5,2,2,47
141540202,0,1,0,2,1,1,0,0,5
141540203,4,10,4,5,0,2,2,1,28
141540204,20,9,8,5,7,1,2,3,55
141540205,7,11,2,3,2,1,1,1,28
141540206,5,4,6,5,1,1,2,0,24
141540207,10,8,9,4,2,2,0,1,36
141540208,10,8,5,2,6,3,0,2,36
141540209,30,37,41,27,15,16,4,3,173
141540210,15,28,33,40,22,23,13,8,182
141540211,50,49,56,50,37,23,7,6,278
141540212,19,23,19,17,4,5,2,1,90
141610101,7,5,6,4,5,1,0,0,28
141610102,8,3,4,8,5,7,0,0,35
141610103,9,9,14,6,4,4,1,1,48
141610104,10,14,19,10,6,9,1,1,70
141610105,7,11,15,13,8,4,3,3,64
141610106,5,6,5,3,2,2,2,0,25
141610107,4,6,6,9,4,2,0,0,31
141610108,3,9,4,4,7,4,0,0,31
141610109,5,6,6,9,9,1,0,1,37
141610110,11,15,13,15,2,0,2,3,61
141610111,7,10,9,9,1,1,0,0,37
141610112,36,48,54,41,29,11,10,15,244
141610113,62,75,54,60,29,13,1,2,296
141610114,25,48,37,36,13,4,3,1,167
141610115,22,32,25,40,18,13,5,4,159
141610116,57,74,49,49,20,11,1,4,265
141610117,73,95,57,58,30,12,3,2,330
141610201,17,10,9,6,4,3,0,1,50
141610202,11,12,9,5,5,0,1,1,44
141610203,4,5,8,1,3,0,0,0,21
141610204,3,6,3,4,2,1,1,1,21
141610205,4,5,5,3,1,1,0,0,19
141610206,6,7,9,9,4,0,0,0,35
141610207,36,44,46,43,19,19,4,1,212
141610208,60,52,41,40,31,6,2,7,239
141610209,61,85,62,44,15,5,3,2,277
141610210,37,66,50,37,17,3,1,1,212
141610211,72,61,36,34,22,9,3,1,238
141610212,45,43,47,30,15,10,5,2,197
141610213,34,57,52,28,22,12,5,4,214
141610214,54,42,53,38,22,10,6,3,228
141610215,51,70,35,29,20,5,1,1,212
141610216,54,57,46,40,18,6,3,4,228
141610301,21,19,16,18,12,4,1,1,92
141610302,16,4,9,5,5,0,2,0,41
141610303,5,5,15,10,3,4,1,0,43
141610304,8,14,15,11,7,4,1,3,63
141610305,20,21,22,19,17,12,7,4,122
141610306,40,48,42,43,29,21,8,14,245
141610307,62,75,62,63,32,13,12,6,325
141610308,41,51,44,26,18,9,3,2,194
141610309,28,29,52,30,32,16,2,2,191
141610310,62,69,61,67,27,12,6,3,307
141610311,48,54,38,32,15,8,4,0,199
141610312,26,40,33,29,15,6,3,0,152
141610313,43,31,36,33,18,5,3,1,170
141610401,6,12,14,11,7,0,2,1,53
141610402,7,4,3,4,7,5,4,0,34
141610403,4,7,2,3,7,1,0,0,24
141610404,3,5,7,12,5,1,1,0,34
141610405,14,9,14,16,9,3,3,3,71
141610406,7,13,8,13,3,4,3,0,51
141610407,20,17,14,24,5,1,1,2,84
141610408,2,6,5,3,1,1,0,0,18
141610409,12,11,8,7,7,5,1,1,52
141610410,8,9,10,13,6,3,2,4,55
141610411,10,24,17,18,10,7,1,3,90
141610412,46,66,38,44,28,13,5,5,245
141610413,37,55,46,51,28,7,3,3,230
141610501,3,7,5,4,3,2,0,0,24
141610502,3,8,5,5,3,0,0,1,25
141610503,25,17,12,18,9,8,1,2,92
141610504,4,4,7,2,3,3,1,0,24
141610505,6,12,19,5,3,1,0,1,47
141610506,40,43,52,34,26,22,11,4,232
141610507,62,87,59,66,32,16,8,9,339
141610508,33,52,31,44,13,13,2,1,189
141610509,34,28,33,63,33,13,6,3,213
141610510,54,71,24,37,15,3,0,0,204
141610511,39,60,46,47,27,10,1,2,232
141610512,27,50,47,39,17,14,2,4,200
141610601,22,41,48,39,29,16,4,11,210
141610602,43,66,59,52,34,22,9,6,291
141610603,33,75,67,93,41,13,6,7,335
141610604,41,70,75,59,31,14,3,3,296
141610605,29,35,41,45,22,8,1,4,185
141610606,63,88,70,68,27,17,4,1,338
141610607,41,62,61,53,39,11,7,8,282
141610608,50,60,40,22,16,8,3,5,204
141610609,47,57,63,34,13,5,5,3,227
141610610,57,68,45,56,29,8,2,1,266
141610611,57,50,57,35,13,6,2,4,224
141610612,67,82,41,36,22,8,1,0,257
141610613,44,63,59,57,23,10,11,7,274
141610614,29,36,49,40,20,24,7,7,212
141610701,41,69,52,53,23,3,1,0,242
141610702,25,46,35,39,22,5,2,1,175
141610703,65,97,72,45,22,11,4,0,316
141610704,38,49,26,17,14,6,1,1,152
141610705,34,37,26,27,18,6,2,0,150
141610706,58,74,58,37,29,10,7,2,275
141610707,49,54,41,36,22,12,7,1,222
141610708,68,72,54,40,26,25,3,6,294
141610709,69,85,65,50,28,8,1,2,308
141610710,50,70,54,36,26,5,2,2,245
141610711,38,50,51,41,13,3,1,1,198
141610712,70,93,66,60,45,15,6,5,360
141610713,45,79,65,61,32,15,1,3,301
141610714,44,63,57,55,25,13,5,4,266
141610715,42,88,76,84,56,27,8,3,384
141610801,32,50,47,42,27,15,6,1,220
141610802,22,21,30,20,16,8,4,2,123
141610803,45,53,31,34,19,8,1,0,191
141610804,48,65,26,26,17,3,0,0,185
141610805,42,55,30,25,6,1,0,1,160
141610806,35,49,32,34,19,6,0,3,178
141610807,53,91,53,48,25,11,3,5,289
141610808,39,57,34,47,15,13,4,1,210
141610809,35,47,30,35,21,6,0,0,174
141610810,74,100,60,42,24,3,0,0,303
141610811,38,66,41,26,9,4,0,0,184
141610812,49,70,32,28,10,3,0,0,192
141610813,69,66,28,15,14,4,0,1,197
141610814,70,86,52,40,10,4,1,1,264
141610815,35,57,48,32,20,17,5,4,218
141610816,42,49,37,34,20,9,2,2,195
141610817,64,83,65,61,35,12,2,2,324
141610901,29,30,46,52,24,19,11,7,218
141610902,29,59,65,65,36,20,15,12,301
141610903,40,55,48,54,35,17,6,7,262
141610904,39,46,49,48,32,14,7,6,241
141610905,54,64,42,57,30,13,4,1,265
141610906,29,50,50,58,46,29,15,10,287
141610907,25,60,52,59,36,7,3,3,245
141610908,24,41,60,47,26,11,3,0,212
141610909,53,66,54,37,18,6,4,1,239
141610910,52,61,41,28,26,3,2,1,214
141610911,44,73,62,51,29,6,0,1,266
141610912,25,68,65,49,21,13,2,2,245
141610913,55,86,55,43,29,8,0,0,276
141610914,66,62,34,29,16,8,1,2,218
141610915,73,99,61,44,27,7,1,1,313
141610916,45,65,33,35,14,4,1,1,198
141610917,42,70,48,45,15,4,1,0,225
141610918,89,106,67,51,19,4,0,0,336
141610919,47,81,45,43,20,3,0,1,240
141610920,55,58,50,30,15,8,2,0,218
141610921,69,97,79,77,20,16,2,2,362
141610922,11,37,72,99,41,16,6,1,283
141610923,37,61,53,44,17,10,2,1,225
141611001,83,80,47,20,10,1,0,0,241
141611002,68,99,48,41,26,3,5,0,290
141611003,92,104,46,29,8,6,0,0,285
141611004,71,94,30,27,12,4,0,0,238
141611005,83,68,44,23,13,3,1,1,236
141611006,80,93,53,35,19,5,2,0,287
141611007,78,100,89,52,29,7,1,2,358
141611008,41,63,62,42,23,8,3,2,244
141611009,45,49,55,38,11,5,1,0,204
141611010,35,65,38,29,9,1,0,0,177
141611011,37,73,36,26,16,2,3,1,194
141611012,62,122,62,46,26,5,0,2,325
141611013,46,64,41,33,16,5,1,1,207
141611014,56,66,46,21,14,6,1,1,211
141611015,53,55,36,36,13,6,1,0,200
141611016,58,71,49,41,18,3,3,2,245
141611017,75,109,71,68,19,9,1,3,355
141611018,26,66,57,87,39,11,2,1,289
141611019,31,38,67,75,48,16,7,9,291
141611020,52,54,54,55,27,7,3,1,253
141611021,40,54,41,47,37,15,5,6,245
141611101,43,73,75,94,39,31,8,5,368
141611102,25,42,37,46,33,16,9,6,214
141611103,26,30,43,34,29,6,6,1,175
141611104,59,79,62,55,29,16,3,5,308
141611105,26,65,61,40,22,6,2,3,225
141611106,56,60,49,44,28,11,3,0,251
141611107,40,68,51,41,11,7,0,1,219
141611108,57,64,42,27,9,1,1,1,202
141611109,36,40,39,25,23,9,1,0,173
141611110,28,53,43,36,26,17,13,12,228
141611111,43,85,94,70,44,16,9,9,370
141611112,56,89,70,63,28,10,1,1,318
141611113,53,87,51,44,19,6,0,1,261
141611114,34,60,50,64,25,5,3,3,244
141611115,24,46,43,57,30,15,4,1,220
141611116,36,60,66,80,39,24,5,8,318
141611117,29,51,44,49,26,16,2,6,223
141680101,12,12,5,6,6,3,1,1,46
141680102,19,9,6,8,7,2,1,0,52
141680103,9,6,3,4,2,3,1,1,29
141680104,6,3,2,3,0,1,0,0,15
141680105,5,3,4,0,2,1,2,1,18
141680106,16,11,10,7,1,1,1,1,48
141680107,12,5,6,7,2,2,2,1,37
141680108,30,9,17,15,10,6,1,2,90
141680109,8,4,6,4,0,2,2,1,27
141680110,17,18,14,22,10,11,3,2,97
141680111,43,34,43,31,27,10,12,11,211
141680112,54,60,53,57,31,10,4,3,272
141680113,16,28,29,29,24,10,2,9,147
141680114,58,35,69,52,47,19,14,18,312
141680201,5,12,9,9,8,2,0,2,47
141680202,8,18,14,21,11,6,2,2,82
141680203,8,6,3,4,2,4,0,0,27
141680204,24,21,42,41,19,7,4,0,158
141680205,29,39,32,28,14,12,4,3,161
141680206,44,53,40,35,20,3,1,2,198
141680207,51,50,60,64,21,21,4,7,278
141680208,54,63,61,57,35,16,3,6,295
141680209,30,28,45,47,34,18,6,9,217
141680210,21,36,54,38,25,14,5,2,195
141680211,37,40,56,60,39,19,4,4,259
141680212,31,35,45,50,25,23,16,14,239
141680213,33,49,57,34,28,14,4,5,224
141680214,22,37,37,38,26,16,7,8,191
141680301,6,7,7,2,4,0,0,1,27
141680302,15,17,3,8,9,4,3,2,61
141680303,18,24,16,16,10,7,1,2,94
141680304,3,6,8,10,1,3,3,3,37
141680305,6,9,11,11,8,6,1,5,57
141680306,4,7,7,5,3,1,0,0,27
141680307,11,11,14,8,10,1,0,1,56
141680308,5,2,4,6,1,2,0,0,20
141680309,6,11,18,11,2,3,0,0,51
141680310,12,13,12,5,6,2,1,2,53
141680311,43,55,60,85,45,25,12,17,342
141680312,46,31,40,44,30,22,2,9,224
141680313,42,50,66,73,51,37,15,8,342
141750101,9,5,5,7,4,2,1,2,35
141750102,8,6,6,1,4,2,0,0,27
141750103,10,16,9,7,5,3,2,1,53
141750104,10,8,5,2,2,2,0,0,29
141750105,17,13,13,4,5,1,1,1,55
141750106,4,3,3,5,3,1,2,1,22
141750107,27,18,11,10,2,4,2,2,76
141750108,7,18,7,3,4,1,2,0,42
141750109,18,13,4,8,3,3,2,0,51
141750110,49,46,38,38,35,15,4,9,234
141750111,42,29,32,27,28,18,0,12,188
141750112,15,24,28,22,10,3,2,0,104
141750113,62,51,32,25,18,17,6,10,221
141750114,48,53,40,30,34,17,6,5,233
141750201,49,42,27,16,8,9,3,4,158
141750202,47,31,31,13,13,12,4,4,155
141750203,27,14,8,5,5,4,1,1,65
141750204,25,38,11,7,4,2,0,1,88
141750205,17,9,7,8,3,1,0,0,45
141750206,11,16,8,10,8,4,1,3,61
141750207,6,6,6,9,4,1,1,2,35
141750208,8,22,11,10,5,5,3,2,66
141750209,36,24,29,25,9,4,6,7,140
141750210,15,13,11,14,5,4,2,1,65
141750211,15,17,9,11,7,4,2,0,65
141750212,34,39,38,40,24,23,9,10,217
141750213,43,50,41,52,33,17,8,5,249
141750214,56,48,38,55,35,11,3,7,253
141750215,52,68,47,44,27,10,6,3,257
141750216,44,39,45,34,16,9,3,1,191
141750217,24,50,51,40,19,13,5,5,207
141750218,63,87,67,68,35,21,7,5,353
141750219,1,0,0,0,0,0,0,0,1
141820101,9,8,12,10,6,4,3,1,53
141820102,6,11,15,16,4,5,2,1,60
141820103,8,6,9,10,6,4,2,0,45
141820104,4,11,9,11,4,5,2,1,47
141820105,12,13,10,12,6,5,1,5,64
141820106,12,13,17,19,13,5,6,5,90
141820107,11,21,14,7,8,6,1,2,70
141820108,12,17,18,13,13,4,1,1,79
141820109,7,16,7,1,10,1,1,3,46
141820110,47,23,28,15,8,1,2,1,125
141820111,46,68,28,25,15,8,0,3,193
141820112,52,51,43,45,24,10,5,5,235
141820113,63,64,31,57,23,7,3,4,252
141820114,37,33,31,18,17,6,5,1,148
141820115,42,50,29,30,22,13,3,2,191
141820116,74,84,74,59,28,17,6,2,344
141820117,49,53,45,34,25,12,4,3,225
141820118,64,80,47,51,20,9,0,0,271
141820119,76,90,55,51,18,6,2,0,298
141820120,53,93,74,61,26,6,5,2,320
141820121,48,74,47,29,21,4,1,0,224
141820201,9,10,12,12,10,4,5,2,64
141820202,7,16,21,30,18,10,2,4,108
141820203,6,22,17,22,8,6,3,5,89
141820204,8,10,7,8,4,1,1,0,39
141820205,1,11,6,8,1,2,2,0,31
141820206,43,57,60,39,23,13,7,6,248
141820207,38,50,55,50,30,18,5,2,248
141820208,36,60,32,34,22,6,1,4,195
141820209,47,64,48,52,27,14,6,8,266
141820210,58,63,47,44,27,13,9,4,265
141820211,59,60,44,49,28,17,8,6,271
141820212,25,34,44,31,22,8,1,2,167
141820213,48,81,70,64,39,15,7,4,328
141820214,41,49,32,23,12,10,2,1,170
141820301,9,11,13,10,10,1,2,2,58
141820302,2,3,1,3,6,2,1,0,18
141820303,11,18,16,14,3,4,1,2,69
141820304,5,8,12,9,1,2,2,2,41
141820305,6,3,9,8,4,2,1,0,33
141820306,14,6,14,10,8,0,3,2,57
141820307,59,72,67,67,28,15,3,1,312
141820308,36,53,59,41,24,8,6,2,229
141820309,48,45,33,33,7,4,1,3,174
141820310,73,89,50,77,49,13,14,10,375
141820401,4,7,7,12,4,2,0,1,37
141820402,10,24,36,19,11,4,1,6,111
141820403,14,17,15,23,6,4,2,2,83
141820404,2,11,4,8,4,0,2,0,31
141820405,5,12,3,6,6,1,1,0,34
141820406,8,16,10,14,3,4,1,2,58
141820407,5,8,8,12,5,2,0,0,40
141820408,28,23,13,21,10,13,7,1,116
141820409,51,63,45,44,26,8,3,2,242
141820410,34,52,54,50,19,7,2,3,221
141820411,65,92,69,54,31,9,4,2,326
141820412,34,44,38,38,34,20,2,6,216
141820413,47,63,44,47,42,24,6,12,285
141820414,29,49,39,55,25,8,1,3,209
141820415,85,80,41,56,34,15,4,4,319
141820501,4,7,1,6,4,3,0,1,26
141820502,3,11,3,2,5,3,0,0,27
141820503,5,1,0,2,1,0,0,0,9
141820504,5,2,3,4,4,2,0,0,20
141820505,14,7,16,8,11,6,4,0,66
141820506,7,5,4,5,1,2,0,0,24
141820507,1,4,6,4,0,2,0,0,17
141820508,7,7,6,8,3,1,0,0,32
141820509,38,51,41,51,17,8,1,1,208
141820510,41,50,32,31,13,5,1,1,174
141820511,62,88,65,58,23,11,3,2,312
141820512,45,60,47,47,29,9,8,0,245
141820513,35,63,51,44,25,11,4,2,235
141820514,56,60,54,28,11,3,1,0,213
141820515,68,78,48,42,21,7,1,1,266
141820516,28,51,50,46,25,16,5,8,229
141820517,32,46,29,43,11,2,3,3,169
141820518,141,112,63,72,18,6,2,0,414
141820519,46,41,27,20,12,3,3,0,152
141820520,52,63,42,49,10,7,0,1,224
141820521,49,54,40,37,25,11,1,6,223
141820601,7,5,6,6,2,1,0,0,27
141820602,10,14,6,8,5,3,1,0,47
141820603,7,7,7,4,3,0,0,0,28
141820604,8,3,7,3,6,2,2,5,36
141820605,9,12,4,12,2,2,0,0,41
141820606,0,2,2,1,1,0,0,0,6
141820607,64,105,61,64,28,10,1,1,334
141820608,52,56,28,49,14,5,0,1,205
141820609,31,77,96,120,54,25,5,10,418
141820610,49,47,64,48,25,5,7,4,249
141820611,40,63,46,35,13,4,1,0,202
141820612,57,78,71,52,39,18,5,5,325
141820613,47,65,41,45,27,1,2,0,228
141820614,33,52,26,20,9,2,1,1,144
141820615,70,106,60,42,23,8,1,3,313
141820616,27,45,43,44,27,18,2,1,207
141820617,49,55,53,29,21,3,3,0,213
141820618,17,34,32,27,10,4,0,0,124
141820619,17,26,22,25,13,6,3,2,114
141820701,8,3,4,6,2,2,0,0,25
141820702,15,19,15,16,5,4,1,1,76
141820703,8,13,7,11,4,2,1,1,47
141820704,5,10,6,2,1,1,1,0,26
141820705,12,15,7,5,3,1,3,2,48
141820706,9,9,7,4,4,0,0,2,35
141820707,28,30,12,27,14,7,6,4,128
141820708,11,8,12,12,5,3,0,2,53
141820709,12,9,9,6,5,2,1,1,45
141820710,11,13,7,6,5,0,0,0,42
141820711,48,60,45,33,16,13,7,7,229
141820712,33,40,20,27,9,6,2,1,138
141820713,43,47,27,32,18,5,6,2,180
141820714,49,54,51,36,20,10,2,4,226
141820715,58,79,71,60,30,10,4,2,314
141820716,62,57,46,46,19,10,4,3,247
141820801,30,41,48,32,32,18,2,10,213
141820802,34,49,43,59,30,15,6,3,239
141820803,30,55,66,61,37,18,6,4,277
141820804,49,65,46,39,24,8,0,0,231
141820805,64,81,78,65,24,11,2,2,327
141820806,37,62,62,91,42,13,7,2,316
141820807,33,67,37,45,19,6,1,0,208
141820808,46,56,32,28,13,4,0,0,179
141820809,74,101,65,59,25,7,0,1,332
141820810,75,97,65,45,25,5,3,0,315
141820811,72,64,38,26,12,3,2,2,219
141820812,48,42,20,14,4,3,0,0,131
141820901,44,62,70,66,32,12,8,0,294
141820902,42,58,73,60,54,34,7,11,339
141820903,36,46,52,81,32,25,11,10,293
141820904,49,56,47,41,19,12,2,4,230
141820905,28,47,47,39,37,15,2,9,224
141820906,54,72,52,37,16,9,0,1,241
141820907,38,64,49,41,17,13,4,4,230
141820908,56,60,77,86,44,29,7,7,366
141820909,51,61,60,53,44,18,13,9,309
141820910,81,90,81,48,42,12,6,1,361
141820911,83,112,58,27,15,4,2,1,302
141821001,55,74,47,28,11,4,0,0,219
141821002,84,77,58,53,27,5,3,0,307
141821003,43,50,49,30,19,14,0,0,205
141821004,36,78,47,54,39,26,8,7,295
141821005,20,25,33,30,24,20,3,7,162
141821006,36,48,47,39,24,12,4,5,215
141821007,63,89,65,34,21,7,1,2,282
141821008,48,55,27,27,14,4,2,1,178
141821009,60,90,58,37,23,11,1,7,287
141821010,60,58,64,60,41,23,8,11,325
141821101,25,48,28,28,14,4,1,1,149
141821102,70,73,43,35,14,6,1,0,242
141821103,32,49,35,25,18,0,0,0,159
141821104,78,59,51,21,10,4,1,1,225
141821105,64,47,37,29,9,2,2,0,190
141821106,36,71,55,59,30,17,4,0,272
141821107,48,58,42,29,18,6,4,1,206
141821108,45,53,67,47,30,16,6,5,269
141821109,37,65,78,74,60,45,12,17,388
141821110,65,96,75,67,36,9,6,3,357
141821201,36,42,55,33,26,11,4,7,214
141821202,53,59,32,22,12,7,2,1,188
141821203,71,81,56,39,23,7,0,0,277
141821204,58,73,52,75,33,20,9,11,331
141821205,53,56,42,43,27,12,2,1,236
141821206,80,81,59,73,30,27,9,4,363
141821207,65,77,62,57,19,6,1,0,287
141821208,31,51,41,51,23,6,2,0,205
141821209,25,43,50,34,22,12,5,3,194
141821210,30,33,48,59,21,4,2,3,200
141821211,31,48,48,48,34,23,7,8,247
141821301,72,73,58,61,33,16,4,3,320
141821302,53,78,61,54,30,13,8,2,299
141821303,56,91,33,27,24,4,2,1,238
141821304,71,86,55,45,30,3,2,1,293
141821305,59,61,44,28,11,4,3,0,210
141821306,62,51,42,54,20,12,5,1,247
141821307,44,61,51,61,37,14,6,9,283
141821308,19,17,20,14,19,16,6,6,117
141821309,36,42,32,32,13,6,1,1,163
141821310,48,56,24,32,15,7,2,0,184
141821311,41,46,51,46,33,13,6,9,245
141821312,57,34,46,53,25,17,15,5,252
180070101,44,60,57,45,41,47,16,20,330
180070102,22,23,39,32,24,14,5,9,168
180070103,25,45,50,42,32,31,15,17,257
180070104,22,45,48,50,23,12,10,8,218
180070105,40,39,55,47,40,15,10,17,263
180070106,45,61,64,53,36,16,12,16,303
180070107,30,48,46,31,18,6,3,1,183
180070108,64,71,60,47,26,15,5,4,292
180070109,20,52,46,62,40,18,11,18,267
180070110,35,36,47,60,25,12,8,6,229
180070111,22,44,56,55,30,15,5,6,233
180070112,38,62,54,41,28,14,5,13,255
180070113,61,73,71,56,43,11,5,3,323
180070114,33,48,40,44,28,30,5,12,240
180070115,31,43,52,41,43,32,16,26,284
180070116,32,48,56,53,30,27,10,16,272
180070117,36,42,58,51,38,19,6,12,262
180070118,32,50,42,54,28,11,8,12,237
180070119,42,46,46,48,24,14,20,21,261
180070120,35,54,57,41,29,9,6,11,242
180070121,30,60,65,47,20,19,4,9,254
180070122,48,40,62,48,30,26,11,14,279
180070123,22,47,50,46,34,19,8,9,235
180070124,24,49,63,62,36,21,8,8,271
180070125,27,56,54,60,36,29,9,11,282
180070201,13,11,10,12,10,5,9,4,74
180070202,6,11,9,11,5,4,3,4,53
180070203,16,12,20,8,18,9,5,8,96
180070204,5,17,26,17,18,8,5,2,98
180070205,16,16,11,11,7,4,4,3,72
180070206,8,16,16,17,9,6,2,3,77
180070207,8,13,14,12,6,6,6,5,70
180070208,9,14,14,11,16,9,2,4,79
180070209,8,16,11,13,5,7,1,11,72
180070210,2,1,4,1,4,4,1,2,19
180070211,12,5,8,10,11,2,4,7,59
180070212,11,14,14,14,11,10,2,2,78
180070213,18,37,56,71,33,26,7,18,266
180070214,12,43,85,95,54,46,22,33,390
180070215,7,31,60,58,57,24,16,14,267
180070216,18,17,18,33,26,27,9,19,167
180070217,15,27,24,24,25,14,10,17,156
180070218,6,19,34,34,16,22,7,15,153
180070301,33,48,32,39,25,14,13,13,217
180070302,2,9,9,5,2,3,4,4,38
180070303,7,5,3,4,3,3,2,8,35
180070304,14,24,16,27,11,9,7,8,116
180070305,15,15,30,20,14,9,3,7,113
180070401,1,9,4,4,0,3,2,3,26
180070501,9,6,6,5,10,0,1,1,38
180070502,3,3,1,4,4,3,1,0,19
180070503,2,1,5,1,0,0,0,0,9
180070504,6,6,2,7,5,3,1,1,31
180070505,4,4,8,5,3,1,1,1,27
180070506,1,6,7,7,7,5,1,5,39
180070601,16,31,29,29,14,9,5,8,141
180070602,10,17,24,23,11,6,4,9,104
180070701,9,9,13,9,10,5,4,4,63
180070702,5,20,20,17,14,12,6,10,104
180070801,5,0,0,0,1,0,0,0,6
180070802,2,1,2,2,2,2,0,0,11
180140101,25,25,23,16,10,12,1,8,120
180140102,21,36,24,32,14,6,2,2,137
180140103,26,15,25,38,18,13,6,6,147
180140201,12,14,11,4,1,4,4,1,51
180140202,3,3,4,0,0,2,0,0,12
180140203,3,2,0,1,2,0,0,0,8
180140301,3,4,6,20,8,9,3,8,61
180140302,9,4,5,5,3,0,1,1,28
180140303,4,7,5,11,5,4,1,5,42
180140401,12,7,9,9,8,1,2,7,55
180140402,5,3,3,2,1,0,0,1,15
180140501,0,0,0,0,0,0,0,0,0
180140502,0,0,0,0,0,0,0,0,0
180210101,136,114,99,49,34,12,6,4,454
180210102,101,67,48,49,26,17,2,2,312
180210103,107,105,72,53,35,18,7,6,403
180210104,69,94,52,36,21,18,1,3,294
180210105,53,82,52,37,24,9,1,1,259
180210106,65,79,70,60,18,11,3,0,306
180210107,66,62,44,34,24,4,0,0,234
180210108,44,57,46,29,15,6,2,3,202
180210109,96,73,42,28,22,7,2,4,274
180210110,76,53,33,24,9,7,1,0,203
180210111,65,60,31,36,17,8,3,1,221
180210112,24,41,26,19,15,7,1,4,137
180210113,117,107,86,71,37,25,4,4,451
180210114,80,87,63,64,40,14,3,6,357
180210115,75,107,81,78,31,24,11,6,413
180210116,38,74,59,38,13,2,0,0,224
180210117,103,98,78,59,42,13,10,2,405
180210118,76,88,61,49,40,16,2,1,333
180210201,168,121,64,51,24,6,6,2,442
180210202,74,74,35,27,25,13,3,4,255
180210203,134,104,53,35,21,12,3,2,364
180210204,61,55,44,29,17,7,2,0,215
180210205,88,72,39,33,23,6,4,1,266
180210206,92,70,46,45,20,11,0,0,284
180210207,150,122,53,47,16,10,1,1,400
180210208,129,97,56,40,10,8,3,5,348
180210209,94,77,49,32,19,7,2,0,280
180210210,71,82,49,35,35,10,4,4,290
180210211,87,64,47,32,13,11,4,0,258
180210212,72,60,41,31,20,8,2,2,236
180210213,51,59,28,39,16,7,2,4,206
180210214,141,145,71,34,24,7,2,4,428
180210215,112,75,61,28,12,3,2,0,293
180210216,97,79,64,33,8,8,2,0,291
180210217,101,108,51,40,20,16,3,1,340
180210218,37,37,28,32,11,4,4,1,154
180210301,19,41,53,41,41,34,14,29,272
180210302,58,46,46,40,46,28,5,19,288
180210303,94,88,75,72,45,30,17,21,442
180210304,24,65,79,102,76,68,28,43,485
180210305,44,64,78,85,49,47,20,22,409
180210306,55,36,50,59,38,31,12,12,293
180210307,25,29,49,51,37,30,7,27,255
180210308,35,34,64,65,49,36,12,16,311
180210309,30,34,55,56,36,50,14,25,300
180210310,26,52,54,61,39,39,8,12,291
180210311,36,54,46,55,32,20,7,2,252
180210312,38,54,48,53,45,35,7,13,293
180210313,29,39,32,37,35,20,6,10,208
180210314,42,46,52,49,54,61,17,16,337
180210315,47,69,76,65,41,40,9,18,365
180210316,54,61,61,54,41,38,11,14,334
180210317,74,109,114,77,46,45,17,20,502
180210318,83,55,45,28,19,12,6,8,256
180210319,116,79,48,32,27,13,7,1,323
180210320,86,80,43,38,31,16,9,11,314
180210321,48,69,42,27,22,11,5,6,230
180210401,42,60,87,82,69,61,22,21,444
180210402,18,44,46,46,42,20,4,0,220
180210403,34,79,95,128,92,59,9,10,506
180210404,19,45,71,53,54,50,30,40,362
180210405,34,33,34,47,42,31,12,22,255
180210406,46,44,58,70,61,59,14,33,385
180210407,33,40,68,85,65,57,22,33,403
180210408,28,41,40,44,31,29,19,12,244
180210409,26,38,75,61,47,43,13,20,323
180210410,33,36,72,54,60,38,12,16,321
180210411,45,82,110,109,85,46,12,16,505
180210412,35,38,64,45,27,20,6,9,244
180210413,29,35,49,68,34,25,15,13,268
180210414,33,57,78,75,46,26,7,8,330
180210415,22,43,50,44,27,26,11,17,240
180210416,62,58,41,46,22,11,3,6,249
180210417,97,71,42,41,36,26,4,11,328
180210418,50,48,47,35,15,18,3,9,225
180210419,124,38,9,14,10,2,2,1,200
180210420,74,37,21,12,9,4,3,6,166
180210421,147,72,51,38,24,17,8,12,369
180210422,51,48,51,49,26,18,7,8,258
180210501,76,77,33,28,14,10,1,2,241
180210502,55,58,51,46,26,13,5,1,255
180210503,150,116,65,36,27,8,5,4,411
180210504,55,79,57,68,33,18,4,5,319
180210505,19,40,35,44,15,20,4,2,179
180210506,29,61,64,57,38,26,12,12,299
180210507,37,57,80,47,53,27,12,18,331
180210508,22,50,52,35,19,14,4,7,203
180210509,47,52,61,43,43,19,6,15,286
180210510,33,45,46,39,41,28,2,10,244
180210511,57,58,64,52,45,26,7,6,315
180210512,98,104,104,72,36,22,9,9,454
180210513,64,77,71,52,48,26,5,5,348
180210514,30,42,56,51,28,19,11,13,250
180210515,31,38,35,50,22,20,6,5,207
180210516,25,46,38,37,24,18,5,6,199
180210601,37,57,42,39,26,16,7,9,233
180210602,26,52,46,39,37,23,7,11,241
180210603,49,72,56,57,37,25,9,12,317
180210604,44,57,81,78,42,36,16,28,382
180210605,34,68,70,80,44,32,11,9,348
180210606,57,92,115,135,88,48,21,25,581
180210607,26,53,37,60,49,25,6,12,268
180210608,24,44,51,58,35,21,13,13,259
180210609,28,53,69,79,36,33,12,26,336
180210610,27,43,42,52,39,27,13,17,260
180210611,20,40,44,35,27,15,6,11,198
180210612,32,55,62,80,54,30,10,21,344
180210613,44,79,71,64,46,22,9,14,349
180210614,31,61,74,81,52,35,15,17,366
180210615,27,41,51,54,47,20,15,29,284
180210616,36,59,80,57,45,26,16,12,331
180210701,25,40,61,70,42,38,30,34,340
180210702,27,44,39,53,47,32,6,20,268
180210703,44,61,97,91,63,69,26,31,482
180210704,27,69,87,62,50,28,6,17,346
180210705,25,52,56,65,51,25,13,9,296
180210706,13,31,41,51,30,14,16,11,207
180210707,42,67,82,99,60,49,10,13,422
180210708,40,83,111,125,88,63,22,33,565
180210709,21,43,61,74,58,31,14,20,322
180210710,16,60,72,74,53,45,21,29,370
180210711,41,51,70,74,63,57,26,34,416
180210712,20,39,54,86,57,45,16,27,344
180210713,24,41,55,66,48,36,13,20,303
180210714,19,40,48,44,52,32,15,14,264
180210715,17,41,50,61,45,40,10,21,285
180210716,23,41,39,54,42,27,5,5,236
180210801,45,41,34,38,23,9,2,6,198
180210802,24,44,52,55,32,36,8,18,269
180210803,66,72,50,42,26,14,7,7,284
180210804,38,49,38,35,25,12,3,4,204
180210805,77,64,48,28,18,13,4,3,255
180210806,54,62,52,45,33,16,7,5,274
180210807,54,59,37,29,23,10,5,0,217
180210808,47,49,49,39,15,10,6,1,216
180210809,86,97,75,61,35,24,13,7,398
180210810,68,82,79,73,37,23,9,10,381
180210811,81,95,115,95,65,34,14,25,524
180210812,26,28,43,42,34,22,11,8,214
180210813,15,37,51,55,34,11,8,20,231
180210901,50,52,35,25,19,6,0,1,188
180210902,52,60,44,21,21,6,3,1,208
180210903,69,76,64,35,28,17,1,1,291
180210904,79,57,34,35,18,13,3,1,240
180210905,47,53,55,48,35,24,5,6,273
180210906,95,103,84,70,47,26,7,14,446
180210907,91,98,78,58,55,32,7,16,435
180210908,121,105,83,56,37,20,2,8,432
180210909,106,96,50,37,17,11,5,1,323
180210910,111,79,50,34,13,7,2,0,296
180210911,70,60,32,21,15,6,1,2,207
180210912,113,130,55,68,33,19,5,4,427
180210913,57,56,43,36,21,4,4,3,224
180210914,95,72,59,39,27,15,4,6,317
180210915,26,66,54,50,22,15,4,1,238
180211001,32,44,52,65,39,24,13,11,280
180211002,21,45,48,66,51,37,7,17,292
180211003,60,41,37,47,51,34,13,20,303
180211004,30,44,67,66,43,56,8,7,321
180211005,25,37,50,51,34,25,14,17,253
180211006,29,60,105,112,74,53,23,24,480
180211007,23,54,68,61,49,38,13,19,325
180211101,36,45,54,48,42,34,15,30,304
180211102,3,5,4,6,1,3,1,0,23
180211103,13,29,27,27,19,34,2,3,154
180211104,16,34,25,16,14,5,1,3,114
180211105,18,25,26,30,20,12,7,13,151
180211106,31,66,69,75,42,42,13,18,356
180211107,25,40,67,55,47,34,17,27,312
180211108,24,22,39,43,39,41,9,14,231
180211109,16,40,50,54,37,38,17,16,268
180211110,25,46,43,39,30,18,9,7,217
180211201,7,4,3,1,4,4,2,2,27
180211202,6,10,8,5,10,4,0,3,46
180211203,7,6,3,9,2,4,0,4,35
180211204,14,14,5,3,5,3,0,4,48
180211205,19,24,47,40,24,14,10,9,187
180211206,13,28,28,36,16,12,5,10,148
180211207,28,31,27,19,15,14,6,5,145
180211208,28,45,60,74,54,30,19,21,331
180211209,43,43,79,73,74,54,26,40,432
180211210,29,38,58,45,62,44,16,32,324
180211211,16,42,39,37,34,41,22,39,270
180211212,38,59,60,60,56,44,12,19,348
180211213,7,17,16,18,16,13,2,9,98
180211301,31,37,65,71,41,29,17,28,319
180211302,26,33,27,41,19,10,3,11,170
180211303,11,7,8,7,5,6,2,5,51
180211304,4,4,3,1,3,0,0,1,16
180211305,9,20,24,26,21,11,3,4,118
180211306,24,21,36,27,35,24,12,11,190
180211307,32,56,40,39,28,13,8,9,225
180211401,4,1,0,0,0,0,0,0,5
180211402,3,1,1,2,0,1,1,1,10
180211501,30,51,51,55,48,36,10,16,297
180211502,42,75,38,54,30,11,1,5,256
180211503,8,23,28,30,12,11,4,2,118
180211504,16,17,29,31,20,10,5,0,128
180211505,41,75,59,63,27,19,1,1,286
180211506,25,47,47,43,29,14,8,8,221
180211507,29,59,31,56,20,24,11,7,237
180211508,22,38,45,46,43,27,5,12,238
180211509,14,39,46,40,18,14,15,8,194
180211510,20,35,39,39,23,16,5,0,177
180211511,46,86,98,92,52,26,10,11,421
180211512,27,44,56,49,35,21,4,8,244
180211513,20,48,47,50,29,14,9,14,231
180211514,20,52,55,46,34,19,7,13,246
180211515,15,37,47,37,30,14,8,11,199
180211516,41,86,106,94,57,49,21,14,468
180211601,23,17,30,26,32,36,7,12,183
180211602,27,22,32,37,29,22,12,16,197
180211603,31,58,73,71,51,34,22,29,369
180211604,41,103,101,98,62,51,24,24,504
180211605,11,27,40,37,26,16,3,10,170
180211606,20,39,32,43,33,17,4,8,196
180211607,35,42,48,54,29,15,5,5,233
180211608,22,51,47,39,40,27,9,7,242
180211609,26,61,88,59,28,12,9,7,290
180211610,15,25,36,37,26,26,6,11,182
180211611,27,49,40,69,51,24,3,5,268
180211612,19,22,35,54,40,21,9,13,213
180211613,16,29,51,45,29,36,9,27,242
180211614,30,61,58,60,38,28,8,9,292
180211615,38,56,63,70,52,35,15,16,345
180211616,17,34,81,90,49,42,16,16,345
180211701,103,33,41,49,35,27,8,6,302
180211702,27,44,67,75,66,29,11,20,339
180211703,29,57,68,84,56,56,15,39,404
180211704,41,51,79,57,46,37,10,9,330
180211705,37,55,47,57,36,15,9,6,262
180211706,54,69,85,84,42,61,13,18,426
180211707,48,44,59,42,33,16,5,3,250
180211708,23,51,56,74,44,30,8,7,293
180211709,13,36,54,57,48,31,15,18,272
180211710,38,64,65,47,49,27,17,11,318
180211711,25,55,82,59,32,17,12,9,291
180211712,28,38,45,36,33,17,11,5,213
180211713,18,36,59,57,44,48,19,18,299
180211714,20,49,39,45,24,22,12,8,219
180211715,26,39,56,61,41,18,12,13,266
180211716,21,36,40,50,30,23,5,11,216
180211717,11,22,46,36,43,39,10,18,225
180211718,26,45,75,75,67,52,26,32,398
180211801,40,59,80,91,62,46,17,34,429
180211802,17,52,49,68,49,33,10,14,292
180211803,37,67,75,101,60,51,20,13,424
180211804,38,70,111,101,67,59,15,26,487
180211805,13,29,68,58,39,28,11,15,261
180211806,15,45,49,52,35,30,18,16,260
180211807,33,64,86,92,61,54,13,14,417
180211808,18,53,73,83,55,40,25,39,386
180211809,24,52,92,95,109,77,24,44,517
180211810,19,60,39,65,43,18,12,5,261
180211811,23,38,69,67,53,38,16,27,331
180211812,18,44,72,103,88,59,25,39,448
180211813,21,47,90,119,56,53,17,18,421
180211901,52,60,45,48,26,23,4,4,262
180211902,54,68,58,55,33,21,7,10,306
180211903,38,69,56,36,19,10,4,1,233
180211904,55,51,49,32,8,5,1,1,202
180211905,29,21,59,61,38,45,17,27,297
180211906,33,36,44,51,38,32,9,14,257
180211907,13,33,37,45,33,28,13,24,226
180211908,53,75,54,75,57,46,18,27,405
180211909,68,73,82,49,39,14,4,3,332
180211910,40,31,26,19,6,4,1,0,127
180211911,46,64,72,58,27,17,5,7,296
180211912,105,110,97,91,56,33,11,11,514
180211913,19,32,36,36,27,18,10,18,196
180211914,23,40,49,37,28,28,12,15,232
180211915,42,42,65,56,35,32,11,14,297
180211916,46,57,46,29,27,12,5,12,234
180211917,19,36,43,25,18,19,6,15,181
180211918,47,61,57,64,36,29,7,13,314
180212001,59,85,81,62,58,23,17,11,396
180212002,51,72,78,91,61,39,14,23,429
180212003,105,96,79,80,49,36,17,15,477
180212004,31,50,60,57,32,36,17,17,300
180212005,15,46,41,46,39,39,5,20,251
180212006,47,59,61,86,57,28,16,14,368
180212007,34,55,60,84,40,21,5,9,308
180212008,43,52,66,56,42,16,5,3,283
180212009,25,40,62,73,38,27,9,14,288
180212010,37,46,72,66,53,36,14,14,338
180212011,50,87,82,73,64,55,15,20,446
180212012,29,49,80,61,31,27,7,18,302
180212013,45,69,74,66,48,30,15,17,364
180212101,51,65,54,65,42,30,9,18,334
180212102,40,62,51,43,25,18,6,8,253
180212103,30,57,86,66,57,43,27,26,392
180212104,50,62,71,68,43,31,5,4,334
180212105,30,44,39,36,16,12,0,0,177
180212106,23,51,67,70,70,60,34,63,438
180212107,45,56,64,62,49,40,13,24,353
180212108,42,49,65,61,53,51,15,39,375
180212109,36,54,57,55,40,16,11,13,282
180212110,48,67,82,85,53,35,12,25,407
180212111,37,60,90,85,48,35,16,29,400
180212112,42,59,66,75,60,51,16,40,409
180212201,28,36,37,38,17,7,2,10,175
180212202,26,39,61,53,56,25,5,10,275
180212203,36,61,63,73,51,42,14,29,369
180212204,53,68,78,79,68,44,34,50,474
180212205,24,38,54,49,43,33,24,44,309
180212206,33,25,38,68,54,46,18,28,310
180212207,40,63,74,81,87,69,28,44,486
180212208,18,41,42,55,43,36,17,22,274
180212209,44,72,74,68,59,40,14,29,400
180212210,31,50,65,71,47,33,15,17,329
180212211,15,50,70,81,60,48,20,24,368
180212212,35,81,94,101,76,42,28,29,486
180212301,34,60,78,90,61,63,23,53,462
180212302,27,53,80,103,58,47,13,19,400
180212303,27,54,73,88,55,68,17,22,404
180212304,17,32,66,83,59,32,16,18,323
180212305,10,44,66,103,65,62,30,33,413
180212306,18,34,50,52,42,30,19,28,273
180212307,22,45,54,81,67,52,17,27,365
180212308,17,43,44,67,54,36,12,25,298
180212309,28,47,53,74,59,39,21,30,351
180212310,13,33,52,67,65,55,31,36,352
180212311,37,46,66,77,59,47,30,30,392
180212312,29,51,67,82,73,49,26,29,406
180212313,10,48,82,120,70,47,12,12,401
180212314,9,13,22,17,24,17,4,10,116
180280101,59,69,70,77,46,41,22,29,413
180280102,40,34,30,29,22,13,8,7,183
180280103,52,62,52,37,41,18,15,20,297
180280201,2,2,7,4,3,2,0,1,21
180280202,6,5,1,2,4,4,3,2,27
180280301,86,76,114,76,61,62,27,58,560
180280302,3,5,2,1,2,2,0,0,15
180280303,17,13,12,17,7,7,5,7,85
180280304,1,0,1,3,0,0,0,0,5
180280305,5,3,3,2,0,1,1,3,18
180280306,2,3,6,2,5,6,2,10,36
180280307,6,7,3,5,4,4,4,6,39
180280308,32,20,26,25,23,12,9,24,171
180280309,43,39,58,70,59,43,21,41,374
180280310,42,43,52,35,31,29,18,18,268
180280311,56,47,62,58,44,32,12,26,337
180280312,60,56,104,105,69,57,36,51,538
180280401,25,36,48,51,40,18,4,13,235
180280402,6,3,1,2,2,2,1,4,21
180280403,8,6,3,2,9,5,3,9,45
180280404,1,1,0,0,0,2,1,1,6
180280405,13,21,22,31,10,11,11,19,138
180280406,16,19,19,32,17,12,15,13,143
180280407,16,24,16,24,14,11,7,11,123
180280408,13,12,14,14,6,13,2,5,79
180280409,9,20,12,13,16,7,5,12,94
180280410,6,4,6,5,7,3,3,2,36
180280411,11,10,14,12,9,6,3,2,67
180280412,14,19,23,38,17,18,16,16,161
180280413,17,20,18,14,16,13,10,18,126
180280501,3,6,4,0,2,2,2,0,19
180280502,11,5,1,1,2,1,0,1,22
180280503,3,6,3,0,2,1,1,1,17
180280601,2,5,10,2,2,2,0,2,25
180280602,0,1,0,0,1,0,1,1,4
180280603,10,4,1,3,1,1,1,1,22
180280604,19,19,11,5,12,6,3,10,85
180280605,0,5,3,0,1,3,0,0,12
180280606,5,6,2,2,1,2,0,2,20
180280701,9,18,17,9,5,1,1,4,64
180280702,12,14,24,31,29,12,13,14,149
180280703,4,6,7,2,2,2,0,0,23
180280704,2,6,2,0,2,3,0,1,16
180280705,6,8,4,3,2,2,0,1,26
180280706,7,4,8,4,1,0,0,0,24
180280707,5,4,0,2,3,2,0,0,16
180350101,34,60,67,51,41,27,7,7,294
180350102,32,29,46,35,20,18,12,14,206
180350103,53,58,61,63,43,26,9,29,342
180350104,58,72,62,49,29,17,7,6,300
180350105,72,104,63,42,27,10,1,2,321
180350106,31,50,30,24,11,9,0,0,155
180350107,36,49,39,33,23,6,1,2,189
180350108,34,48,38,25,16,6,3,1,171
180350109,44,52,32,47,29,14,6,8,232
180350110,43,45,36,34,30,14,6,4,212
180350111,36,52,47,43,42,35,12,27,294
180350112,32,44,33,37,26,26,11,11,220
180350113,41,72,41,35,19,11,5,8,232
180350114,3,1,1,1,0,0,0,0,6
180350115,19,49,42,31,27,25,14,18,225
180350116,24,32,37,27,34,23,9,15,201
180350201,8,9,6,3,4,1,2,1,34
180350301,12,12,5,9,7,3,0,2,50
180350302,5,8,4,4,3,3,2,4,33
180350303,9,10,11,4,3,1,1,2,41
180350401,2,3,2,0,3,3,1,3,17
180350402,9,7,4,5,6,1,0,1,33
180350501,21,37,20,19,6,4,4,3,114
180350502,19,16,15,9,7,6,2,4,78
180350503,4,1,0,2,1,1,0,3,12
180350601,14,6,6,3,0,1,0,0,30
180350602,5,7,5,3,3,0,2,0,25
180350603,19,16,23,16,12,9,9,10,114
180350701,5,6,7,9,4,7,2,1,41
180350702,2,3,4,4,3,1,0,2,19
180350801,4,6,1,4,4,0,1,1,21
180350802,16,16,17,9,5,5,2,3,73
180350901,2,2,3,4,3,2,1,1,18
180350902,6,6,6,4,3,3,1,1,30
180351001,4,6,2,1,0,2,1,0,16
180351002,1,0,0,3,1,1,0,0,6
180351101,29,29,20,24,23,7,3,12,147
180351102,7,8,7,7,6,1,0,0,36
180351201,8,13,4,4,7,5,1,2,44
180351202,3,3,3,1,1,1,2,1,15
180351203,3,4,7,4,3,1,0,2,24
180351301,15,13,22,14,2,4,0,0,70
180351302,6,10,3,5,0,1,0,0,25
180351303,15,12,14,12,6,6,2,7,74
180351401,30,22,20,22,24,11,12,6,147
180351402,4,8,6,10,3,3,2,3,39
180351501,37,57,74,51,34,26,10,19,308
180351502,44,47,44,49,33,23,26,25,291
180351503,4,5,10,1,4,4,0,1,29
180351504,3,4,8,6,2,5,1,1,30
180351505,10,3,3,3,1,4,1,1,26
180351506,17,20,16,17,12,18,1,9,110
180351507,3,1,2,1,2,0,0,0,9
180351508,8,6,5,2,1,3,0,1,26
180351509,5,3,3,4,4,6,2,0,27
180351510,33,50,50,47,19,15,2,13,229
180351511,22,30,48,40,34,12,6,10,202
180351601,4,3,3,6,3,0,0,1,20
180351602,5,4,3,2,0,1,1,4,20
180351701,4,2,1,3,1,1,0,0,12
180351702,0,2,5,2,2,0,0,0,11
180351801,18,55,66,75,62,39,18,24,357
180351802,26,82,76,78,52,36,17,10,377
180351803,17,35,48,37,23,12,4,6,182
180351804,32,44,46,40,22,17,9,6,216
180351805,54,79,68,59,30,21,4,11,326
180351806,22,49,42,31,16,5,3,5,173
180351807,61,64,67,46,36,20,7,9,310
180351808,31,45,73,76,54,30,21,13,343
180351809,24,40,47,68,45,40,10,11,285
180351810,36,52,50,57,37,31,14,31,308
180351811,13,21,42,37,20,23,3,14,173
180351901,13,23,28,12,17,10,3,13,119
180351902,25,48,42,37,28,21,7,15,223
180351903,30,55,65,85,48,27,13,24,347
180351904,45,86,68,70,37,19,14,17,356
180351905,44,68,45,58,37,32,5,13,302
180351906,50,60,41,28,12,8,0,1,200
180351907,35,52,33,31,15,8,2,1,177
180351908,23,41,25,21,12,10,4,4,140
180351909,40,52,45,35,15,10,2,3,202
180351910,47,34,51,34,21,16,6,15,224
180351911,40,45,37,28,13,5,3,1,172
180351912,52,77,51,40,37,6,3,3,269
180351913,26,45,55,71,33,20,15,24,289
180420101,23,39,48,55,37,19,9,10,240
180420102,26,52,78,76,48,28,10,10,328
180420103,26,45,42,46,24,18,10,7,218
180420104,61,56,61,60,53,32,21,17,361
180420105,27,38,36,31,30,27,4,16,209
180420106,38,44,35,41,31,35,7,12,243
180420107,31,59,59,64,41,22,10,10,296
180420108,48,65,65,52,23,22,9,11,295
180420109,26,40,46,48,39,18,5,12,234
180420201,1,0,1,2,1,1,0,2,8
180420202,15,11,19,5,7,5,2,3,67
180420203,3,2,1,0,0,0,0,2,8
180420204,5,9,6,9,3,2,1,1,36
180420301,15,12,25,21,11,6,10,7,107
180420302,7,8,4,0,3,1,1,1,25
180420303,8,6,4,4,3,1,2,0,28
180420304,23,26,20,25,9,11,10,8,132
180420305,12,14,12,5,3,6,2,1,55
180420306,7,10,6,10,6,7,3,5,54
180420307,17,34,29,33,19,13,9,6,160
180420308,4,6,2,3,1,2,1,3,22
180420401,10,5,4,5,10,2,4,3,43
180420402,1,5,2,3,2,1,0,0,14
180420403,11,7,6,7,10,6,1,2,50
180420404,8,0,4,2,1,0,2,4,21
180420405,4,6,6,5,4,4,0,1,30
180420501,19,15,16,12,15,9,1,6,93
180420502,9,16,7,16,9,6,2,2,67
180420503,16,10,13,7,9,7,0,8,70
180420504,28,27,31,24,13,7,8,9,147
180420505,5,8,8,6,3,2,2,0,34
180420506,33,46,31,22,16,19,5,18,190
180420507,25,32,22,19,29,13,6,11,157
180420601,1,0,1,0,0,0,0,0,2
180420602,2,0,2,0,2,2,1,2,11
180420603,0,0,0,0,0,0,0,0,0
180490101,32,45,43,32,27,30,14,17,240
180490102,32,45,41,41,35,21,14,19,248
180490103,36,66,77,76,59,44,17,22,397
180490104,40,74,69,70,52,34,18,21,378
180490105,26,50,40,32,16,14,3,7,188
180490106,28,39,39,31,16,11,4,1,169
180490107,66,67,68,44,13,7,2,3,270
180490108,45,56,44,40,13,7,1,1,207
180490109,47,72,53,52,39,20,10,12,305
180490110,59,85,72,68,26,13,3,2,328
180490111,32,39,36,40,25,10,5,4,191
180490112,43,42,48,31,27,15,5,3,214
180490113,35,54,67,67,48,41,34,31,377
180490114,26,45,42,25,32,25,11,13,219
180490115,19,21,35,29,33,28,13,14,192
180490116,63,76,70,77,40,31,12,19,388
180490117,44,54,50,52,44,31,9,17,301
180490118,18,22,34,41,22,21,7,6,171
180490201,4,3,2,8,3,3,4,3,30
180490202,21,22,27,22,14,3,8,12,129
180490203,10,3,12,7,9,3,4,11,59
180490204,3,6,2,4,2,2,0,2,21
180490205,4,2,4,3,1,0,1,1,16
180490206,2,0,6,1,0,0,0,0,9
180490207,33,28,41,38,37,20,10,10,217
180490301,42,57,50,41,31,30,12,21,284
180490302,3,0,0,0,2,0,0,1,6
180490303,4,6,6,3,1,1,4,0,25
180490304,3,7,7,7,5,3,1,3,36
180490305,3,3,7,5,1,9,3,4,35
180490306,24,47,27,33,21,27,5,16,200
180490307,23,11,17,18,9,9,6,5,98
180490308,37,33,66,51,31,18,5,13,254
180490401,11,15,10,10,11,4,3,6,70
180490402,11,15,13,10,11,7,2,3,72
180490403,1,8,6,4,6,3,0,1,29
180490404,5,12,8,5,3,4,1,1,39
180490405,5,5,14,7,3,3,2,5,44
180490501,7,14,13,9,10,8,2,10,73
180490502,3,5,2,0,3,1,1,1,16
180490503,4,0,0,0,0,0,0,0,4
180490601,5,0,3,4,1,1,2,0,16
180490602,3,1,2,2,3,0,0,0,11
180490603,2,3,2,2,1,2,2,2,16
180490701,68,91,113,112,89,72,27,57,629
180490702,14,24,18,21,9,11,5,15,117
180490703,19,36,20,20,22,15,4,14,150
180490704,36,38,43,30,19,22,6,23,217
180490705,3,3,4,0,2,4,0,0,16
180490801,3,12,8,9,2,4,0,5,43
180490802,0,7,18,12,6,3,6,9,61
180490901,0,4,1,0,0,2,0,2,9
180490902,1,7,9,8,5,5,2,9,46
180490903,1,1,2,3,3,4,1,2,17
180490904,2,2,2,2,5,2,1,3,19
180491001,15,22,13,8,13,18,10,17,116
180491002,9,6,9,5,5,5,1,5,45
180491003,0,3,4,2,2,1,0,2,14
180491101,3,3,1,3,5,0,1,1,17
180560101,46,47,60,43,21,15,8,14,254
180560102,57,49,47,34,23,18,5,6,239
180560103,53,68,58,52,37,29,9,19,325
180560104,55,62,61,58,35,25,8,10,314
180560105,23,39,36,29,14,13,2,6,162
180560106,47,40,32,16,12,10,2,1,160
180560107,44,27,34,29,9,7,2,4,156
180560108,31,27,22,33,9,9,7,2,140
180560109,41,41,24,26,10,4,4,6,156
180560110,19,29,21,17,10,11,2,9,118
180560201,19,15,15,11,10,7,3,7,87
180560202,8,6,4,11,2,3,1,0,35
180560301,13,10,8,9,8,10,4,9,71
180560302,6,5,4,2,0,1,0,0,18
180560303,1,3,7,2,0,0,0,2,15
180560401,14,5,8,4,3,1,1,3,39
180560402,7,3,3,1,2,0,0,0,16
180560403,2,1,4,3,1,1,0,0,12
180560404,2,3,1,0,0,0,0,0,6
180560501,0,2,5,1,1,0,0,1,10
180560502,4,1,4,1,0,0,0,0,10
180560503,5,0,7,1,2,0,1,1,17
180560504,1,2,0,2,0,0,0,0,5
180560601,1,1,0,2,1,0,0,0,5
180560602,0,0,1,1,0,0,0,0,2
180560603,1,1,1,0,0,0,0,0,3
180560604,0,4,4,0,1,1,0,0,10
180560605,1,0,1,0,0,0,0,0,2
180630101,117,79,79,83,49,48,11,19,485
180630102,65,70,84,56,35,31,8,15,364
180630103,37,48,42,33,32,17,11,10,230
180630104,34,50,60,50,27,20,16,15,272
180630201,44,50,32,22,27,12,4,5,196
180630202,56,75,78,53,32,19,9,18,340
180630203,4,8,4,7,5,1,1,2,32
180630204,23,33,17,21,19,11,6,8,138
180630205,32,43,39,30,23,15,8,11,201
180630206,28,46,39,39,27,16,13,22,230
180630301,23,26,32,25,6,7,8,11,138
180630302,4,2,6,2,0,1,1,4,20
180630303,8,13,16,9,6,9,0,3,64
180630304,13,6,10,2,5,4,2,0,42
180630401,35,25,19,20,14,6,2,2,123
180630402,6,6,7,4,3,3,2,1,32
180630403,0,3,0,1,0,0,0,2,6
180630404,6,5,3,5,2,0,0,1,22
180630405,1,0,0,1,0,1,0,0,3
180630406,7,4,6,8,9,0,2,1,37
180630407,1,1,1,0,1,1,0,1,6
180630408,1,2,1,0,1,2,0,1,8
180630501,9,4,9,0,3,3,2,6,36
180630502,8,9,6,9,5,2,2,3,44
180630503,7,6,11,9,5,10,1,6,55
180630504,5,1,2,2,1,1,2,2,16
180630601,9,2,7,2,3,1,1,1,26
180630602,5,5,2,2,6,4,3,0,27
180630603,4,2,0,1,0,1,0,0,8
180630701,26,27,20,26,14,12,2,10,137
180630702,4,9,6,2,4,3,2,1,31
180630703,8,8,7,6,6,10,4,3,52
180630704,24,15,16,13,6,9,3,11,97
180630705,21,11,21,5,9,8,1,11,87
180630706,5,7,7,5,1,7,3,3,38
180630801,8,2,5,2,4,3,2,2,28
180630802,16,14,9,10,3,9,4,11,76
180630803,14,12,11,7,5,3,1,3,56
180630804,22,24,22,13,10,10,3,7,111
180630805,7,18,10,12,6,10,4,6,73
180630806,21,23,20,24,15,12,9,7,131
180630901,1,0,0,0,0,0,0,0,1
180700101,49,67,44,49,26,17,1,6,259
180700102,58,76,56,37,16,8,1,1,253
180700103,60,81,58,45,24,9,4,3,284
180700104,31,58,39,37,23,14,7,4,213
180700105,35,59,46,43,24,20,2,4,233
180700106,47,66,60,55,23,12,5,5,273
180700107,41,90,66,33,25,7,3,1,266
180700108,42,72,48,46,17,13,1,2,241
180700109,37,51,57,45,19,10,4,6,229
180700110,31,45,49,51,25,20,7,15,243
180700111,50,69,56,75,37,30,10,6,333
180700112,21,58,48,43,30,14,10,10,234
180700113,29,40,35,36,34,31,6,8,219
180700114,55,63,59,39,16,16,3,5,256
180700115,48,61,53,67,31,21,5,14,300
180700116,30,41,43,36,23,12,7,13,205
180700117,39,52,41,44,24,14,12,6,232
180700118,9,9,14,25,11,8,10,5,91
180700201,28,21,52,38,17,9,3,5,173
180700202,23,17,30,32,24,17,8,22,173
180700203,14,19,26,32,24,19,8,6,148
180700204,19,11,25,18,8,2,7,2,92
180700205,4,11,2,4,4,2,2,1,30
180700206,2,7,5,6,4,3,4,2,33
180700207,5,5,5,2,2,5,0,3,27
180700208,2,0,3,0,0,0,0,0,5
180700209,4,9,7,11,10,9,0,2,52
180700210,0,0,1,1,1,0,0,0,3
180700301,20,43,41,32,24,12,6,7,185
180700302,17,23,21,15,10,10,4,7,107
180700303,10,9,7,7,3,3,1,0,40
180700401,6,4,9,6,2,2,1,0,30
180700402,6,7,7,6,5,5,3,1,40
180700403,1,5,8,2,2,3,1,0,22
180700404,4,7,4,2,1,2,1,3,24
180700501,4,10,12,9,10,7,3,6,61
180700502,3,4,10,13,1,1,1,4,37
180700503,3,3,2,1,1,0,0,0,10
180700601,3,5,4,4,5,1,0,3,25
180700602,1,3,5,1,2,0,0,0,12
180700603,2,9,2,5,6,3,3,1,31
180700701,6,4,8,3,4,2,2,1,30
180700702,0,2,2,1,2,0,0,0,7
180700703,1,2,3,3,0,0,1,3,13
180700801,8,5,7,12,8,6,3,7,56
180700802,6,6,7,8,10,3,1,6,47
180700803,4,10,9,8,12,3,6,6,58
180700804,8,10,19,10,7,8,6,11,79
180700901,7,9,11,12,3,5,0,3,50
180700902,5,12,17,6,8,5,5,3,61
180701001,4,10,3,3,6,4,1,0,31
180701002,5,7,14,10,7,5,3,2,53
180701003,10,23,26,11,18,10,7,10,115
180701004,4,3,8,8,4,7,2,7,43
180701005,2,17,25,13,14,15,8,17,111
180701101,6,13,17,14,12,3,6,14,85
180701102,1,16,23,17,19,10,6,11,103
180701201,26,32,30,33,29,16,10,10,186
180701202,6,8,16,10,6,12,3,9,70
180701203,10,10,10,5,5,6,0,4,50
180701204,15,22,13,11,17,11,3,4,96
180701301,10,15,28,16,13,5,6,11,104
180701302,2,7,8,5,1,3,1,7,34
180701303,20,33,28,22,15,19,11,19,167
180701304,4,2,6,4,0,1,0,0,17
180701401,7,16,24,13,14,17,6,9,106
180701402,8,15,14,19,16,4,1,15,92
180701403,11,21,27,20,17,12,4,12,124
180701404,8,14,11,14,6,9,3,7,72
180701501,4,10,9,17,9,7,2,4,62
180701502,9,19,9,13,5,5,0,7,67
180701503,15,21,23,12,20,6,4,10,111
180701504,1,5,2,2,1,1,1,0,13
180701505,3,4,5,7,5,4,1,4,33
180701506,23,50,63,72,49,32,19,23,331
180701507,23,33,67,63,46,24,16,20,292
180701508,23,48,83,95,55,39,16,24,383
180701509,33,63,65,76,51,26,12,24,350
180701601,10,11,21,20,6,9,1,4,82
180701602,4,11,14,4,3,1,2,1,40
180701603,3,23,19,7,4,1,1,1,59
180701604,6,8,14,7,13,6,3,3,60
180701605,1,15,21,17,5,2,3,0,64
180701606,7,21,17,12,9,2,2,1,71
180701607,18,12,18,15,20,5,2,3,93
180701701,6,15,14,13,6,2,4,2,62
180701702,1,5,3,4,2,0,1,0,16
180701703,10,14,14,10,9,2,2,3,64
180701704,2,7,9,4,1,0,0,0,23
180701801,10,13,14,8,9,3,6,2,65
180701802,16,6,16,13,13,5,2,4,75
180701803,12,16,18,14,11,3,3,4,81
180701901,3,0,0,0,0,0,1,1,5
180701902,18,17,22,20,26,13,8,21,145
180701903,2,0,1,0,0,1,0,2,6
180701904,0,3,0,2,2,4,2,0,13
180701905,0,3,5,1,0,1,1,3,14
180701906,0,0,0,0,0,0,0,0,0
180701907,0,0,1,2,1,0,0,0,4
180701908,0,0,1,2,0,0,0,0,3
180701909,6,3,6,5,2,2,0,1,25
180702001,29,43,47,38,43,14,7,10,231
180702002,28,39,46,52,32,21,0,3,221
180702003,28,42,51,37,31,15,3,5,212
180702004,26,96,80,68,44,22,8,9,353
180702005,37,66,70,48,31,20,7,7,286
180702006,44,84,61,53,28,19,2,7,298
180702007,32,66,72,41,27,9,7,6,260
180702008,65,93,64,62,31,16,3,12,346
180702009,60,67,61,35,22,14,4,5,268
180702010,36,52,41,40,27,10,7,9,222
180702011,51,57,39,41,18,10,1,0,217
180702012,45,69,49,51,21,4,1,2,242
180702013,41,79,58,36,22,18,3,7,264
180702014,47,59,51,35,12,6,0,1,211
180702015,49,50,38,32,19,3,1,0,192
180702016,63,88,52,41,20,6,0,1,271
180702101,9,29,67,52,23,10,4,6,200
180702102,1,6,3,4,3,2,0,0,19
180702103,31,71,85,85,57,29,10,18,386
180702104,33,61,64,64,48,31,10,25,336
180702105,49,71,64,63,31,23,7,11,319
180702106,37,51,52,46,22,18,4,8,238
180702107,12,9,18,13,15,12,5,3,87
180702108,21,17,37,33,24,30,6,14,182
180702109,34,60,54,56,39,33,13,16,305
180702110,40,50,49,49,30,14,12,15,259
180702111,30,53,50,54,22,21,7,8,245
180702112,24,41,51,41,34,31,16,26,264
180702113,41,50,69,65,55,35,24,23,362
180702114,38,43,46,41,25,20,7,14,234
180702115,28,72,56,66,57,56,8,27,370
180702116,27,54,57,75,46,40,3,11,313
180702117,26,33,51,40,32,35,15,27,259
180702201,28,48,69,72,54,63,19,31,384
180702202,36,61,68,57,43,32,17,29,343
180702203,52,59,65,71,37,15,5,7,311
180702204,59,66,96,77,53,34,19,17,421
180702205,21,42,35,40,32,26,9,9,214
180702206,47,78,51,71,53,21,9,13,343
180702207,31,65,45,47,23,6,3,5,225
180702208,27,39,45,58,40,21,9,12,251
180702209,22,34,44,40,31,17,5,12,205
180702210,35,74,106,108,61,40,18,14,456
180702211,4,3,4,2,2,3,1,5,24
180702212,49,80,88,76,30,32,14,13,382
180702213,28,53,74,75,45,22,9,17,323
180702214,20,38,49,50,34,32,17,21,261
180702215,24,34,43,62,48,68,30,48,357
180702216,18,32,52,63,39,33,26,24,287
180702217,11,42,58,68,46,33,7,8,273
180702218,20,51,65,70,55,33,11,11,316
180770101,29,30,35,37,28,15,11,14,199
180770102,35,30,36,22,15,10,8,5,161
180770103,52,65,68,50,35,29,8,13,320
180770104,65,67,43,50,37,29,10,13,314
180770105,32,42,42,34,27,10,10,12,209
180770106,25,38,35,37,28,25,14,14,216
180770201,26,22,22,31,28,18,11,10,168
180770202,14,22,16,14,13,4,1,2,86
180770203,12,15,15,10,10,2,1,3,68
180770204,16,10,21,19,10,7,3,8,94
180770205,10,10,12,12,15,3,2,3,67
180770206,3,1,3,4,2,0,0,0,13
180770207,3,4,0,0,3,2,1,1,14
180770208,6,17,28,33,24,20,4,14,146
180770301,11,44,35,33,20,11,4,7,165
180770302,9,11,10,6,5,4,1,10,56
180770401,5,4,1,4,5,3,1,0,23
180770402,11,11,16,16,7,7,4,4,76
180770501,3,5,3,7,2,1,1,1,23
180770502,5,9,4,4,6,4,0,0,32
180770503,1,0,1,1,2,0,0,0,5
180770601,0,0,0,0,0,0,0,0,0
180770602,1,0,0,0,0,0,0,0,1
180770603,0,0,0,0,0,0,0,0,0
180840101,54,54,52,54,50,29,19,34,346
180840102,35,47,24,47,32,16,7,14,222
180840103,40,50,41,44,27,18,7,17,244
180840104,34,29,44,38,17,14,7,7,190
180840105,30,55,52,37,22,17,7,7,227
180840106,33,49,39,47,29,23,9,18,247
180840107,54,46,72,79,43,47,12,21,374
180840108,43,46,60,64,36,22,12,14,297
180840109,55,59,52,28,21,14,5,4,238
180840110,42,43,37,46,32,17,6,1,224
180840111,58,63,54,34,22,6,5,4,246
180840112,43,61,65,61,34,21,8,10,303
180840113,18,45,51,57,29,15,4,2,221
180840114,42,76,59,59,38,25,8,4,311
180840115,36,51,81,60,42,18,11,7,306
180840116,41,58,65,71,42,29,10,10,326
180840117,38,14,22,24,13,11,3,3,128
180840118,43,56,85,91,61,51,26,32,445
180840201,39,37,47,54,33,38,15,30,293
180840202,3,1,1,1,3,3,0,2,14
180840203,14,10,15,11,6,7,1,7,71
180840204,18,17,24,24,14,16,3,18,134
180840205,33,36,29,41,26,24,19,26,234
180840206,1,1,3,0,1,1,0,0,7
180840301,14,11,9,10,9,6,4,8,71
180840302,6,5,4,2,3,1,0,0,21
180840303,4,0,1,1,0,0,0,0,6
180840304,5,2,1,0,1,1,0,0,10
180840305,4,1,0,0,0,1,0,0,6
180840306,15,11,5,3,0,1,1,0,36
180840401,2,1,0,0,0,0,0,0,3
180840402,0,0,1,1,1,0,0,1,4
180840403,8,2,4,4,3,3,0,0,24
180840404,3,1,1,0,1,0,0,2,8
180840501,14,9,1,5,3,3,1,0,36
180840502,29,2,10,3,0,1,0,2,47
180840503,5,9,3,2,7,4,0,0,30
180840601,4,3,1,5,1,4,0,1,19
180840602,8,3,1,2,0,1,0,0,15
180840603,10,4,0,1,2,1,0,1,19
180840701,3,4,4,6,1,3,2,4,27
180840702,2,1,2,3,1,0,0,1,10
180840703,6,0,1,1,2,2,0,1,13
180840801,2,2,1,1,0,0,0,0,6
180840802,5,3,2,1,3,3,0,1,18
180840901,8,2,3,4,1,2,2,1,23
180840902,3,11,2,3,0,4,0,0,23
180840903,12,5,4,4,2,3,0,2,32
180841001,35,33,26,21,16,23,11,8,173
180841002,37,32,26,32,28,12,13,21,201
180841003,25,36,32,22,22,13,9,19,178
180841004,11,15,17,12,14,10,8,10,97
180841005,8,9,11,1,1,3,2,4,39
180841006,6,2,0,1,1,2,1,0,13
180841007,16,20,11,11,3,6,3,7,77
180841008,9,4,1,2,1,0,0,0,17
180841009,3,2,1,1,0,1,0,0,8
180841101,33,53,51,56,29,18,12,13,265
180841102,10,15,12,14,11,8,2,3,75
180841103,5,5,4,7,2,1,3,1,28
180841104,16,15,12,10,10,6,9,3,81
180841105,18,21,24,18,21,14,7,13,136
180841106,3,5,3,1,4,1,0,2,19
180841107,4,2,3,4,1,1,0,0,15
180841108,5,9,7,5,2,7,2,0,37
180841109,32,47,56,64,31,43,17,22,312
180841201,33,24,33,41,27,29,14,28,229
180841202,21,7,4,3,4,3,2,1,45
180841203,15,20,18,19,17,19,5,13,126
180841204,15,5,8,4,0,2,2,2,38
180841205,0,1,2,0,0,0,0,0,3
180841206,0,0,0,0,0,0,0,0,0
180841207,0,0,0,0,0,0,0,0,0
180910101,26,42,67,75,40,38,11,12,311
180910102,46,38,43,43,29,13,5,7,224
180910103,26,42,39,35,17,8,4,2,173
180910104,36,29,43,48,29,25,11,21,242
180910105,39,47,56,53,43,32,21,20,311
180910106,20,44,68,54,51,43,10,11,301
180910107,30,41,53,63,42,22,12,13,276
180910108,36,46,57,35,30,21,5,15,245
180910109,27,42,39,53,34,21,2,7,225
180910110,52,61,84,93,56,42,34,33,455
180910201,36,29,39,40,27,8,12,3,194
180910202,9,12,21,20,14,12,6,9,103
180910203,29,27,42,47,28,28,13,22,236
180910204,22,21,28,24,11,13,4,11,134
180910205,5,1,3,3,0,2,1,2,17
180910206,24,9,23,19,22,10,14,10,131
180910207,18,18,40,36,18,23,7,9,169
180910208,42,27,29,42,23,15,4,12,194
180910209,35,38,44,45,34,30,15,19,260
180910210,27,18,20,25,15,13,7,11,136
180910211,21,21,29,17,13,15,4,5,125
180910212,8,6,10,9,9,6,2,9,59
180910301,11,39,32,28,14,10,7,11,152
180910302,11,19,13,22,8,11,6,3,93
180910303,10,21,20,20,11,10,5,9,106
180910304,3,6,5,9,4,3,2,1,33
180910305,5,11,12,14,14,2,3,3,64
180910401,16,15,31,26,14,11,9,10,132
180910402,10,15,15,13,10,7,6,8,84
180910403,8,14,11,10,9,8,5,4,69
180910404,9,10,11,9,6,4,4,10,63
180910405,15,8,23,23,13,19,5,8,114
180910406,4,11,12,12,2,4,2,3,50
180910407,6,2,5,3,2,1,1,3,23
180910501,1,1,1,2,1,2,2,5,15
180910502,3,3,7,2,3,0,0,1,19
180910503,9,14,15,12,9,8,2,5,74
180910504,4,6,6,6,5,0,4,6,37
180910505,1,3,1,2,1,3,0,0,11
180910506,3,2,2,1,1,5,0,0,14
180910601,3,1,0,3,1,0,1,1,10
180910602,1,0,1,3,1,0,0,1,7
180910603,4,3,1,2,0,1,0,1,12
180910701,35,33,33,33,22,18,6,7,187
180910702,3,9,9,7,4,9,3,6,50
180910703,14,19,20,14,14,12,6,9,108
180910704,14,20,19,18,16,13,9,20,129
180910705,4,7,6,5,6,3,2,5,38
180910706,24,36,50,45,37,23,13,28,256
180910801,8,5,7,3,3,4,2,4,36
180910802,24,23,40,36,31,21,3,22,200
180910803,44,47,53,40,28,29,14,19,274
180910804,17,29,37,32,15,12,7,11,160
180910805,8,7,8,6,7,10,3,2,51
180910806,16,17,23,17,16,12,4,11,116
180910901,0,2,1,0,0,0,0,0,3
180910902,1,0,0,0,0,0,0,0,1
180910903,0,0,0,0,0,0,0,0,0
180980101,29,40,34,61,31,20,10,12,237
180980102,31,42,47,50,35,30,7,13,255
180980103,62,66,79,52,51,31,12,25,378
180980104,39,58,52,25,16,9,4,8,211
180980105,24,43,30,24,18,16,4,8,167
180980106,36,50,53,46,24,21,12,6,248
180980107,37,38,54,35,27,16,14,12,233
180980201,16,17,18,24,9,5,7,6,102
180980202,7,14,9,10,8,4,2,6,60
180980203,30,31,23,28,24,21,7,19,183
180980301,17,8,14,13,8,3,3,5,71
180980302,27,23,17,13,12,8,10,12,122
180980303,11,9,8,7,4,3,1,4,47
180980304,19,12,15,7,5,7,2,5,72
180980401,3,3,0,0,0,0,0,0,6
180980402,7,5,3,5,1,1,1,2,25
180980403,15,6,7,7,4,5,3,5,52
180980501,3,3,7,4,1,1,0,0,19
180980502,4,3,1,2,1,5,1,1,18
180980503,10,2,2,1,0,3,0,0,18
181050101,33,38,53,40,35,28,14,22,263
181050102,34,43,58,53,24,22,11,25,270
181050103,41,41,54,48,41,41,14,27,307
181050104,54,85,63,56,42,16,6,10,332
181050105,25,34,38,43,20,21,11,12,204
181050106,44,74,69,69,40,42,12,18,368
181050107,57,65,75,91,67,48,18,27,448
181050108,15,21,28,15,23,7,4,10,123
181050109,42,64,62,50,25,27,6,8,284
181050110,63,90,55,53,27,9,2,2,301
181050111,34,35,30,25,17,6,5,0,152
181050112,34,60,46,46,38,27,9,9,269
181050113,52,62,72,73,58,27,14,27,385
181050114,35,42,81,82,61,31,17,14,363
181050115,51,53,30,28,16,11,1,1,191
181050201,0,5,2,3,2,1,0,1,14
181050202,13,14,15,15,7,6,2,2,74
181050203,13,10,7,4,5,1,3,1,44
181050204,18,56,84,83,41,26,13,11,332
181050301,0,2,0,1,0,2,0,2,7
181050302,15,12,10,2,6,4,0,0,49
181050401,3,1,1,2,3,1,1,3,15
181050402,0,0,0,5,0,1,0,0,6
181050501,3,3,1,1,2,1,1,0,12
181050502,6,7,5,1,1,0,1,0,21
181050503,3,1,3,3,1,1,0,0,12
181050601,5,5,8,5,2,2,0,0,27
181050602,5,5,3,3,2,2,0,0,20
181050603,5,4,2,2,0,1,0,0,14
181050701,3,0,3,3,0,0,0,0,9
181050702,3,1,0,1,2,0,0,0,7
181050801,5,7,7,3,5,3,0,3,33
181050802,4,5,2,6,3,1,0,2,23
181050803,5,11,7,4,3,0,1,0,31
181050804,0,0,0,1,0,0,1,1,3
181050805,6,20,46,44,33,16,16,7,188
181050806,2,1,2,0,0,0,0,1,6
181050901,32,54,56,39,30,16,7,12,246
181050902,3,3,1,2,1,2,0,0,12
181050903,3,6,4,2,1,1,1,1,19
181050904,43,47,49,41,32,17,14,18,261
181051001,2,0,1,0,0,0,0,0,3
181051002,3,0,0,0,0,0,0,0,3
181051003,13,20,13,19,8,8,2,5,88
181051101,57,88,84,76,41,30,8,21,405
181051102,5,3,4,2,0,0,0,1,15
181051103,3,7,0,2,1,2,1,1,17
181051104,3,2,2,2,1,0,0,0,10
181051201,6,14,2,4,4,6,0,4,40
181051202,7,12,12,5,7,5,0,1,49
181051203,5,8,7,4,2,1,0,0,27
181051204,16,17,22,11,6,3,2,5,82
181051301,13,18,16,11,5,9,6,5,83
181051302,7,6,6,3,0,1,0,2,25
181051303,0,2,0,0,1,1,0,0,4
181051304,17,15,7,2,5,2,0,0,48
181051305,4,3,4,8,2,4,0,0,25
181051306,0,1,1,0,0,0,0,0,2
181051401,2,1,0,0,2,0,0,0,5
181051402,2,2,0,1,1,0,0,0,6
181051403,2,3,2,0,0,0,0,0,7
181051404,0,0,1,0,0,0,0,1,2
181051501,2,3,2,0,1,0,0,1,9
181051502,1,0,0,0,0,0,0,0,1
181051503,3,0,0,0,0,0,0,1,4
181051601,8,16,21,12,8,9,5,4,83
181051602,2,7,4,4,0,2,1,2,22
181051603,2,5,9,3,0,0,0,1,20
181051604,3,9,2,4,0,0,0,0,18
181051605,5,3,5,1,3,4,1,1,23
181051701,0,0,1,1,1,2,0,0,5
181051702,2,1,1,0,1,2,0,0,7
181051801,5,9,5,4,3,4,2,1,33
181051802,7,1,0,1,0,0,0,0,9
181051901,1,5,1,3,3,2,0,0,15
181051902,11,6,2,1,1,0,0,0,21
181052001,0,1,0,0,0,0,0,3,4
181052002,2,1,4,1,1,0,0,2,11
181052003,19,3,1,0,0,0,1,0,24
181052101,13,30,38,41,29,15,7,7,180
181052102,69,76,91,83,49,33,13,25,439
181052103,23,53,61,46,29,26,12,25,275
181052104,21,37,54,49,22,19,16,15,233
181052105,60,68,52,45,23,9,1,5,263
181052106,45,78,64,50,36,15,5,5,298
181052107,46,79,61,66,44,40,19,26,381
181052108,54,78,66,47,22,13,5,4,289
181052109,24,40,52,42,26,17,2,10,213
181052110,24,30,34,32,38,19,5,8,190
181052111,45,54,59,50,38,29,11,28,314
181052112,64,80,94,108,53,29,16,24,468
181052113,40,70,74,63,50,36,23,19,375
181052114,23,33,61,53,47,17,9,11,254
181120101,27,27,56,74,48,27,5,16,280
181120102,5,15,14,23,9,5,5,3,79
181120103,0,6,15,27,9,4,0,0,61
181120104,36,75,79,68,33,17,11,7,326
181120105,29,56,50,34,23,15,6,5,218
181120106,22,48,63,82,54,37,7,13,326
181120107,46,48,45,53,32,27,15,17,283
181120108,43,71,67,50,44,38,19,16,348
181120109,34,52,40,42,20,19,8,2,217
181120110,22,48,27,33,18,8,9,6,171
181120111,53,50,36,31,13,5,1,0,189
181120112,36,43,45,42,21,9,9,12,217
181120113,46,46,32,26,8,1,2,1,162
181120114,65,89,56,59,42,18,8,12,349
181120201,2,2,4,8,4,3,1,0,24
181120202,17,15,10,9,6,3,2,7,69
181120203,3,10,11,7,5,8,3,1,48
181120204,4,6,10,8,3,1,0,0,32
181120205,3,10,9,5,2,1,1,1,32
181120206,5,8,7,9,6,3,0,0,38
181120207,3,9,1,7,1,1,1,0,23
181120208,2,3,5,2,0,0,3,0,15
181120209,8,5,3,5,4,2,0,1,28
181120210,3,7,9,7,5,5,3,4,43
181120211,1,0,1,1,0,0,0,1,4
181120212,14,16,21,23,15,12,8,10,119
181120301,1,8,2,3,1,1,0,1,17
181120302,2,1,0,2,2,1,0,0,8
181120303,5,2,3,3,1,3,0,1,18
181120304,1,2,0,0,0,0,0,1,4
181120401,10,14,4,3,4,4,0,5,44
181120402,2,7,6,2,0,2,0,0,19
181120403,7,5,8,12,6,10,1,3,52
181120404,15,23,38,27,23,20,6,7,159
181120405,5,8,10,2,7,2,0,1,35
181120406,2,0,2,0,3,0,0,1,8
181120407,0,3,6,3,4,0,3,3,22
181120408,0,3,1,0,2,0,0,0,6
181120409,4,3,1,4,2,1,0,2,17
181120410,3,4,5,2,2,1,4,1,22
181120411,6,2,0,1,1,0,0,0,10
181120501,0,0,0,0,1,1,0,0,2
181120502,11,4,4,2,3,2,1,1,28
181120503,4,10,1,4,0,0,0,1,20
181120504,3,0,1,1,0,0,0,0,5
181120601,12,2,5,4,3,1,0,0,27
181120602,16,11,12,12,3,1,1,2,58
181120603,2,2,1,1,0,0,0,1,7
181120604,2,4,2,2,1,2,1,0,14
181120701,48,56,76,61,40,19,14,16,330
181120702,11,19,28,11,14,9,4,4,100
181120703,4,4,6,3,1,1,0,0,19
181120704,9,6,14,9,5,3,1,0,47
181120705,3,5,6,6,2,0,1,1,24
181120706,0,1,3,3,1,1,1,0,10
181120707,3,0,6,2,0,0,0,1,12
181120708,3,2,1,2,0,2,1,0,11
181120709,0,0,0,0,0,0,0,0,0
181120710,2,6,10,7,4,3,1,1,34
181120801,10,11,17,8,5,3,0,1,55
181120802,2,14,9,9,11,3,1,1,50
181120803,5,22,13,17,7,6,0,2,72
181120804,23,17,17,10,9,7,2,2,87
181120805,2,2,3,2,2,2,0,2,15
181120806,63,79,71,46,28,10,5,6,308
181120807,57,81,64,52,24,4,4,5,291
181120808,87,98,90,85,68,29,13,19,489
181120809,34,43,50,48,35,23,9,17,259
181120810,35,70,85,88,60,36,13,18,405
181120901,29,50,34,38,25,18,6,10,210
181120902,42,54,40,52,29,11,11,6,245
181120903,41,52,55,36,19,8,2,3,216
181120904,51,57,33,29,11,4,1,0,186
181120905,53,71,50,36,12,7,1,1,231
181120906,47,62,37,28,13,4,2,1,194
181120907,55,86,68,42,32,9,10,4,306
181120908,54,77,64,58,31,20,12,7,323
181120909,36,66,40,45,22,19,8,5,241
181120910,29,60,44,48,36,19,6,11,253
181120911,45,69,68,43,30,15,6,9,285
181120912,33,47,42,44,28,7,2,4,207
181120913,66,77,111,97,52,42,21,34,500
181120914,17,18,41,42,46,25,15,21,225
181190101,34,40,41,42,29,21,10,21,238
181190102,23,26,60,54,44,17,8,12,244
181190103,44,86,75,52,51,25,7,12,352
181190104,57,68,110,115,76,41,14,16,497
181190105,45,64,64,62,34,27,16,4,316
181190106,9,39,36,25,23,10,6,5,153
181190107,24,36,54,43,26,11,9,12,215
181190108,28,61,74,59,35,19,4,5,285
181190109,50,66,77,72,59,41,21,37,423
181190110,28,39,44,53,45,34,9,17,269
181190111,25,46,55,49,28,20,8,14,245
181190112,13,18,17,20,7,4,1,0,80
181190113,21,18,28,27,14,10,10,18,146
181190114,15,21,35,52,34,15,8,10,190
181190115,54,56,68,80,49,48,10,34,399
181190116,32,61,68,54,31,32,10,12,300
181190117,18,29,37,39,32,36,9,12,212
181190201,2,5,1,1,1,0,0,0,10
181190202,4,3,4,2,3,0,0,0,16
181190301,12,15,29,13,6,8,3,5,91
181190302,38,16,15,12,8,6,3,2,100
181190303,2,0,2,2,2,0,0,0,8
181190401,28,36,60,39,44,34,12,9,262
181190402,5,5,4,2,0,0,0,2,18
181190403,2,4,7,5,0,3,0,1,22
181190404,3,7,9,5,3,0,0,0,27
181190501,2,6,4,4,1,6,0,1,24
181190502,2,5,7,1,3,1,1,0,20
181190601,32,39,35,38,29,17,9,11,210
181190602,2,3,1,5,1,0,0,0,12
181190701,5,3,5,2,0,0,0,0,15
181190702,10,11,3,5,8,2,1,1,41
181190703,2,4,2,0,0,1,0,0,9
181190801,3,1,3,1,0,0,0,0,8
181190802,5,6,6,3,3,0,0,0,23
181190901,36,23,19,14,17,10,6,14,139
181190902,2,3,1,0,1,0,0,0,7
181190903,5,0,1,2,2,1,0,0,11
181190904,3,0,0,0,0,0,0,0,3
181190905,1,3,3,1,1,2,1,1,13
181191001,11,6,3,10,3,2,2,2,39
181191002,5,6,9,3,5,1,1,1,31
181191003,2,5,6,5,1,2,0,1,22
181191101,7,4,1,0,0,0,0,0,12
181191102,4,4,0,3,0,0,0,0,11
181191103,8,1,4,1,2,0,1,0,17
181191201,3,1,5,1,3,3,1,0,17
181191202,6,1,2,1,1,0,0,0,11
181191203,5,1,2,2,2,1,0,0,13
181191301,1,0,0,0,0,0,0,0,1
181191401,16,18,21,24,12,15,7,9,122
181191402,14,27,37,41,38,28,12,15,212
181191403,26,46,63,78,48,45,29,43,378
181191404,13,22,30,38,16,18,6,10,153
181191405,27,41,93,105,63,30,13,22,394
181191406,22,29,44,33,37,24,10,17,216
181191407,33,42,72,79,37,39,7,18,327
181191501,29,42,38,56,30,24,10,25,254
181191502,23,15,41,37,20,9,5,14,164
181191503,55,83,80,74,31,24,10,8,365
181191504,51,60,58,55,35,20,5,14,298
181191505,62,74,67,56,37,23,6,2,327
181191506,51,47,32,28,13,7,3,2,183
181191507,31,37,53,44,27,17,10,15,234
181191508,38,44,50,47,32,38,12,20,281
181191509,15,23,38,43,38,24,15,10,206
181191510,38,61,40,49,23,10,4,7,232
181191511,63,97,56,55,17,9,4,2,303
181191512,58,43,38,36,15,14,2,0,206
181191513,30,68,53,49,17,3,5,4,229
181191514,4,7,19,21,12,5,1,0,69
181191515,33,64,59,59,46,37,8,13,319
181191516,31,50,32,26,15,8,3,3,168
181191517,32,28,23,16,11,4,1,0,115
181191518,52,55,25,33,7,0,2,0,174
181191519,58,67,81,63,39,28,11,20,367
181191520,62,94,91,66,48,16,16,6,399
181191521,37,61,48,48,27,30,7,9,267
181191522,43,28,40,40,35,33,12,10,241
181191523,46,61,49,42,14,7,3,2,224
181260101,50,47,58,50,32,36,19,23,315
181260102,49,58,53,60,36,27,17,17,317
181260103,41,63,44,39,31,14,7,12,251
181260104,46,62,66,65,47,31,11,19,347
181260105,34,57,75,74,41,43,15,29,368
181260106,58,63,92,62,59,26,12,18,390
181260107,53,84,91,74,40,43,13,17,415
181260108,48,45,55,85,51,41,16,37,378
181260109,46,30,63,54,36,24,8,16,277
181260201,11,9,5,7,7,3,5,4,51
181260202,42,41,58,57,46,24,16,29,313
181260203,0,2,1,3,1,0,0,0,7
181260301,19,20,20,14,18,14,11,19,135
181260302,10,3,7,7,6,0,0,2,35
181260401,7,10,4,4,3,5,2,5,40
181260402,3,5,4,4,4,6,1,4,31
181260501,44,49,46,48,38,22,20,34,301
181260502,22,26,15,19,9,3,5,10,109
181260601,20,11,12,16,14,16,8,15,112
181260602,2,1,2,5,3,3,1,1,18
181260603,3,1,1,0,0,0,0,2,7
181260701,38,48,49,65,52,40,23,35,350
181260702,4,7,14,8,5,9,6,10,63
181260703,20,21,19,21,22,14,5,9,131
181260801,12,12,15,8,6,1,1,4,59
181260802,8,6,8,4,3,3,1,1,34
181260901,39,36,53,59,36,20,18,22,283
181260902,31,57,64,93,51,30,13,21,360
181260903,10,9,17,10,6,10,5,14,81
181260904,6,12,21,7,6,4,3,1,60
181330101,22,32,45,37,35,16,13,9,209
181330102,32,26,24,30,18,9,6,0,145
181330103,38,26,25,21,14,12,5,4,145
181330104,4,3,7,5,5,3,1,4,32
181330201,9,13,5,7,1,2,2,2,41
181330202,11,18,6,10,7,8,0,2,62
181330203,11,14,18,11,6,5,3,1,69
181330204,20,21,22,26,20,5,1,8,123
181330205,9,16,6,15,7,5,4,3,65
181330206,27,36,31,33,21,8,6,4,166
181330207,26,45,30,27,20,8,6,5,167
181330208,34,36,47,39,19,20,4,5,204
181330209,19,30,11,15,6,6,1,2,90
181330210,8,15,18,18,13,11,3,2,88
181330211,12,9,3,5,0,2,1,0,32
181330212,22,15,16,23,8,16,3,3,106
181330213,13,20,13,12,13,8,4,7,90
181330214,27,38,72,69,57,45,21,30,359
181330215,17,13,15,12,5,5,1,3,71
181330216,6,1,1,2,1,3,0,4,18
181330301,21,32,54,51,44,25,14,18,259
181330302,24,24,22,23,21,9,8,11,142
181330303,4,9,2,4,5,2,0,0,26
181330304,6,5,5,1,2,3,0,0,22
181330305,0,1,0,1,0,0,0,0,2
181330401,20,45,39,11,27,16,10,12,180
181330402,8,9,5,3,4,2,0,2,33
181330403,14,11,12,15,7,6,5,7,77
181330501,42,49,51,54,35,27,8,11,277
181330502,34,48,47,44,27,33,5,12,250
181330503,10,14,12,10,12,4,3,4,69
181330504,16,12,12,13,2,3,1,8,67
181330505,8,7,14,11,10,2,2,3,57
181330506,10,9,15,10,9,12,4,4,73
181330507,7,17,8,12,10,2,2,6,64
181330601,0,1,0,0,0,0,0,0,1
181330602,0,0,0,0,0,0,0,0,0
181330603,1,0,0,0,0,0,0,0,1
181400101,36,31,54,59,31,27,10,26,274
181400102,28,38,36,42,26,16,8,15,209
181400103,33,39,56,46,37,25,9,14,259
181400104,38,50,39,48,49,16,9,5,254
181400105,35,47,60,45,41,26,7,25,286
181400106,24,40,58,77,56,50,11,19,335
181400107,22,36,57,59,37,27,12,16,266
181400108,35,43,57,49,36,26,5,8,259
181400109,32,43,51,41,45,29,8,26,275
181400110,34,47,57,63,40,28,8,26,303
181400201,11,14,22,9,7,3,6,9,81
181400202,17,20,17,12,6,8,3,7,90
181400203,54,60,96,67,64,42,22,34,439
181400204,6,6,6,7,3,7,2,4,41
181400205,0,0,2,1,0,1,0,1,5
181400206,12,24,39,38,37,19,5,11,185
181400301,4,6,3,6,2,4,0,3,28
181400302,6,7,4,7,4,3,2,4,37
181400303,4,3,1,5,2,2,0,0,17
181400401,3,3,2,3,1,1,0,0,13
181400402,3,4,4,2,3,0,2,2,20
181400403,0,3,2,1,5,1,0,3,15
181400404,4,2,2,3,1,6,1,3,22
181400405,15,5,4,6,8,7,3,8,56
181400501,4,4,4,5,3,4,0,2,26
181400502,1,5,3,1,3,1,0,1,15
181400503,2,4,2,1,3,1,0,0,13
181400504,4,1,3,3,2,0,2,2,17
181400601,4,4,13,10,13,7,3,4,58
181400602,5,9,15,10,9,5,3,14,70
181400603,0,1,0,1,0,0,0,0,2
181400604,1,3,1,1,0,1,0,0,7
181400701,6,8,8,7,2,5,2,3,41
181400702,6,4,3,3,1,3,0,1,21
181400703,14,10,13,13,4,6,6,5,71
181400704,1,2,2,3,2,0,0,2,12
181400801,4,2,1,0,2,0,1,0,10
181400802,8,9,6,3,2,2,1,1,32
181400803,10,14,8,11,9,15,2,3,72
181400804,5,3,2,6,2,1,1,2,22
181400805,5,6,7,3,5,5,2,3,36
181400806,3,5,1,0,5,1,0,2,17
181400807,1,1,2,2,0,0,0,0,6
181400808,0,1,0,0,0,0,0,0,1
181400809,2,2,1,1,2,0,1,2,11
181400901,5,3,0,0,0,1,0,0,9
181400902,10,10,9,3,4,2,0,2,40
181400903,5,10,6,3,4,6,2,3,39
181470101,28,56,68,52,30,23,11,15,283
181470102,37,70,61,59,27,14,10,12,290
181470103,47,60,45,49,30,17,9,16,273
181470104,53,50,43,46,17,10,4,6,229
181470105,65,55,62,50,34,13,7,6,292
181470106,42,47,79,65,44,30,16,20,343
181470107,41,49,42,32,28,15,7,15,229
181470201,10,12,13,13,4,3,5,1,61
181470202,11,5,11,12,5,4,4,5,57
181470203,7,6,6,8,3,2,2,1,35
181470204,2,3,2,8,1,3,0,1,20
181470205,22,28,32,37,21,12,7,16,175
181470206,43,57,36,31,29,15,12,16,239
181470207,27,34,44,32,23,10,7,8,185
181470301,3,1,4,2,1,1,1,0,13
181470302,12,3,2,0,0,1,0,1,19
181470303,4,0,3,1,0,2,0,1,11
181470304,4,3,3,2,5,1,0,0,18
181470401,2,6,4,5,1,1,0,1,20
181470402,2,1,5,3,1,1,0,0,13
181470403,0,1,3,0,3,5,0,0,12
181470501,4,3,2,1,0,1,0,0,11
181470502,3,6,2,6,2,7,1,1,28
181470503,4,1,2,0,0,0,0,0,7
181470601,4,0,0,0,0,0,0,0,4
181470602,1,3,2,0,2,2,0,1,11
181470603,3,0,1,2,2,0,0,1,9
181470604,1,0,0,1,0,0,0,1,3
181470701,9,6,0,1,1,0,2,0,19
181470702,3,1,0,1,0,0,0,0,5
181470703,1,0,3,0,0,0,0,0,4
181470801,36,27,34,17,19,7,9,19,168
181470802,28,29,27,30,23,14,3,13,167
181470803,3,3,3,5,0,2,0,1,17
181470804,6,2,3,2,1,1,1,0,16
181470901,1,2,2,3,1,0,0,0,9
181470902,8,5,5,7,2,3,0,0,30
181470903,5,3,6,6,2,1,0,3,26
181471001,3,4,4,0,2,0,0,1,14
181471002,8,1,1,1,0,0,0,1,12
181471003,7,2,2,0,2,1,0,0,14
181471004,1,2,1,0,0,0,0,0,4
181471101,1,2,3,0,0,0,1,0,7
181471102,0,2,0,1,1,3,1,0,8
181471103,0,0,1,0,0,0,0,0,1
181471201,14,24,19,16,15,2,7,7,104
181471202,5,6,1,1,3,3,0,1,20
181471203,1,1,4,1,0,1,0,1,9
181471204,18,27,19,12,17,12,7,5,117
181540101,60,52,68,65,49,54,22,46,416
181540102,41,60,68,56,45,44,20,26,360
181540103,29,39,48,39,38,26,8,22,249
181540201,8,11,6,6,6,3,6,8,54
181540202,42,37,41,51,32,52,18,37,310
181540203,21,29,33,30,33,34,8,32,220
181540204,3,0,2,1,0,1,0,0,7
181540301,0,1,1,0,0,0,0,0,2
181540302,2,0,0,0,1,0,0,0,3
181540401,11,12,9,7,7,4,1,12,63
181540402,6,11,1,6,3,3,2,6,38
181540501,0,0,0,2,1,0,0,0,3
181540502,0,1,0,2,0,0,0,1,4
181540601,10,8,7,4,0,2,0,1,32
181540602,7,3,0,0,0,1,0,0,11
181540603,2,6,2,4,2,0,2,0,18
181540701,42,61,33,32,23,21,8,13,233
181540702,23,25,19,18,12,8,7,14,126
181540703,19,19,19,14,15,16,5,20,127
181540704,49,47,46,46,19,20,13,12,252
181540801,6,1,2,1,1,1,0,0,12
181540802,3,2,6,1,0,0,0,1,13
181540901,0,0,0,0,0,0,0,0,0
181610101,23,32,33,45,22,17,8,19,199
181610102,28,25,38,33,36,27,14,25,226
181610103,31,45,40,40,35,13,5,10,219
181610104,40,44,49,41,26,20,4,10,234
181610105,47,45,57,46,33,22,10,27,287
181610106,44,63,80,66,46,27,19,18,363
181610107,31,45,40,37,27,14,7,9,210
181610108,12,33,25,33,23,21,7,16,170
181610201,6,24,16,15,9,12,7,8,97
181610202,19,10,24,16,13,19,5,10,116
181610203,9,10,16,9,12,6,6,5,73
181610204,10,9,6,6,8,8,5,8,60
181610205,3,3,7,4,2,2,3,2,26
181610206,11,21,23,13,12,8,10,9,107
181610301,10,8,16,13,16,18,4,9,94
181610302,0,1,0,1,0,0,0,0,2
181610303,3,5,4,2,6,4,2,5,31
181610304,0,0,0,0,0,0,0,2,2
181610401,31,27,31,14,15,13,9,14,154
181610402,10,8,16,15,11,7,6,7,80
181610403,3,2,4,1,1,0,0,1,12
181610404,6,13,14,5,3,8,5,7,61
181610405,27,45,34,46,31,26,16,8,233
181610501,8,4,7,5,2,1,2,2,31
181610502,15,5,1,2,2,0,1,1,27
181610503,4,8,7,3,6,1,0,3,32
181610504,37,48,61,59,43,24,10,16,298
181610505,47,44,55,39,52,29,12,36,314
181610601,53,45,59,43,36,23,14,16,289
181610602,5,16,12,14,5,7,6,8,73
181610603,8,15,23,23,6,6,2,7,90
181610604,4,1,0,2,4,1,0,0,12
181610605,13,17,29,26,19,16,4,7,131
181610606,10,6,10,7,5,4,2,11,55
181610607,48,41,55,44,36,20,16,16,276
181680101,15,8,10,10,3,5,3,3,57
181680102,57,45,57,36,38,26,6,5,270
181680103,56,71,47,43,25,19,7,4,272
181680104,96,64,54,43,28,14,10,6,315
181680105,64,46,45,34,23,6,4,6,228
181680106,38,51,48,48,43,30,13,20,291
181680107,45,45,49,38,45,41,19,26,308
181680108,58,65,60,43,36,29,12,14,317
181680109,37,70,90,68,31,28,10,12,346
181680110,30,49,64,57,38,19,5,9,271
181680201,16,15,14,11,9,10,6,10,91
181680202,15,8,10,5,9,2,4,7,60
181680301,4,7,4,4,6,3,1,1,30
181680302,9,7,4,2,1,0,0,4,27
181680303,3,4,4,1,1,2,0,0,15
181680401,3,1,1,0,0,2,1,2,10
181680402,7,2,4,0,0,1,1,0,15
181680403,2,5,2,0,3,2,0,0,14
181680501,24,16,6,10,6,2,0,2,66
181680502,1,1,3,1,1,1,1,0,9
181680601,1,2,0,0,3,0,0,1,7
181680602,5,2,2,0,2,0,0,0,11
181680603,27,13,13,7,8,4,1,4,77
181680604,22,1,1,0,0,0,0,0,24
181680701,22,33,50,42,47,29,19,23,265
181680702,66,65,95,80,61,38,24,31,460
181680703,58,75,80,95,68,36,16,14,442
181680704,35,52,51,42,31,26,5,12,254
181680705,62,72,88,86,89,92,50,56,595
181680706,39,49,73,68,48,54,28,30,389
181680707,19,19,35,45,33,21,10,22,204
181680708,1,0,0,0,0,0,0,0,1
181680709,0,0,0,0,0,0,0,0,0
181680710,2,4,0,1,0,2,0,0,9
181680711,12,18,23,29,20,15,12,19,148
181680712,42,60,65,83,59,37,29,26,401
181680713,48,69,74,64,35,21,4,10,325
181680714,46,47,38,27,21,11,7,7,204
181680715,38,35,48,50,30,27,16,6,250
181680716,26,51,64,61,20,22,12,8,264
181680717,24,43,52,49,19,14,9,20,230
181680718,43,67,78,77,66,41,10,19,401
181680719,34,76,81,63,54,25,7,20,360
181680720,24,44,54,56,49,33,13,19,292
181680721,25,36,57,61,29,18,8,8,242
181680722,45,69,94,90,67,35,10,30,440
181680723,43,57,45,40,20,12,1,9,227
181680724,43,50,59,25,25,11,4,8,225
181680725,26,71,78,87,67,51,21,39,440
181680726,0,0,0,1,1,1,0,0,3
181680727,18,31,51,44,34,40,18,17,253
181680801,14,11,9,9,3,4,2,2,54
181680802,9,6,3,2,0,0,0,0,20
181680803,0,2,0,0,0,0,0,0,2
181680804,3,2,4,3,1,1,1,0,15
181680901,0,2,4,1,0,0,0,0,7
181680902,0,1,0,1,0,0,0,0,2
181680903,5,0,0,2,1,0,0,0,8
181680904,2,0,1,1,0,0,1,0,5
181681001,0,1,0,1,0,0,0,0,2
181681002,10,9,10,9,8,6,1,4,57
181681003,8,3,4,5,3,3,1,0,27
181681101,3,1,1,0,0,0,0,0,5
181681102,2,1,1,1,0,0,0,0,5
181681103,15,15,11,11,10,7,3,6,78
181681201,22,22,22,19,7,6,5,7,110
181681202,1,1,1,1,1,0,0,0,5
181681203,5,5,0,2,2,0,0,2,16
181681204,2,1,2,3,0,0,0,1,9
181681301,1,1,3,1,3,1,0,0,10
181681302,11,11,8,3,3,4,0,1,41
181681303,17,25,37,33,24,15,4,6,161
181681304,4,0,2,2,1,0,0,0,9
181681305,24,12,13,7,7,3,1,6,73
181681306,14,21,32,40,18,14,10,12,161
181681307,12,40,84,125,95,69,22,30,477
181681401,23,31,50,29,28,21,11,8,201
181681402,13,13,10,6,7,2,1,6,58
181681403,7,6,2,3,3,0,0,1,22
181681404,10,16,12,9,6,6,3,2,64
181681501,8,8,13,9,6,3,1,5,53
181681502,3,2,1,0,0,0,0,0,6
181681601,42,32,25,19,21,19,9,14,181
181681602,89,6,3,4,1,2,2,2,109
181681603,12,12,4,0,0,2,0,2,32
181681604,2,4,0,2,0,0,0,0,8
181681701,66,54,55,58,40,42,13,16,344
181681702,108,83,59,28,21,10,1,1,311
181681703,110,88,51,47,22,14,3,2,337
181681704,43,61,49,40,26,21,4,9,253
181681705,62,57,35,26,17,11,3,5,216
181681706,123,67,31,26,6,4,2,0,259
181681707,92,74,54,49,29,17,6,14,335
181681708,61,85,67,61,62,22,7,19,384
181681709,45,39,56,55,42,32,8,22,299
181681710,38,45,59,65,41,48,15,31,342
181681711,15,15,30,39,32,25,7,13,176
181681712,28,44,65,67,40,47,11,23,325
181681713,44,65,65,53,28,12,7,5,279
181681714,11,33,50,72,47,25,4,14,256
181750101,31,38,46,31,24,18,8,20,216
181750102,30,38,36,27,27,18,11,8,195
181750103,42,65,45,43,20,6,3,3,227
181750104,39,50,61,53,34,22,12,18,289
181750105,51,52,60,63,34,27,16,23,326
181750106,53,67,66,33,36,21,6,12,294
181750107,74,77,72,40,28,23,10,17,341
181750108,11,16,13,8,12,10,4,4,78
181750201,1,4,3,2,1,0,0,1,12
181750202,3,7,3,0,1,2,1,1,18
181750203,0,6,3,2,1,1,0,0,13
181750204,5,8,4,8,1,3,1,0,30
181750301,2,4,3,1,1,4,0,0,15
181750302,11,7,0,3,2,1,2,0,26
181750303,4,4,4,2,2,2,1,6,25
181750401,3,8,2,3,4,4,0,2,26
181750402,7,12,1,6,3,3,3,6,41
181750403,9,12,16,7,4,5,2,3,58
181750501,18,27,15,11,8,11,5,4,99
181750502,0,2,1,1,0,0,1,1,6
181750503,4,0,3,3,1,3,0,4,18
181750601,12,6,7,8,10,3,5,5,56
181750602,9,3,5,7,7,2,0,7,40
181750603,4,2,1,0,0,0,0,1,8
181750604,6,3,0,0,0,0,0,0,9
181750605,8,4,1,3,2,2,0,1,21
181750701,0,1,0,0,0,0,0,2,3
181750702,3,0,1,1,3,0,0,0,8
181750801,5,0,0,0,2,2,0,0,9
181750802,1,4,0,1,0,0,0,1,7
220070101,50,50,66,54,59,42,27,27,375
220070102,80,53,74,87,46,35,18,58,451
220070103,20,40,51,61,32,29,19,19,271
220070104,33,30,42,38,26,19,4,17,209
220070201,19,7,17,12,7,11,3,5,81
220070202,14,10,4,3,1,1,2,2,37
220070203,15,7,9,3,6,4,2,2,48
220070204,22,20,18,11,10,25,1,2,109
220070205,4,4,4,7,5,1,3,4,32
220070206,18,10,14,15,8,5,2,5,77
220070207,12,10,10,14,12,14,2,8,82
220070208,40,43,70,77,67,53,17,43,410
220070209,10,16,19,28,17,22,8,16,136
220070301,4,5,7,8,4,1,2,1,32
220070302,30,14,5,8,4,6,0,1,68
220070303,5,8,4,5,2,4,0,1,29
220070304,15,20,21,16,10,8,3,6,99
220070401,12,8,5,5,4,6,1,1,42
220070402,12,5,4,1,2,5,0,0,29
220070403,17,5,4,1,0,1,0,0,28
220070404,9,5,3,4,2,1,1,2,27
220070501,21,13,15,15,9,14,6,7,100
220070502,23,18,30,38,29,31,8,17,194
220070503,28,36,30,33,20,22,1,4,174
220070504,14,16,8,5,5,4,2,5,59
220070505,13,8,9,11,7,4,2,4,58
220070506,28,28,45,39,45,38,23,24,270
220070507,28,26,31,37,22,18,10,12,184
220070508,40,37,56,63,51,49,19,39,354
220070509,38,50,47,53,32,49,16,41,326
220070601,26,32,26,13,13,4,2,1,117
220070602,22,15,11,11,12,12,0,6,89
220070603,17,19,16,27,24,15,4,9,131
220070604,6,14,9,8,5,4,1,5,52
220070701,31,38,56,51,43,41,9,19,288
220070702,45,51,66,57,56,28,12,23,338
220070703,20,33,29,28,20,9,5,3,147
220070704,40,58,46,42,20,10,4,1,221
220070705,44,69,95,77,46,29,10,18,388
220070706,45,57,57,51,42,24,8,6,290
220070707,31,31,48,42,41,24,13,12,242
220070708,44,54,75,72,46,45,18,31,385
220070801,30,12,19,12,6,5,3,2,89
220070802,8,9,9,7,4,5,5,6,53
220070803,11,13,9,7,10,12,2,3,67
220070804,8,7,10,7,5,2,1,4,44
220070805,3,3,1,3,4,0,0,2,16
220070806,12,8,2,6,4,0,0,2,34
220070807,34,20,26,43,37,34,18,21,233
220070901,35,39,56,59,39,25,13,8,274
220070902,32,36,47,42,38,15,11,8,229
220070903,20,13,15,13,11,7,2,6,87
220070904,25,49,28,32,34,17,7,11,203
220070905,41,46,56,51,58,43,7,20,322
220140101,1,0,2,1,0,0,1,1,6
220140102,22,14,16,15,9,7,2,3,88
220140103,23,29,38,25,20,13,9,11,168
220140201,1,2,1,0,1,0,0,0,5
220140202,2,5,7,1,2,0,0,1,18
220140203,7,5,6,4,1,2,0,0,25
220140301,3,2,3,0,0,0,1,0,9
220140302,3,1,0,0,0,0,0,0,4
220140303,4,1,0,2,0,0,1,0,8
220140304,1,2,0,1,0,0,0,0,4
220140305,16,7,7,7,0,0,1,0,38
220140306,5,9,8,1,3,0,1,0,27
220140307,61,58,55,35,30,23,7,7,276
220140308,57,56,47,39,35,14,2,11,261
220140401,60,75,51,55,32,10,9,13,305
220140402,25,29,31,39,15,23,11,14,187
220140403,9,10,6,8,10,2,3,8,56
220140404,16,10,12,10,4,7,4,4,67
220140405,51,46,66,59,50,34,10,21,337
220140406,17,24,15,17,8,5,4,6,96
220140407,7,12,19,13,5,8,5,2,71
220140408,36,47,66,54,31,17,3,4,258
220140409,31,26,20,30,16,19,8,18,168
220140410,36,54,61,55,32,18,10,15,281
220140411,21,40,44,38,24,14,4,5,190
220140412,53,43,67,60,40,32,15,31,341
220140501,50,60,56,40,26,17,12,19,280
220140502,74,84,73,74,32,21,5,18,381
220140503,58,69,54,52,25,19,8,7,292
220140504,60,59,64,54,34,19,10,15,315
220140505,21,36,28,21,21,23,8,10,168
220140601,56,87,73,49,29,22,6,9,331
220140602,49,52,45,37,24,4,2,5,218
220140603,48,55,73,35,14,15,4,4,248
220140604,62,70,77,73,40,42,17,23,404
220140605,38,40,31,30,9,6,7,6,167
220140701,10,8,5,4,1,1,0,2,31
220140702,20,15,10,16,16,13,4,11,105
220140703,15,16,8,5,4,1,0,2,51
220140704,41,36,43,60,39,19,8,7,253
220140705,33,27,43,49,40,14,3,10,219
220140801,16,9,7,8,5,9,7,7,68
220140802,4,11,8,11,6,1,4,9,54
220140803,15,16,18,12,14,7,1,13,96
220140804,4,3,4,4,2,0,3,1,21
220140805,18,11,19,15,8,7,6,8,92
220140901,5,5,3,2,1,0,0,0,16
220140902,5,4,4,5,3,0,0,3,24
220210101,5,7,9,1,3,4,2,2,33
220210102,5,11,10,5,3,4,1,4,43
220210201,11,9,9,4,4,4,1,3,45
220210202,5,5,3,7,4,5,2,3,34
220210301,2,4,6,1,0,2,2,1,18
220210302,4,14,9,9,5,9,0,4,54
220210303,3,9,5,4,5,1,3,3,33
220210401,8,9,12,6,7,12,3,7,64
220210402,2,6,0,2,0,0,0,0,10
220210403,20,36,24,26,27,14,9,13,169
220210501,9,10,8,5,5,5,1,4,47
220210502,15,22,18,11,18,16,7,7,114
220210503,20,37,34,29,18,19,4,8,169
220210504,31,50,42,43,28,8,1,0,203
220210505,18,19,32,51,33,31,19,27,230
220210506,37,34,57,49,38,16,12,13,256
220210507,24,41,56,81,49,34,8,21,314
220210508,26,51,66,71,56,43,18,17,348
220210601,36,30,17,24,18,18,2,10,155
220210602,10,5,6,7,9,5,1,4,47
220210603,13,17,11,19,6,20,2,4,92
220210604,20,13,27,16,18,11,7,12,124
220210605,18,37,39,28,42,34,18,31,247
220210606,19,26,38,30,23,16,3,10,165
220210607,33,29,54,46,40,26,18,19,265
220210608,21,33,50,46,47,33,17,32,279
220210701,19,42,45,57,59,40,14,18,294
220210702,30,55,43,33,19,11,2,3,196
220210703,18,30,35,26,17,9,0,5,140
220210704,60,87,111,113,93,41,29,37,571
220210705,42,57,50,59,21,11,6,2,248
220210706,17,51,43,27,18,13,3,2,174
220210707,27,37,35,27,25,12,4,11,178
220210708,43,91,72,70,37,14,3,2,332
220210709,38,57,62,85,43,17,4,6,312
220210710,46,66,48,42,21,13,4,3,243
220210711,33,65,57,36,17,5,1,0,214
220210712,41,53,27,31,10,2,0,1,165
220210713,74,108,66,58,27,9,4,0,346
220210714,61,63,53,46,21,4,2,4,254
220210715,42,70,45,44,19,15,1,1,237
220210716,53,50,44,22,9,4,0,0,182
220210717,34,46,34,31,3,2,1,0,151
220210718,27,44,59,49,22,16,2,4,223
220210719,30,69,90,95,60,28,6,13,391
220210720,20,42,36,48,22,7,3,1,179
220210721,25,41,41,54,45,19,5,16,246
220210722,6,15,21,39,24,6,2,0,113
220210723,11,30,40,45,30,7,1,0,164
220210801,42,57,77,84,59,31,12,14,376
220210802,21,35,36,39,42,28,21,46,268
220210803,31,35,43,58,38,36,23,35,299
220210804,39,61,55,60,38,22,5,7,287
220210805,22,48,35,26,10,2,0,0,143
220210806,50,55,65,39,42,16,14,10,291
220210807,56,77,46,40,19,8,2,1,249
220210808,33,57,72,74,43,33,10,6,328
220210809,33,48,48,44,37,28,8,9,255
220210810,35,49,46,34,18,11,1,4,198
220210811,23,37,35,43,25,29,20,28,240
220210812,20,34,46,30,28,40,9,10,217
220210813,25,29,45,51,38,26,9,16,239
220210814,27,30,44,67,44,31,21,32,296
220210815,22,16,36,33,20,32,14,34,207
220210816,22,30,45,33,36,21,11,6,204
220210901,3,5,5,2,1,1,0,2,19
220210902,3,9,5,1,7,7,2,3,37
220210903,8,9,9,8,6,3,2,2,47
220211001,5,8,3,5,8,4,1,4,38
220211002,8,7,12,4,4,9,2,2,48
220211003,6,13,6,2,3,1,2,2,35
220211101,10,10,4,10,4,7,3,3,51
220211102,2,6,4,1,2,2,0,1,18
220211103,8,9,4,5,6,6,0,2,40
220211201,7,14,7,7,4,2,0,0,41
220211202,6,14,10,10,7,11,2,4,64
220211301,2,5,4,4,3,6,3,3,30
220211302,8,8,4,4,10,6,0,5,45
220211401,5,11,7,4,5,2,1,0,35
220211402,5,11,4,6,3,4,0,1,34
220211501,65,67,37,26,13,2,4,0,214
220211502,41,54,41,24,16,4,4,1,185
220211503,39,62,36,23,12,1,0,1,174
220211504,54,68,50,59,40,13,3,7,294
220211505,51,65,54,47,27,17,11,5,277
220211506,83,109,165,164,117,84,34,44,800
220211507,38,47,44,48,22,12,5,5,221
220211508,78,76,83,79,42,23,9,17,407
220211509,39,53,54,51,40,31,9,5,282
220211510,18,69,71,56,31,30,10,5,290
220211511,32,61,89,75,59,30,8,15,369
220211512,25,32,54,41,40,42,10,16,260
220211513,51,53,19,17,4,1,1,0,146
220211601,20,45,57,62,58,30,10,18,300
220211602,52,63,66,51,29,23,1,2,287
220211603,41,54,27,22,10,4,0,0,158
220211604,45,49,36,31,28,11,4,8,212
220211605,37,49,61,89,48,41,21,23,369
220211606,37,41,32,34,23,10,2,3,182
220211607,131,75,45,21,14,4,3,0,293
220211608,54,76,51,28,29,14,6,4,262
220211609,27,36,26,43,30,19,9,10,200
220211610,34,36,65,45,41,36,13,18,288
220211611,39,62,64,60,58,39,5,4,331
220211612,73,50,38,34,32,13,1,1,242
220211613,83,99,55,35,22,9,3,1,307
220211614,33,42,40,44,35,37,10,19,260
220211615,22,35,34,54,41,30,12,19,247
220211616,115,77,43,32,14,5,0,1,287
220211617,20,22,37,30,30,29,12,18,198
220211618,38,44,55,64,54,44,15,16,330
220211701,62,59,43,31,17,1,0,0,213
220211702,50,35,28,25,11,4,2,2,157
220211703,46,46,50,56,20,7,5,7,237
220211704,40,44,30,19,7,4,0,0,144
220211705,70,59,44,28,13,5,3,2,224
220211706,61,74,66,49,20,16,4,1,291
220211707,45,49,60,66,39,15,8,11,293
220211708,27,40,42,45,24,20,5,8,211
220211709,54,76,61,76,48,24,7,14,360
220211710,50,68,71,50,37,21,8,9,314
220211711,87,63,35,54,18,5,4,4,270
220211712,32,55,53,70,40,32,15,20,317
220211713,33,45,50,49,33,25,12,19,266
220211714,27,34,62,71,58,47,25,20,344
220211715,46,40,46,33,14,6,1,7,193
220211716,27,57,43,52,30,25,7,7,248
220211717,18,37,34,43,35,22,7,15,211
220211718,30,24,51,44,45,27,9,15,245
220280101,46,48,50,53,29,23,10,16,275
220280102,70,91,89,67,47,47,16,17,444
220280103,59,62,52,43,34,12,4,6,272
220280104,40,73,74,61,30,18,4,3,303
220280105,66,90,92,80,29,21,4,9,391
220280106,42,57,65,72,34,25,6,12,313
220280107,67,75,64,46,20,6,5,2,285
220280108,46,63,47,38,19,12,2,4,231
220280109,40,64,68,54,31,22,11,7,297
220280110,41,52,55,68,34,30,3,10,293
220280111,35,61,39,29,11,3,1,0,179
220280112,51,64,53,45,20,15,4,3,255
220280113,51,67,75,61,35,28,19,16,352
220280114,61,58,89,78,26,11,4,3,330
220280115,51,64,68,73,40,21,10,15,342
220280116,26,33,56,70,68,33,13,37,336
220280117,47,70,77,72,45,25,13,13,362
220280118,38,49,72,55,50,30,6,16,316
220280201,15,30,29,24,31,18,7,17,171
220280202,5,11,13,12,9,2,1,10,63
220280203,17,23,31,36,31,17,2,11,168
220280301,17,23,41,43,21,19,4,10,178
220280302,23,24,21,31,18,14,4,6,141
220280303,6,10,4,9,7,4,2,2,44
220280304,3,10,11,14,5,6,4,2,55
220280305,9,15,14,10,8,6,1,5,68
220280306,16,23,47,60,31,17,7,6,207
220280307,29,39,83,70,40,12,3,3,279
220280308,21,46,57,54,28,16,3,8,233
220280309,36,46,93,93,54,39,6,18,385
220280310,29,33,71,57,46,27,24,33,320
220280311,22,45,45,75,56,37,28,21,329
220280401,8,10,9,6,3,4,2,0,42
220280402,3,7,4,6,3,4,0,2,29
220280403,8,12,7,9,2,1,2,1,42
220280501,15,12,13,18,10,12,13,13,106
220280502,6,3,2,3,1,1,0,2,18
220280503,8,4,6,5,11,2,1,3,40
220360101,39,30,33,61,45,30,13,16,267
220360102,33,52,55,62,38,24,11,16,291
220360103,18,30,27,18,13,5,1,1,113
220360104,37,38,40,25,17,15,2,8,182
220360105,52,60,64,73,29,25,6,7,316
220360106,79,80,65,70,45,19,14,13,385
220360107,67,54,50,33,18,10,1,4,237
220360108,35,44,56,57,31,13,5,12,253
220360109,22,19,47,37,22,14,5,8,174
220360110,32,41,54,66,40,43,10,17,303
220360111,22,33,53,43,28,19,8,11,217
220360112,48,58,63,53,27,21,7,16,293
220360113,24,30,52,64,41,25,19,29,284
220360114,23,36,43,50,38,17,10,15,232
220360201,6,12,14,11,8,3,4,3,61
220360202,7,12,11,14,9,12,2,12,79
220360203,5,18,15,10,9,4,3,5,69
220360204,1,7,8,4,4,0,2,0,26
220360301,1,1,0,0,0,0,0,0,2
220360302,26,22,26,27,15,16,11,16,159
220360303,3,8,9,4,2,6,0,3,35
220360304,10,23,30,22,25,16,7,12,145
220360305,12,14,10,12,5,4,4,3,64
220360401,7,6,4,5,1,5,0,0,28
220360402,3,4,3,3,3,3,1,0,20
220360403,16,12,16,15,12,3,8,5,87
220360404,5,6,6,1,2,2,1,3,26
220360405,21,18,18,34,11,4,4,8,118
220360406,7,9,6,4,4,1,0,0,31
220360501,5,2,7,1,1,1,0,0,17
220360502,14,7,10,6,3,1,0,0,41
220360601,5,6,7,6,3,2,1,1,31
220360602,10,6,4,0,3,0,3,0,26
220360603,19,28,23,24,10,5,1,14,124
220360604,14,7,5,5,2,1,0,1,35
220360701,6,6,4,3,1,9,0,0,29
220360702,9,5,8,0,2,1,0,0,25
220360801,12,3,0,1,0,0,0,0,16
220360802,3,1,0,0,0,0,0,0,4
220360803,3,2,0,0,0,0,1,0,6
220360804,3,0,3,1,0,0,0,0,7
220360805,0,0,1,0,1,0,0,0,2
220360901,76,62,93,93,56,31,15,20,446
220360902,13,18,23,24,19,24,7,17,145
220360903,0,2,1,0,1,0,0,0,4
220360904,5,5,6,0,1,3,0,5,25
220360905,9,3,2,6,3,0,0,0,23
220360906,18,29,38,48,25,14,7,10,189
220360907,32,55,66,63,41,37,16,19,329
220390101,17,10,21,22,15,10,7,8,110
220390102,6,8,11,14,5,4,0,2,50
220390103,3,5,2,1,1,1,0,1,14
220390104,5,4,2,1,0,0,2,0,14
220390105,21,18,32,23,15,19,5,5,138
220390106,29,47,57,64,32,20,6,22,277
220390107,59,61,50,35,17,9,1,2,234
220390108,17,26,22,37,36,26,14,14,192
220390109,43,32,72,70,40,21,9,11,298
220390110,44,55,59,30,19,12,1,1,221
220390111,28,35,56,50,30,10,1,8,218
220390201,3,7,11,3,1,1,2,3,31
220390202,6,5,9,5,5,3,1,0,34
220390203,5,6,3,10,3,2,1,2,32
220390204,13,10,7,8,4,6,2,1,51
220390301,5,9,7,2,1,1,1,0,26
220390302,6,1,1,0,0,1,0,0,9
220390303,10,5,8,9,4,3,2,2,43
220390304,9,3,4,9,4,1,2,2,34
220390305,17,24,20,17,8,6,1,2,95
220430101,50,53,69,43,32,9,3,3,262
220430102,43,53,48,36,19,5,4,0,208
220430103,30,46,73,63,39,25,12,24,312
220430104,17,40,49,49,30,25,10,19,239
220430105,40,53,40,44,34,18,3,8,240
220430106,52,51,62,54,30,12,5,2,268
220430201,13,20,28,30,17,18,8,8,142
220430202,19,8,22,10,10,4,2,7,82
220430203,12,20,14,15,13,13,4,9,100
220430204,8,7,8,6,10,5,0,1,45
220430205,45,46,53,60,54,42,16,35,351
220430301,4,3,3,1,2,3,0,0,16
220430302,10,33,34,29,19,20,0,1,146
220430303,16,22,15,35,37,26,1,0,152
220430304,21,22,43,31,31,20,2,5,175
220430305,33,37,34,39,25,57,6,6,237
220430401,1,7,5,1,2,2,0,0,18
220430402,20,22,20,12,8,8,1,1,92
220430403,4,6,11,8,3,2,1,2,37
220430501,8,4,7,4,3,4,1,0,31
220430502,10,13,9,17,2,0,2,5,58
220430503,2,6,3,4,1,1,0,1,18
220490101,49,66,56,43,25,12,8,7,266
220490102,35,45,41,48,43,24,15,17,268
220490103,46,43,63,57,40,22,10,21,302
220490104,41,74,69,45,18,23,7,6,283
220490201,8,2,5,2,2,3,0,1,23
220490202,8,4,4,2,2,4,0,0,24
220490203,1,1,0,1,1,0,0,0,4
220490301,4,5,7,6,8,3,1,6,40
220490302,4,7,11,6,7,5,2,2,44
220490303,4,15,13,2,3,4,2,0,43
220490304,42,52,65,90,84,55,33,33,454
220490305,3,3,2,3,3,2,3,2,21
220490306,8,2,2,5,3,3,2,0,25
220490307,12,29,30,31,23,27,9,19,180
220490308,38,15,29,26,12,17,4,4,145
220490309,31,36,51,62,47,31,11,13,282
220490310,19,24,22,21,34,22,15,17,174
220490311,33,49,78,68,83,44,20,32,407
220490401,6,8,2,3,3,2,3,2,29
220490402,7,6,0,1,0,0,0,2,16
220490403,14,9,7,11,2,2,1,2,48
220560101,68,72,83,83,33,36,17,9,401
220560102,44,83,105,99,50,37,20,18,456
220560201,40,58,65,54,54,31,12,15,329
220560202,9,5,6,2,2,1,0,2,27
220560203,11,2,5,9,4,5,0,2,38
220560204,0,0,0,0,1,0,1,0,2
220560301,6,10,12,9,4,4,0,4,49
220560302,5,11,9,8,5,5,3,6,52
220560303,12,11,22,11,16,6,4,6,88
220560304,8,11,4,5,8,6,2,8,52
220560305,28,43,43,57,34,20,7,9,241
220560306,43,43,66,54,39,11,3,6,265
220560307,3,4,4,4,1,2,1,0,19
220560308,3,2,3,1,1,0,0,1,11
220560309,27,23,40,55,42,15,17,8,227
220560310,43,61,57,61,32,11,11,8,284
220560311,32,56,68,59,49,28,12,18,322
220560312,19,18,19,20,12,8,2,7,105
220560313,45,68,78,80,58,28,13,15,385
220560314,56,56,63,51,49,23,9,7,314
220560401,3,2,4,3,1,1,0,0,14
220560402,7,4,3,1,0,2,0,0,17
220630101,50,48,58,40,37,19,5,5,262
220630102,64,72,72,51,28,10,2,2,301
220630103,35,40,45,37,26,14,3,0,200
220630104,50,78,46,45,15,5,1,3,243
220630105,47,57,52,45,22,12,4,3,242
220630106,44,49,53,50,25,19,5,5,250
220630107,57,70,71,46,26,15,4,8,297
220630108,46,45,64,54,34,26,6,8,283
220630109,48,49,48,42,29,9,4,1,230
220630202,55,92,54,52,43,42,11,16,365
220630203,37,54,50,43,33,40,6,20,283
220630204,17,14,16,21,19,12,9,18,126
220630205,0,2,3,7,3,1,1,2,19
220630206,12,16,17,9,11,7,4,8,84
220630207,8,10,4,8,8,4,6,8,56
220630208,29,44,40,54,33,33,7,26,266
220630209,11,6,13,10,16,9,4,18,87
220630210,62,46,50,44,25,21,6,19,273
220630211,11,10,5,8,11,4,2,13,64
220630212,30,39,42,22,28,42,4,11,218
220630213,8,11,7,9,10,8,4,14,71
220630214,49,55,62,65,48,47,12,29,367
220630215,27,33,52,47,43,31,11,13,257
220630216,14,23,11,13,5,3,1,6,76
220630301,31,35,40,37,28,17,3,17,208
220630302,24,37,31,31,28,26,5,10,192
220630303,7,11,19,20,14,10,4,9,94
220630304,20,33,39,27,22,29,10,23,203
220630305,14,29,42,39,20,31,7,27,209
220630306,23,65,43,37,43,42,4,20,277
220630307,32,31,29,21,21,12,6,3,155
220630308,14,22,18,21,13,8,8,10,114
220630309,62,77,81,83,47,49,12,16,427
220630310,61,62,70,87,60,41,17,35,433
220630311,48,68,96,75,51,36,8,12,394
220630401,37,54,69,68,56,42,14,22,362
220630402,12,5,11,9,3,5,1,0,46
220630403,23,13,18,10,6,8,0,3,81
220630404,42,45,67,66,40,31,19,27,337
220630501,11,6,12,11,8,4,9,8,69
220630502,10,0,13,12,1,4,5,9,54
220630503,8,14,23,24,24,18,11,30,152
220630504,12,7,17,27,11,13,6,10,103
220630505,22,25,32,23,23,46,8,21,200
220630506,19,19,37,36,23,13,7,15,169
220630507,11,14,24,32,24,32,4,15,156
220630508,69,40,83,73,62,44,17,36,424
220630509,28,42,57,67,50,41,26,35,346
220630601,1,1,3,1,3,1,1,5,16
220630602,22,32,34,33,40,52,7,34,254
220630603,34,29,42,34,27,24,12,21,223
220630604,0,1,1,0,0,0,1,0,3
220630605,64,45,57,54,37,37,15,22,331
220630701,19,43,26,15,13,14,9,10,149
220630702,69,106,79,84,77,71,7,17,510
220630703,17,20,22,26,18,20,1,8,132
220630704,5,2,4,2,2,0,0,1,16
220630705,104,76,88,60,53,57,14,17,469
220630801,39,41,65,76,54,53,10,46,384
220630814,33,32,52,52,31,11,2,8,221
220630816,35,38,61,71,49,15,21,33,323
220630817,39,57,75,65,50,25,15,10,336
220630818,18,27,29,27,17,13,6,7,144
220630824,26,33,36,43,24,19,13,14,208
220630825,26,28,37,37,27,6,4,5,170
220630826,16,23,26,24,22,10,1,0,122
220630827,22,18,37,27,21,10,5,8,148
220630915,47,52,61,59,56,43,20,22,360
220630919,55,46,48,53,51,39,21,44,357
220630920,44,41,69,54,39,55,19,24,345
220630921,36,59,85,79,46,38,21,21,385
220630922,11,36,43,34,19,9,2,9,163
220630923,25,35,60,53,37,29,10,12,261
220630928,27,26,38,38,25,15,3,8,180
220630929,22,29,43,38,28,21,4,6,191
220630930,23,34,41,35,33,23,5,15,209
220630931,30,45,57,66,43,27,8,7,283
220630932,26,35,47,40,30,16,11,20,225
220700101,45,51,62,49,28,24,13,19,291
220700102,50,58,51,39,28,17,8,11,262
220700103,43,51,54,55,51,43,29,40,366
220700104,67,52,60,60,49,39,8,30,365
220700105,20,43,48,59,25,28,13,15,251
220700201,5,10,6,8,9,3,1,7,49
220700202,34,43,62,70,46,40,23,32,350
220700203,4,5,6,6,1,4,1,1,28
220700204,6,4,9,3,0,0,0,3,25
220700205,17,14,13,36,15,21,10,16,142
220700206,27,36,53,78,51,55,30,56,386
220700301,27,42,43,58,31,35,19,41,296
220700302,5,9,9,18,14,7,1,1,64
220700303,14,7,6,11,1,11,1,2,53
220700304,16,12,5,4,8,6,3,2,56
220700305,5,6,5,8,4,6,2,12,48
220700306,7,10,14,11,8,5,4,9,68
220700307,33,36,57,58,60,43,19,26,332
220700308,33,39,54,44,41,17,9,13,250
220700309,28,41,45,36,32,22,3,10,217
220700310,9,9,22,26,22,16,7,19,130
220700311,17,21,29,30,34,26,18,19,194
220700401,22,38,56,49,52,29,18,34,298
220700402,6,12,13,9,7,6,3,7,63
220700403,15,16,9,11,6,8,4,4,73
220700404,9,7,2,7,4,4,0,0,33
220700405,11,16,16,8,5,7,5,4,72
220700406,57,62,63,55,57,24,14,24,356
220700501,8,13,11,9,13,5,5,3,67
220700502,7,8,2,3,6,3,3,1,33
220700503,1,0,5,2,1,3,1,1,14
220700504,2,0,1,1,2,1,1,1,9
220700601,13,10,10,8,8,5,3,6,63
220700602,13,4,4,7,3,5,1,3,40
220700603,5,17,17,11,8,7,5,3,73
220770101,24,56,58,63,35,27,10,9,282
220770102,21,36,33,25,21,18,7,5,166
220770103,39,74,79,77,66,28,20,22,405
220770104,30,33,63,55,40,20,8,11,260
220770105,28,52,52,50,30,17,10,9,248
220770106,29,32,38,51,31,21,11,5,218
220770107,21,29,62,74,56,22,13,19,296
220770201,17,12,18,14,7,4,0,3,75
220770202,28,41,44,38,30,25,4,6,216
220770203,7,10,7,8,7,3,1,4,47
220770204,3,6,3,4,4,3,1,0,24
220770205,9,7,7,3,1,5,1,0,33
220770206,11,18,24,31,16,10,4,2,116
220770207,5,12,5,6,6,2,1,0,37
220770208,10,16,21,14,7,6,0,4,78
220770301,6,14,16,20,8,5,1,1,71
220770302,17,23,54,81,44,25,10,12,266
220770303,17,26,28,36,14,23,7,15,166
220770304,35,12,25,16,9,12,7,4,120
220770305,6,6,7,5,2,3,0,3,32
220770306,4,2,0,3,0,1,1,0,11
220770307,6,7,2,5,1,1,1,2,25
220770308,3,2,2,1,0,1,1,0,10
220770401,2,0,1,0,0,1,0,2,6
220770402,4,3,3,3,1,0,1,0,15
220770403,4,1,3,2,3,0,0,1,14
220840101,94,97,96,93,57,38,12,14,501
220840102,33,30,42,52,38,30,10,15,250
220840103,45,51,57,47,36,26,9,13,284
220840104,48,57,67,49,30,21,0,7,279
220840105,54,44,99,45,52,68,18,26,406
220840201,4,4,2,3,4,1,0,1,19
220840202,15,16,13,20,24,11,3,9,111
220840203,37,27,37,35,31,37,15,36,255
220840204,18,32,27,26,15,23,6,13,160
220840205,47,69,82,82,88,130,21,69,588
220840206,16,12,17,18,23,45,2,7,140
220840207,9,9,12,12,14,21,3,5,85
220840208,26,25,58,51,33,17,7,8,225
220840209,62,66,72,67,51,46,13,21,398
220840301,6,6,3,1,1,0,1,0,18
220840302,3,3,5,6,1,7,0,1,26
220840303,8,3,16,15,12,11,7,20,92
220840401,19,23,31,10,9,12,1,3,108
220840402,20,15,13,11,12,12,3,6,92
220840403,9,11,12,7,3,2,0,3,47
220840404,11,9,4,2,4,2,2,5,39
220840501,43,55,58,45,27,19,10,10,267
220840502,42,39,45,62,27,30,19,17,281
220840503,43,39,71,45,34,32,6,18,288
220840504,23,47,64,56,36,22,11,18,277
220840601,46,39,71,46,42,29,11,24,308
220840602,6,7,6,2,3,3,0,3,30
220840603,6,6,9,8,10,5,3,4,51
220840604,40,28,16,17,9,3,2,5,120
220840605,28,38,46,33,16,23,14,10,208
220840606,3,4,3,5,2,0,1,0,18
220840607,4,1,2,0,0,0,0,0,7
220840701,41,26,20,17,16,4,6,13,143
220840702,7,2,2,1,0,0,1,0,13
220840703,7,4,3,2,2,2,2,0,22
220840704,5,1,5,3,0,1,2,1,18
220840705,12,3,5,2,3,0,0,2,27
220840706,4,8,5,9,5,3,0,4,38
220840707,11,12,16,8,8,4,1,4,64
220840801,29,22,30,30,13,8,6,10,148
220840802,14,15,6,12,9,11,3,2,72
220840803,28,16,20,16,6,14,4,6,110
220840804,27,32,29,27,42,26,13,18,214
220840805,34,21,20,20,12,12,9,8,136
220840901,4,2,2,3,3,1,0,0,15
220840902,2,6,2,2,1,0,0,0,13
220840903,29,14,12,10,6,4,3,1,79
220840904,6,9,8,7,4,2,2,1,39
220841001,16,21,13,17,6,7,1,7,88
220841002,38,55,57,54,37,26,5,11,283
220841003,5,4,0,2,1,1,0,0,13
220841004,31,26,23,23,22,9,5,4,143
220841005,48,62,46,63,31,26,9,18,303
220841006,31,25,34,28,20,13,6,10,167
220841101,53,54,73,64,60,35,10,19,368
220841102,44,44,35,26,19,5,0,2,175
220841103,21,28,35,23,14,10,2,2,135
220841104,42,60,55,45,32,20,11,13,278
220841105,18,36,50,57,43,34,8,13,259
220841106,45,58,58,48,24,20,10,6,269
220841107,58,69,50,32,23,5,0,3,240
220841108,43,81,55,41,29,18,2,5,274
220841109,23,33,32,25,27,9,4,4,157
220841110,37,82,97,78,50,26,14,8,392
220841111,28,36,42,43,40,27,19,24,259
220841112,32,34,61,41,31,20,10,19,248
220841201,50,62,99,87,56,40,9,18,421
220841202,41,84,79,62,36,23,4,6,335
220841203,35,31,50,35,27,23,10,6,217
220841204,41,46,44,54,33,21,5,20,264
220841205,60,74,57,29,17,5,0,2,244
220841206,42,52,41,42,17,8,4,1,207
220841207,61,66,75,53,26,20,3,4,308
220841208,24,50,35,38,26,17,2,3,195
220841209,22,41,52,40,21,16,6,12,210
220841210,28,29,39,39,42,32,13,38,260
220841211,37,60,56,77,52,40,12,27,361
220841212,28,31,40,39,25,24,27,25,239
220841213,50,44,46,42,34,18,10,14,258
220841214,38,43,39,45,26,28,10,27,256
220841215,36,33,62,63,35,20,4,12,265
220841216,35,56,76,72,55,39,24,34,391
220841217,14,27,31,35,26,23,14,16,186
220910101,38,71,83,66,43,18,10,10,339
220910102,55,56,59,36,25,13,3,5,252
220910103,58,80,84,71,42,31,9,14,389
220910104,51,65,59,50,27,9,4,4,269
220910105,44,38,49,49,20,20,9,5,234
220910201,7,4,12,10,5,3,3,3,47
220910202,4,15,12,9,13,9,7,10,79
220910203,8,10,4,11,10,11,9,10,73
220910204,16,19,18,8,8,9,4,7,89
220910301,19,14,19,19,17,10,6,11,115
220910302,10,9,22,20,15,20,16,21,133
220910303,9,25,23,31,34,26,9,26,183
220910304,10,16,13,8,4,3,1,6,61
220910401,15,11,18,23,7,11,2,9,96
220910402,20,20,28,24,15,10,4,14,135
220910403,20,12,24,14,17,16,9,18,130
220910404,10,11,14,4,11,7,2,2,61
220910501,30,53,68,88,73,53,34,46,445
220910502,26,31,51,48,32,34,17,15,254
220910503,19,22,16,15,19,7,2,4,104
220910504,18,18,24,20,12,11,3,4,110
220910505,9,14,13,12,4,4,1,5,62
220910506,7,21,20,15,19,9,3,6,100
220910507,30,49,53,54,39,15,19,18,277
220910508,56,67,94,79,66,32,13,37,444
220910509,28,37,57,60,51,52,22,41,348
220910510,15,27,54,44,35,40,19,49,283
220910511,21,30,35,49,31,27,9,21,223
220910512,27,30,57,65,40,30,7,14,270
220910513,24,39,68,62,35,24,12,13,277
220910601,7,13,11,5,1,3,0,4,44
220910602,19,14,34,17,21,6,3,5,119
220910701,6,7,5,15,7,3,0,1,44
220910702,7,7,5,5,7,6,1,6,44
220910703,9,17,16,16,16,22,5,10,111
220910704,14,28,13,16,7,11,7,6,102
220980101,40,58,55,71,36,15,6,6,287
220980102,16,22,27,38,14,28,7,11,163
220980103,75,99,105,106,65,40,12,14,516
220980104,20,42,43,58,40,26,19,24,272
220980105,45,70,47,57,32,32,10,7,300
220980106,43,70,53,54,30,8,10,8,276
220980107,46,79,64,48,31,9,3,4,284
220980108,55,67,52,30,17,12,4,4,241
220980109,47,62,52,55,21,6,1,2,246
220980110,27,61,66,67,43,24,14,9,311
220980111,71,76,89,73,31,26,5,4,375
220980112,41,45,26,23,17,7,2,2,163
220980113,26,30,23,19,15,2,2,1,118
220980114,45,37,28,15,3,4,0,1,133
220980115,44,52,30,22,12,3,2,2,167
220980116,38,59,27,23,9,3,1,1,161
220980117,45,65,43,24,18,7,0,3,205
220980118,19,30,49,35,24,13,7,7,184
220980119,33,63,77,71,45,26,12,7,334
220980120,34,61,62,67,24,12,4,5,269
220980121,51,44,61,52,46,36,21,20,331
220980122,30,50,59,48,32,18,9,8,254
220980123,32,48,59,72,23,12,6,12,264
220980201,12,17,7,5,7,5,3,1,57
220980202,21,19,26,18,10,19,9,13,135
220980203,1,3,1,1,1,1,3,1,12
220980204,7,4,3,3,3,1,0,4,25
220980205,5,11,6,8,6,3,3,3,45
220980206,12,9,7,5,8,1,2,0,44
220980207,18,10,7,14,13,7,3,5,77
220980208,7,6,12,12,6,1,2,0,46
220980209,10,16,9,16,8,7,3,0,69
220980210,5,6,1,6,3,0,3,1,25
220980211,23,14,14,12,7,4,3,4,81
220980212,7,8,5,6,6,5,1,5,43
220980213,12,12,8,11,6,6,3,2,60
220980214,30,27,21,43,28,28,8,24,209
220980301,26,27,37,30,19,12,4,8,163
220980302,46,58,65,52,36,19,6,9,291
220980303,38,63,54,61,26,20,7,9,278
220980304,35,41,52,42,21,11,3,1,206
220980305,41,62,63,61,21,7,4,7,266
220980306,23,35,52,43,30,17,6,11,217
220980307,28,32,34,36,36,15,14,18,213
220980401,17,40,41,54,30,10,10,15,217
220980402,6,6,6,7,8,2,1,0,36
220980403,6,6,9,6,4,3,1,2,37
220980404,4,5,6,4,4,2,0,0,25
220980405,5,5,10,3,3,0,0,2,28
220980406,27,40,51,50,45,30,15,31,289
220980407,19,29,23,24,10,4,1,4,114
220980408,25,45,59,84,42,28,10,10,303
220980501,15,17,11,11,8,8,1,4,75
220980502,9,17,11,8,2,4,1,1,53
220980503,7,9,10,2,6,2,0,3,39
220980601,18,15,26,29,19,11,2,10,130
220980602,11,5,9,13,7,7,4,3,59
220980603,16,18,10,7,4,6,2,3,66
220980604,0,0,1,6,1,2,0,1,11
220980605,5,5,8,8,3,7,3,1,40
220980701,50,67,121,79,49,39,16,15,436
220980702,49,81,87,61,53,33,24,21,409
220980703,28,52,41,32,14,22,5,3,197
220980704,39,53,41,34,20,10,2,3,202
220980705,54,59,35,32,6,7,1,1,195
220980706,47,64,59,51,40,20,6,11,298
220980707,58,83,96,107,55,34,13,21,467
220980708,40,64,89,75,66,44,22,27,427
220980709,58,80,67,73,46,16,8,8,356
220980710,33,69,60,55,26,11,3,4,261
220980711,13,21,11,16,10,4,6,2,83
220980712,26,25,37,34,21,9,10,8,170
220980713,19,21,36,39,15,10,5,6,151
220980714,32,33,37,44,27,20,18,12,223
220980715,56,57,70,82,53,42,16,22,398
220980716,2,4,7,2,5,2,1,4,27
220980717,50,32,75,75,43,26,11,9,321
220980718,58,104,125,113,74,39,23,27,563
220980719,8,14,18,24,12,14,1,8,99
220980720,18,37,36,56,41,41,16,29,274
221050101,26,33,44,23,27,17,7,7,184
221050102,26,40,50,24,19,26,6,9,200
221050103,45,40,40,32,16,10,3,5,191
221050104,40,37,34,35,19,3,1,4,173
221050105,35,37,36,39,11,3,2,2,165
221050106,47,77,57,41,23,16,2,2,265
221050107,59,86,55,53,44,13,10,6,326
221050108,57,68,56,80,46,31,11,8,357
221050109,55,84,61,52,32,21,8,4,317
221050110,61,58,34,35,19,8,2,0,217
221050111,53,52,44,46,21,7,2,3,228
221050112,47,62,51,44,21,15,3,3,246
221050113,25,37,43,30,25,6,4,1,171
221050114,31,28,45,45,34,20,13,16,232
221050115,18,22,34,34,21,19,7,5,160
221050201,14,15,20,28,15,12,4,5,113
221050202,7,11,11,19,16,6,3,11,84
221050203,11,29,32,26,20,16,10,9,153
221050204,7,2,5,9,7,5,1,9,45
221050205,21,19,20,21,17,9,4,4,115
221050301,36,73,119,143,96,53,11,24,555
221050302,11,4,5,4,4,2,1,4,35
221050303,37,34,56,59,43,61,21,36,347
221050304,12,16,20,22,11,12,6,5,104
221050305,11,14,15,7,8,7,3,5,70
221050306,15,28,20,20,19,38,5,5,150
221050307,6,9,13,14,13,5,3,4,67
221050308,6,5,6,8,3,2,3,4,37
221050309,9,11,14,9,11,8,1,3,66
221050310,11,15,28,13,12,5,2,9,95
221050311,43,73,85,107,63,34,5,6,416
221050312,52,59,81,94,59,51,8,11,415
221050313,1,4,6,2,1,2,0,0,16
221050314,28,34,49,70,52,44,22,28,327
221050315,16,31,58,60,46,42,10,23,286
221050316,33,66,89,77,33,25,4,1,328
221050317,17,33,59,54,50,36,12,17,278
221050401,2,6,4,4,0,2,1,2,21
221050402,9,4,4,3,2,2,1,1,26
221050403,22,7,12,10,6,3,1,10,71
221050404,12,12,21,15,12,7,5,13,97
221050405,7,10,10,10,2,4,4,2,49
221120101,48,75,78,59,41,27,15,16,359
221120102,62,59,62,55,24,17,5,2,286
221120103,54,63,84,81,55,34,23,31,425
221120104,53,58,77,69,58,30,9,29,383
221120105,47,66,74,70,56,43,25,32,413
221120106,50,67,100,86,67,52,30,34,486
221120201,0,0,0,0,0,0,0,0,0
221120202,12,7,4,10,6,6,0,5,50
221120203,4,5,3,3,0,1,1,2,19
221120301,28,50,50,32,27,19,10,14,230
221120302,44,62,70,67,59,55,31,49,437
221120303,8,8,5,4,4,2,2,1,34
221120304,3,8,2,5,0,3,0,3,24
221120305,8,8,4,2,1,4,0,6,33
221120306,32,49,41,34,15,13,2,5,191
221120401,30,32,45,40,21,11,9,11,199
221120402,18,14,31,27,34,15,13,23,175
221120403,17,17,11,20,17,14,1,10,107
221120404,17,18,20,19,19,16,13,20,142
221120405,2,6,5,4,6,3,2,3,31
221120406,5,8,6,9,6,3,2,1,40
221120407,29,28,56,60,43,35,22,38,311
221120408,11,8,12,10,5,2,0,1,49
221120501,4,3,5,4,1,1,1,0,19
221120502,8,9,2,5,1,1,0,0,26
221120503,8,2,1,1,3,2,1,0,18
221120504,10,6,5,2,3,3,1,2,32
221120505,7,7,7,9,4,3,0,4,41
221120601,7,3,2,1,2,0,0,0,15
221120602,6,11,2,5,1,3,1,3,32
221120603,10,6,9,5,3,1,2,3,39
221120701,10,7,7,6,4,3,2,3,42
221120702,10,9,3,6,1,2,1,1,33
221120801,8,6,10,7,8,6,3,8,56
221120802,17,13,12,8,7,4,2,4,67
221120803,12,5,12,18,5,15,7,4,78
221120901,10,5,4,6,4,2,3,1,35
221120902,7,6,1,4,3,4,0,1,26
221120903,9,8,8,7,1,4,2,1,40
221121001,20,10,11,11,14,12,3,9,90
221121002,11,19,9,6,5,4,0,1,55
221121003,4,2,2,4,3,0,1,0,16
221190101,40,55,47,40,21,19,4,3,229
221190102,50,64,57,59,36,32,10,10,318
221190103,63,57,82,77,48,36,10,11,384
221190104,49,64,89,85,53,28,16,18,402
221190105,27,36,54,49,24,18,9,11,228
221190106,46,69,70,48,48,32,18,17,348
221190107,34,48,41,51,53,34,9,23,293
221190108,34,47,54,52,55,24,9,14,289
221190201,30,26,34,19,12,10,14,16,161
221190202,27,29,42,33,23,21,9,16,200
221190203,26,25,13,15,7,12,4,2,104
221190204,18,10,21,13,8,10,2,7,89
221190205,26,32,31,23,18,12,11,11,164
221190206,3,11,15,14,7,6,0,1,57
221190207,5,5,4,2,1,3,1,2,23
221190208,16,9,4,7,0,1,1,3,41
221190301,15,8,12,8,2,1,0,1,47
221190302,3,7,1,1,0,1,0,0,13
221190303,14,2,3,4,2,1,0,0,26
221260101,31,42,42,54,45,32,24,13,283
221260102,33,52,42,45,16,8,3,4,203
221260103,35,37,27,33,12,11,1,4,160
221260104,34,44,49,44,35,18,7,7,238
221260105,30,33,43,33,26,12,6,10,193
221260201,8,4,5,3,2,2,1,0,25
221260202,40,22,15,9,8,5,5,7,111
221260203,11,12,9,8,3,3,1,2,49
221260204,11,10,8,2,4,6,1,4,46
221260301,33,48,58,46,25,21,6,13,250
221260302,7,8,10,14,2,4,2,1,48
221260303,22,27,15,15,8,9,1,3,100
221260304,23,39,42,33,14,9,4,8,172
221260305,24,29,37,54,38,27,10,12,231
221260306,2,10,4,5,3,1,0,0,25
221260307,5,2,0,2,3,2,1,1,16
221260308,5,3,2,6,0,1,0,2,19
221260309,0,2,4,5,0,0,0,0,11
221260310,2,5,3,6,1,0,0,1,18
221260311,17,12,9,5,8,2,1,2,56
221260312,30,34,40,32,27,18,11,14,206
221260313,28,35,35,37,21,13,2,8,179
221260314,45,51,87,67,34,14,4,1,303
221260315,4,3,2,2,0,0,1,0,12
221330101,24,30,56,40,26,24,9,9,218
221330102,49,70,61,60,32,17,8,8,305
221330103,40,46,70,67,48,27,8,12,318
221330104,37,90,65,57,35,26,1,16,327
221330105,37,42,39,29,17,6,0,0,170
221330106,49,85,86,42,35,25,6,9,337
221330107,27,54,36,25,18,6,3,1,170
221330108,38,52,73,89,88,52,26,38,456
221330109,32,54,72,66,57,48,18,24,371
221330110,28,36,33,37,17,15,9,11,186
221330111,24,43,54,60,34,28,10,19,272
221330112,31,41,50,33,28,18,10,6,217
221330113,22,35,39,32,19,19,5,7,178
221330114,33,44,67,70,56,46,20,40,376
221330115,30,59,64,75,55,36,11,17,347
221330116,33,34,47,32,14,6,3,5,174
221330117,31,18,27,25,20,11,5,8,145
221330118,35,39,46,44,43,17,7,7,238
221330119,34,38,62,52,40,23,12,21,282
221330120,29,53,62,64,23,7,4,7,249
221330201,5,14,7,9,6,5,3,3,52
221330202,13,22,9,16,16,12,6,11,105
221330203,12,15,19,19,14,15,10,9,113
221330204,3,4,2,6,1,3,2,2,23
221330205,16,9,12,14,7,12,4,9,83
221330206,10,13,5,17,12,10,7,7,81
221330207,27,41,32,38,29,23,7,20,217
221330208,8,11,5,5,9,6,3,6,53
221330301,11,16,16,15,9,11,3,4,85
221330302,13,21,19,12,14,14,6,11,110
221330303,9,8,12,11,9,10,3,3,65
221330304,3,8,11,11,6,7,4,9,59
221330305,15,18,13,7,7,4,1,4,69
221330306,8,7,11,8,4,3,1,2,44
221330307,8,9,8,2,11,5,0,0,43
221330308,9,15,6,9,8,8,4,6,65
221330309,14,14,13,13,14,11,6,12,97
221330401,24,15,13,14,14,11,6,4,101
221330402,9,16,13,7,6,5,4,6,66
221330403,6,10,7,8,7,4,0,1,43
221330404,9,13,9,14,6,4,2,3,60
221330405,13,17,7,8,9,15,3,5,77
221330406,3,12,8,4,2,4,3,2,38
221330407,1,1,1,0,0,2,0,0,5
221330408,15,5,11,7,4,4,1,10,57
221330409,0,3,1,1,0,0,0,0,5
221330410,1,1,3,0,1,0,0,1,7
221330411,24,16,27,17,12,16,5,4,121
221330412,23,43,73,54,43,50,24,43,353
221330413,26,40,64,71,51,34,10,16,312
221330414,36,31,33,47,30,17,7,10,211
221330415,11,22,24,20,17,18,8,14,134
221330501,15,7,10,6,1,1,3,5,48
221330502,29,32,33,37,29,52,20,40,272
221330503,6,8,11,10,7,8,3,4,57
221330504,8,8,5,3,2,3,2,1,32
221330505,6,8,9,7,5,8,3,7,53
221330506,7,5,2,1,2,0,0,0,17
221330507,1,6,3,3,0,2,1,2,18
221330508,6,2,3,2,6,1,2,0,22
221400101,23,16,34,18,16,12,4,10,133
221400102,22,57,83,76,61,46,16,46,407
221400103,34,35,45,34,14,6,2,4,174
221400104,75,74,58,49,30,14,4,6,310
221400105,40,63,39,43,30,16,1,5,237
221400106,27,33,61,47,37,40,16,27,288
221400107,39,71,68,73,41,40,16,10,358
221400108,23,26,28,21,15,8,2,0,123
221400109,28,49,69,49,46,23,16,12,292
221400110,21,44,37,45,23,17,7,8,202
221400111,53,67,83,80,50,26,11,11,381
221400112,32,56,54,46,32,22,4,12,258
221400113,34,33,41,48,34,22,10,17,239
221400114,21,24,16,27,7,10,2,4,111
221400115,35,53,50,40,18,22,8,4,230
221400116,33,32,34,30,26,17,11,17,200
221400117,14,45,35,57,33,30,10,14,238
221400118,34,36,41,40,34,17,7,8,217
221400201,44,60,39,56,21,16,0,1,237
221400202,58,82,59,38,22,7,2,0,268
221400203,45,66,64,53,32,26,5,3,294
221400204,48,62,65,57,45,35,13,10,335
221400205,42,50,44,44,24,11,6,3,224
221400206,53,82,69,87,42,27,3,5,368
221400207,50,38,85,69,49,39,4,21,355
221400208,36,43,62,56,45,34,7,19,302
221400209,23,56,35,41,29,29,3,3,219
221400210,40,88,62,62,35,26,9,17,339
221400211,52,47,46,40,36,21,11,17,270
221400301,43,39,58,38,22,6,1,0,207
221400302,46,53,43,31,20,7,0,1,201
221400303,65,103,47,34,22,9,1,0,281
221400304,70,81,46,31,16,7,0,0,251
221400305,64,84,53,44,17,9,1,0,272
221400306,40,67,40,38,19,7,1,2,214
221400307,41,61,42,30,9,16,1,2,202
221400308,35,64,54,29,38,10,1,1,232
221400309,45,48,44,43,40,17,5,8,250
221400310,33,53,50,34,23,11,3,2,209
221400311,27,63,46,37,24,23,6,8,234
221400312,33,48,73,73,48,33,10,17,335
221400313,27,43,62,75,78,43,18,21,367
221400401,54,25,21,12,13,2,1,0,128
221400402,52,57,31,27,8,7,3,0,185
221400403,77,68,39,22,13,9,0,0,228
221400404,95,77,46,29,21,5,0,0,273
221400405,76,70,56,37,19,7,3,2,270
221400406,59,67,44,30,11,10,2,1,224
221400407,68,98,37,39,18,7,0,0,267
221400408,55,60,39,32,13,4,1,0,204
221400409,59,70,53,55,29,13,8,1,288
221400410,43,51,44,37,19,13,7,5,219
221400411,47,65,50,50,42,23,4,10,291
221400412,48,60,52,60,37,29,4,4,294
221400413,33,43,43,25,14,2,1,2,163
221400414,30,46,61,47,33,32,3,3,255
221400415,18,33,31,28,15,8,4,2,139
221400416,27,53,48,41,21,6,3,2,201
221400417,11,16,16,16,10,2,0,0,71
221400418,17,28,32,28,22,4,3,2,136
221400501,44,58,53,42,18,16,3,2,236
221400502,45,50,44,39,24,10,3,2,217
221400503,57,55,48,32,17,13,2,4,228
221400504,41,61,57,44,17,11,5,5,241
221400505,55,67,82,85,54,32,12,15,402
221400506,43,73,53,48,31,18,7,4,277
221400507,52,65,60,46,35,21,8,9,296
221400508,36,36,75,83,41,38,14,15,338
221400509,28,35,47,48,26,18,5,4,211
221400510,30,49,47,56,29,22,6,7,246
221400511,29,26,57,50,34,19,10,8,233
221400512,33,52,64,49,40,38,11,15,302
221400513,14,43,65,66,48,36,19,21,312
221400514,26,29,53,64,31,28,11,14,256
221400601,37,61,71,75,63,37,18,15,377
221400602,43,52,68,56,24,7,0,3,253
221400603,37,60,80,56,27,11,5,3,279
221400604,44,46,60,47,27,11,4,2,241
221400605,28,57,61,64,49,28,13,8,308
221400606,37,59,106,79,49,27,18,12,387
221400607,24,47,47,42,28,14,1,8,211
221400608,38,63,61,91,74,46,12,20,405
221400609,34,52,79,86,70,28,13,13,375
221400610,22,55,74,78,51,32,10,15,337
221400611,29,45,63,61,39,31,9,6,283
221400612,9,27,25,43,28,24,4,5,165
221400701,46,60,64,47,21,15,2,2,257
221400702,61,63,67,58,39,23,13,5,329
221400703,30,90,71,52,39,8,4,5,299
221400704,29,42,49,42,37,29,6,6,240
221400705,33,35,49,57,30,16,12,2,234
221400706,60,70,61,60,37,28,8,11,335
221400707,36,44,47,37,27,11,5,4,211
221400708,34,60,52,48,28,25,7,11,265
221400709,22,32,41,42,25,25,9,13,209
221400710,37,33,50,37,34,18,13,12,234
221400711,28,33,38,51,28,20,11,5,214
221400712,34,34,41,26,26,22,5,7,195
221400713,24,47,39,39,14,8,5,4,180
221400714,32,53,60,58,32,22,19,19,295
221400715,26,52,38,37,24,8,5,3,193
221400716,36,54,64,53,43,23,6,8,287
221400717,19,35,36,32,17,14,7,4,164
221400718,29,50,74,54,49,30,8,8,302
221400719,17,35,44,50,30,30,5,8,219
221400720,22,26,45,52,23,23,6,11,208
221400721,24,51,51,53,43,17,9,7,255
221400722,3,3,2,0,2,0,0,0,10
221400723,25,33,49,47,32,27,19,19,251
221400724,38,58,53,72,47,31,14,15,328
221400725,40,42,53,58,31,16,5,5,250
221400726,24,36,51,64,33,15,11,9,243
221400727,19,36,42,52,47,37,19,17,269
221400728,12,38,44,32,30,16,9,12,193
221400729,20,27,29,27,30,15,2,3,153
221400801,92,91,38,27,11,1,0,0,260
221400802,56,85,46,42,20,4,2,0,255
221400803,61,88,47,36,12,5,5,2,256
221400804,32,33,17,18,13,8,0,1,122
221400805,48,52,31,43,24,6,1,0,205
221400806,70,84,18,23,12,1,4,2,214
221400807,78,71,46,40,17,6,1,0,259
221400808,92,87,66,39,15,7,1,1,308
221400809,54,48,25,14,4,0,3,0,148
221400810,32,68,67,41,39,24,11,7,289
221400811,30,37,50,38,35,30,3,15,238
221400812,66,59,19,21,4,5,2,1,177
221400813,53,84,54,29,12,7,0,0,239
221400814,74,89,49,38,25,15,2,1,293
221400815,96,97,38,26,18,6,0,0,281
221400816,22,33,26,24,12,3,0,0,120
221400817,56,70,26,17,9,4,1,1,184
221400818,100,45,9,7,4,1,0,1,167
221400901,61,45,53,36,29,5,2,1,232
221400902,34,53,78,89,53,45,17,28,397
221400903,54,65,64,65,38,25,7,4,322
221400904,59,62,64,69,38,20,11,8,331
221400905,96,64,53,51,28,7,4,5,308
221400906,48,75,78,74,42,27,8,7,359
221400907,34,37,58,49,47,18,10,17,270
221400908,31,45,51,40,35,28,15,12,257
221400909,39,56,50,41,44,22,7,16,275
221400910,36,62,78,85,46,31,10,10,358
221400911,42,48,57,42,28,24,7,5,253
221400912,15,45,37,37,20,11,8,9,182
221400913,48,66,69,79,51,27,8,4,352
221400914,53,82,108,88,53,14,1,0,399
221400915,38,78,75,80,63,15,4,0,353
221400916,109,62,64,43,38,14,4,7,341
221400917,16,35,38,40,41,26,16,10,222
221400918,21,46,33,51,35,19,6,15,226
221401001,33,56,65,66,52,18,5,11,306
221401002,27,39,52,35,24,14,4,5,200
221401003,31,62,51,43,48,25,10,13,283
221401004,40,69,88,77,44,28,7,13,366
221401005,47,74,63,51,42,20,6,3,306
221401006,29,58,73,69,53,24,14,9,329
221401007,41,60,78,81,54,26,17,12,369
221401008,27,41,59,69,34,22,2,5,259
221401009,29,74,67,91,57,39,16,13,386
221401010,33,55,59,54,33,16,4,5,259
221401011,29,47,44,78,35,19,8,5,265
221401012,36,44,49,61,31,15,5,7,248
221401013,39,62,67,40,25,17,3,11,264
221401014,32,31,73,66,38,17,10,8,275
221401015,25,21,67,60,48,22,10,7,260
221401017,26,37,51,45,52,34,17,15,277
221401018,22,30,47,75,48,23,9,9,263
221401019,21,32,42,54,27,11,5,13,205
221401020,19,38,49,59,42,34,13,33,287
221401021,21,20,49,65,30,22,8,5,220
221401022,21,29,40,60,41,23,13,8,235
221401101,103,82,35,24,13,3,0,1,261
221401102,135,84,41,23,13,5,1,1,303
221401103,87,64,52,30,24,5,3,1,266
221401104,96,105,77,72,45,9,3,5,412
221401105,41,65,38,45,22,7,3,3,224
221401106,34,37,40,38,32,13,6,5,205
221401107,61,62,54,33,23,8,3,3,247
221401108,44,59,50,25,22,6,0,3,209
221401109,20,35,29,34,24,14,11,1,168
221401110,33,51,34,37,29,9,4,1,198
221401111,37,63,60,58,47,14,12,8,299
221401112,69,104,56,41,10,2,1,2,285
221401113,31,51,38,36,16,5,3,2,182
221401114,38,56,58,32,17,15,1,3,220
221401115,58,50,42,39,21,3,3,4,220
221401201,46,62,37,22,5,5,0,1,178
221401202,46,59,26,32,15,7,4,0,189
221401203,80,62,38,29,11,4,0,0,224
221401204,71,87,38,36,8,5,1,1,247
221401205,48,49,34,38,26,8,3,0,206
221401206,70,82,52,34,16,7,2,1,264
221401207,60,77,43,44,15,6,3,1,249
221401208,86,102,67,52,29,8,0,1,345
221401209,28,42,36,24,11,10,3,5,159
221401210,94,115,81,41,24,13,2,3,373
221401211,60,73,71,69,44,23,4,5,349
221401212,33,43,34,35,25,12,1,3,186
221401213,76,85,88,77,32,26,8,2,394
221401214,29,40,44,42,28,16,5,6,210
221401215,47,79,94,100,63,28,10,11,432
221401216,55,56,17,20,4,3,4,0,159
221401217,32,54,88,75,65,23,13,10,360
221401301,46,52,45,39,18,7,4,2,213
221401302,56,72,61,45,15,10,3,3,265
221401303,63,71,46,36,22,14,1,1,254
221401304,51,53,56,44,33,8,3,2,250
221401305,33,64,45,58,39,27,4,5,275
221401306,40,58,42,38,23,9,0,2,212
221401307,64,62,58,42,34,16,4,3,283
221401308,60,82,90,72,47,31,4,7,393
221401309,29,36,36,31,12,10,4,4,162
221401310,30,43,32,29,18,9,5,12,178
221401311,21,35,59,41,29,18,6,5,214
221401312,22,38,42,40,29,12,4,4,191
221401313,20,37,40,57,31,18,10,16,229
221401314,31,38,32,36,31,19,6,11,204
221401315,19,15,8,10,5,4,0,0,61
221401401,14,32,27,32,19,11,6,0,141
221401402,29,51,54,46,24,12,0,3,219
221401403,35,65,67,66,38,14,3,4,292
221401404,32,58,65,55,44,6,3,3,266
221401405,9,44,50,35,29,13,5,6,191
221401406,46,98,84,70,40,18,7,3,366
221401407,24,60,49,32,35,14,9,7,230
221401408,24,39,56,45,30,12,3,5,214
221401409,25,50,40,37,25,11,2,3,193
221401410,19,33,42,53,20,11,2,1,181
221401411,27,40,52,54,35,20,9,7,244
221401412,9,24,25,15,17,8,1,2,101
221401413,22,42,40,31,20,13,2,1,171
221401501,40,98,58,66,29,10,7,4,312
221401502,25,53,56,36,31,27,2,3,233
221401503,56,89,65,56,31,5,1,1,304
221401504,43,55,51,53,29,20,5,4,260
221401505,31,54,43,36,15,10,5,3,197
221401506,34,101,78,69,37,30,8,7,364
221401507,24,56,70,56,46,24,5,2,283
221401508,45,66,59,48,32,15,4,8,277
221401509,25,37,45,41,29,10,1,4,192
221401510,39,77,85,55,42,29,11,4,342
221401601,22,46,51,57,34,23,10,11,254
221401602,18,19,17,28,18,5,0,3,108
221401603,41,41,41,57,19,7,8,5,219
221401604,70,104,72,58,41,30,2,2,379
221401605,52,66,63,50,37,19,8,7,302
221401606,47,57,65,39,39,34,5,9,295
221401607,77,84,38,28,11,6,0,2,246
221401608,20,36,38,43,22,17,7,8,191
221401609,37,58,88,114,50,28,10,7,392
221401610,33,56,66,59,33,13,7,10,277
221401611,15,23,30,32,12,8,3,2,125
221401612,14,37,54,67,31,11,5,1,220
221401613,25,34,28,37,16,11,2,5,158
221401614,11,23,27,24,20,14,7,3,129
221401615,27,67,49,42,19,8,2,1,215
221401616,32,42,68,56,46,28,7,6,285
221401617,26,37,45,50,36,26,11,4,235
221401618,28,49,46,89,36,33,15,4,300
221401619,20,53,56,57,42,15,6,9,258
221401620,17,30,35,44,34,29,15,19,223
221401621,19,47,67,56,44,31,5,15,284
221401622,6,13,12,9,8,2,2,0,52
221401623,10,8,22,16,10,9,1,3,79
221401624,9,14,9,15,9,4,0,1,61
221401625,9,37,52,40,31,10,3,4,186
221401701,28,42,24,26,17,11,8,9,165
221401702,56,61,62,63,30,18,11,6,307
221401703,46,76,74,63,51,25,16,19,370
221401704,32,58,62,55,31,16,3,5,262
221401705,50,71,78,86,52,24,9,9,379
221401706,27,45,72,61,58,33,21,30,347
221401707,19,32,35,60,45,21,6,11,229
221401708,15,23,42,36,24,22,10,22,194
221401709,31,36,36,30,38,16,0,2,189
221401710,13,24,45,30,29,14,15,17,187
221401801,37,54,54,41,29,21,8,10,254
221401802,38,49,66,60,44,35,16,20,328
221401803,18,38,39,34,26,15,22,23,215
221401804,20,32,52,59,37,20,17,16,253
221401805,29,36,46,40,36,12,11,12,222
221401806,41,50,63,52,48,26,15,22,317
221401807,52,52,82,54,44,17,20,12,333
221401808,32,59,53,47,38,22,5,8,264
221401809,27,39,56,52,33,13,10,10,240
221401810,23,43,49,58,34,24,10,16,257
221401811,24,25,54,43,32,33,14,14,239
221401812,30,37,38,39,31,12,7,5,199
221401813,40,36,53,38,37,17,8,5,234
221401814,28,50,44,46,22,20,8,11,229
221401815,19,28,48,34,34,25,7,8,203
221401816,22,48,75,92,56,42,22,39,396
221401817,34,33,42,31,22,12,7,5,186
221401818,2,6,1,0,0,0,0,0,9
221401819,20,41,50,59,38,36,13,13,270
221401820,37,53,43,58,28,23,4,4,250
221401821,12,36,51,33,24,19,8,10,193
221401901,55,73,78,79,53,22,13,13,386
221401902,20,19,17,11,8,3,4,2,84
221401903,27,52,36,42,28,17,6,0,208
221401904,31,77,71,71,46,38,9,6,349
221401905,25,31,42,31,14,16,3,2,164
221401906,24,40,59,42,23,16,2,7,213
221401907,56,60,72,62,47,22,13,7,339
221401908,20,41,41,36,34,14,9,4,199
221401909,37,52,42,43,35,5,6,5,225
221401910,16,34,39,34,20,10,6,1,160
221401911,41,51,36,46,20,13,4,3,214
221401912,37,50,37,49,22,19,9,6,229
221401913,24,43,39,32,32,25,10,7,212
221401914,23,32,31,30,28,20,1,0,165
221401915,22,37,41,53,22,17,3,1,196
221401916,29,31,51,47,31,24,5,3,221
221402001,21,56,56,47,29,15,3,3,230
221402002,40,55,70,64,37,25,8,7,306
221402003,37,46,38,32,19,12,7,4,195
221402004,32,49,63,50,44,19,8,11,276
221402005,50,75,71,72,52,43,10,21,394
221402006,55,46,63,82,46,39,13,15,359
221402007,18,46,56,43,49,21,9,12,254
221402008,17,57,46,46,36,21,3,11,237
221402009,18,54,66,57,33,28,7,6,269
221402010,27,40,48,48,21,14,7,8,213
221402011,20,39,42,47,25,14,6,6,199
221402101,22,43,70,59,57,26,14,10,301
221402102,30,46,63,57,34,17,10,9,266
221402103,33,43,71,48,33,23,7,10,268
221402104,26,29,27,19,15,15,6,7,144
221402105,44,66,76,69,69,42,2,11,379
221402106,42,66,106,123,84,45,20,16,502
221402107,4,10,13,9,9,5,4,10,64
221402108,20,31,65,62,35,20,12,10,255
221402109,6,5,5,8,6,7,4,3,44
221402201,13,2,4,1,2,1,1,1,25
221402202,6,10,10,5,1,0,0,1,33
221402203,13,11,8,7,7,8,2,3,59
221402204,6,5,3,1,1,1,0,0,17
221402205,7,11,9,6,6,1,1,4,45
221402206,15,8,7,5,0,3,1,2,41
221402301,1,1,0,1,2,0,0,0,5
221402302,0,0,0,1,1,0,0,0,2
221402303,3,3,5,1,1,2,1,0,16
221402304,24,15,27,25,14,7,3,2,117
221402305,4,6,2,6,1,0,0,0,19
221402401,33,39,41,33,25,19,5,4,199
221402402,2,1,3,1,0,2,1,0,10
221402403,8,8,3,6,1,2,1,0,29
221402404,33,61,55,50,26,19,5,8,257
221402405,11,10,9,7,6,2,4,1,50
221402406,18,17,13,12,12,6,3,9,90
221402407,2,0,0,0,0,0,0,0,2
221402408,0,2,1,2,0,1,0,0,6
221402409,10,12,8,8,6,8,2,4,58
221402410,13,12,11,12,14,6,4,6,78
221402411,22,28,30,29,27,23,9,8,176
221402501,16,39,51,50,56,50,22,22,306
221402502,14,57,55,67,44,28,10,11,286
221402503,37,78,93,91,72,47,7,9,434
221402504,31,71,63,91,62,25,6,6,355
221402505,38,72,105,129,81,40,13,16,494
221402506,16,39,49,51,23,14,4,6,202
221402507,24,18,14,12,9,6,0,4,87
221402508,26,33,68,88,62,34,7,14,332
221402509,20,34,54,56,46,42,6,19,277
221402510,39,47,65,79,47,37,9,17,340
221402511,52,63,75,74,68,38,29,31,430
221402512,43,48,70,74,46,46,9,24,360
221402513,18,29,24,46,26,6,1,3,153
221402514,7,14,14,12,7,10,3,3,70
221402515,8,22,33,42,18,5,1,1,130
221402516,5,30,25,33,22,25,8,16,164
221402517,15,23,28,31,14,4,0,2,117
221402518,20,37,51,53,41,18,8,8,236
221402601,29,27,36,54,23,21,10,18,218
221402602,15,29,65,104,58,23,9,8,311
221402603,26,48,73,67,42,35,10,9,310
221402604,35,54,43,49,41,22,8,12,264
221402605,25,40,56,52,40,21,9,13,256
221402606,16,31,41,56,42,20,7,7,220
221402607,22,41,96,90,53,29,13,19,363
221402608,26,45,77,75,64,35,13,14,349
221402609,28,23,32,40,22,12,9,5,171
221402701,34,62,62,74,59,21,3,7,322
221402702,28,74,70,93,40,19,6,3,333
221402703,23,35,48,42,38,27,18,16,247
221402704,19,39,48,61,29,42,21,32,291
221402705,26,55,54,57,37,38,17,27,311
221402706,13,33,36,41,37,33,12,21,226
221402707,20,50,78,71,60,47,19,43,388
221402708,19,28,51,49,47,33,21,16,264
221402709,7,27,45,54,38,34,9,19,233
221402710,17,35,41,40,29,10,6,1,179
221402711,37,51,62,69,41,34,15,13,322
221402712,30,34,69,50,32,17,5,6,243
221402713,27,42,43,56,37,17,10,10,242
221402714,40,62,85,127,64,42,21,25,466
221402715,30,44,54,79,48,54,3,4,316
221402716,20,57,65,78,72,42,16,21,371
221402717,27,48,81,85,68,27,6,10,352
221402718,35,42,69,82,63,27,7,9,334
221402719,33,39,71,86,52,47,11,17,356
221402720,38,44,62,43,31,28,7,2,255
221402721,20,38,67,57,21,27,3,9,242
221402722,53,50,72,64,23,14,3,5,284
221402723,33,37,44,38,25,23,9,10,219
221402724,22,36,21,26,15,17,8,7,152
221402725,29,33,60,43,15,11,3,5,199
221402726,16,31,39,43,38,19,6,13,205
221402801,33,49,63,104,58,12,9,3,331
221402802,28,58,67,79,46,23,7,8,316
221402803,24,39,44,54,35,14,3,4,217
221402804,36,53,66,59,44,19,2,6,285
221402805,30,47,82,114,69,26,13,11,392
221402806,17,35,47,49,34,12,2,6,202
221402807,6,13,32,13,23,26,10,11,134
221402808,24,45,68,84,69,49,31,35,405
221402809,32,32,50,46,40,32,8,9,249
221402810,30,71,104,75,46,23,7,3,359
221402811,27,42,61,74,43,33,13,7,300
221402901,28,22,45,39,22,17,8,5,186
221402902,28,43,47,48,24,17,6,10,223
221402903,29,35,60,54,43,15,6,9,251
221402904,14,28,59,100,55,21,2,1,280
221402905,43,54,55,49,26,20,11,12,270
221402906,21,43,65,72,54,17,4,5,281
221402907,8,17,35,22,14,15,2,5,118
221402908,23,44,61,66,52,25,8,10,289
221402909,27,57,74,81,47,44,4,5,339
221402910,23,41,82,98,80,41,6,15,386
221402911,22,47,72,82,50,27,15,6,321
221402912,17,29,42,24,19,16,9,5,161
221402913,16,38,53,85,37,13,3,4,249
221402914,37,42,63,62,38,27,10,10,289
221402915,24,37,48,65,39,34,10,15,272
221402916,17,35,46,47,33,21,5,3,207
221402919,29,32,37,32,34,10,7,7,188
221402920,27,30,49,57,24,23,9,5,224
221403001,28,45,41,57,37,21,4,9,242
221403002,38,36,32,56,34,17,4,10,227
221403003,39,59,61,68,55,50,19,30,381
221403004,9,28,45,55,40,27,8,9,221
221403005,15,51,70,99,76,49,21,15,396
221403006,21,30,40,37,13,11,3,8,163
221403007,26,63,129,96,50,21,11,6,402
221403008,18,18,24,18,15,11,8,5,117
221403009,38,60,67,51,51,36,12,22,337
221403010,7,10,41,46,22,14,4,1,145
221403011,20,37,39,29,33,34,15,25,232
221403012,13,28,43,52,35,16,9,2,198
221403013,9,17,33,31,17,6,9,8,130
221470101,16,7,4,8,8,8,4,7,62
221470102,2,4,2,2,2,2,1,2,17
221470103,9,11,7,2,3,3,3,3,41
221470104,11,14,9,20,2,4,2,3,65
221470105,17,18,22,21,12,12,4,6,112
221470106,29,21,25,21,14,14,3,6,133
221470107,8,10,7,9,2,3,2,3,44
221470108,11,10,4,10,7,1,1,1,45
221470201,56,77,64,57,45,36,16,14,365
221470202,36,56,37,27,18,9,5,3,191
221470203,44,51,78,57,45,18,10,3,306
221470204,26,37,30,22,25,12,2,21,175
221470205,26,47,35,26,18,10,3,2,167
221470206,30,69,57,56,34,20,11,19,296
221470301,52,59,73,67,58,32,27,23,391
221470302,6,17,10,6,6,2,1,2,50
221470303,17,17,16,16,13,10,4,8,101
221470304,9,6,7,7,6,3,1,0,39
221470305,69,63,78,90,53,48,24,46,471
221470306,47,52,70,63,51,44,11,27,365
221470307,16,13,12,14,8,10,5,7,85
221470401,44,48,59,50,38,25,6,11,281
221470402,30,13,17,12,10,8,4,5,99
221470403,15,13,12,4,4,3,1,2,54
221470404,11,8,3,9,3,1,2,0,37
221540101,68,64,64,62,53,35,8,11,365
221540102,63,32,41,31,27,31,10,21,256
221540103,24,15,16,14,12,8,7,8,104
221540104,31,30,26,26,17,11,6,6,153
221540105,55,66,59,60,37,24,14,5,320
221540106,17,17,15,22,19,11,8,10,119
221540201,30,54,50,61,29,18,12,19,273
221540202,58,89,57,63,35,33,9,9,353
221540203,3,8,7,3,4,2,0,3,30
221540204,34,36,37,19,13,11,7,8,165
221540205,9,4,7,8,5,2,0,2,37
221540206,33,52,44,48,26,26,17,19,265
221540301,34,43,51,45,27,26,9,7,242
221540302,38,58,63,65,39,38,26,18,345
221540303,14,13,22,23,7,16,4,1,100
221540304,9,8,13,7,8,7,5,4,61
221540305,14,25,20,19,16,13,7,10,124
221540306,11,4,4,4,2,2,2,1,30
221540307,66,61,80,66,38,29,6,21,367
221540308,19,14,19,11,12,11,3,6,95
221540309,39,41,40,39,26,9,4,3,201
221540310,34,18,14,15,6,7,7,5,106
221540311,31,35,58,42,35,20,17,18,256
221610101,21,5,11,4,7,1,1,1,51
221610102,11,9,12,7,4,7,0,0,50
221610103,7,1,3,4,1,1,1,0,18
221610201,53,49,65,57,44,37,18,19,342
221610202,26,2,8,12,10,5,1,2,66
221610203,9,2,4,8,2,2,1,1,29
221610301,71,49,77,65,52,41,21,23,399
221610302,12,7,14,11,11,2,2,5,64
221610303,1,4,3,4,3,0,0,0,15
221610304,9,3,6,2,1,0,0,0,21
221610305,11,5,5,4,3,0,1,1,30
221610401,18,9,14,12,5,3,0,0,61
221610402,3,5,0,1,1,0,0,0,10
221680101,71,101,66,51,24,18,6,4,341
221680102,45,58,58,47,29,17,2,2,258
221680103,24,36,42,51,37,31,15,29,265
221680104,40,49,56,61,31,27,9,18,291
221680105,51,76,55,36,27,13,2,6,266
221680106,54,80,46,49,30,6,8,4,277
221680107,64,75,127,95,79,46,25,36,547
221680108,24,34,57,56,49,34,20,30,304
221680109,27,35,53,63,39,41,6,25,289
221680110,38,49,79,61,39,39,11,18,334
221680111,15,24,26,26,22,19,14,12,158
221680112,27,56,81,74,42,30,9,6,325
221680113,36,59,74,59,40,29,15,22,334
221680114,35,43,44,42,34,42,12,23,275
221680115,19,28,46,37,41,22,13,18,224
221680116,25,20,33,30,26,22,7,25,188
221680117,26,39,37,41,25,19,5,9,201
221680201,5,11,8,6,10,7,1,4,52
221680202,15,10,19,10,6,11,1,8,80
221680203,7,9,8,8,1,8,1,0,42
221680204,5,9,8,6,5,4,1,3,41
221680205,15,5,14,8,6,7,5,6,66
221680206,7,6,2,3,1,0,0,4,23
221680207,11,3,16,9,12,6,3,4,64
221680301,12,13,14,4,7,4,1,5,60
221680302,14,12,21,19,10,13,0,4,93
221680303,1,0,0,4,2,6,0,5,18
221680304,10,8,6,5,1,4,1,5,40
221680305,4,7,10,5,5,3,0,0,34
221680306,12,16,8,11,5,3,4,4,63
221680307,14,12,9,7,3,4,1,1,51
221680308,12,14,13,6,1,1,2,2,51
221680309,41,55,95,85,50,46,6,14,392
221680310,50,76,89,106,67,47,23,35,493
221680401,10,11,14,13,7,7,6,14,82
221680402,15,18,20,21,28,22,12,22,158
221680403,6,25,22,23,15,14,9,26,140
221680404,2,12,8,11,10,5,4,8,60
221680405,6,9,7,8,14,10,9,6,69
221680406,21,14,19,10,9,9,2,5,89
221680407,2,10,16,9,5,5,0,1,48
221680408,16,8,10,10,4,4,3,4,59
221680409,23,46,43,53,36,37,15,34,287
260070101,19,5,1,1,2,1,0,0,29
260070201,28,10,1,3,0,0,0,0,42
260070202,40,44,26,26,11,7,2,0,156
260070301,38,9,2,4,0,3,0,0,56
260070302,7,4,0,0,0,0,0,0,11
260070303,10,12,3,0,1,1,0,0,27
260070304,34,39,51,50,18,9,1,1,203
260070401,111,113,37,19,9,3,3,0,295
260070402,41,67,53,34,22,15,1,2,235
260070403,70,80,56,36,13,10,2,1,268
260070404,65,63,58,47,24,9,6,3,275
260070405,58,65,66,75,29,23,9,11,336
260070406,20,30,52,50,39,21,6,9,227
260070407,54,76,93,102,64,30,8,6,433
260070408,11,19,24,27,14,6,4,1,106
260070409,29,62,64,44,25,8,3,0,235
260070410,27,68,47,35,20,8,3,2,210
260070411,18,74,41,38,16,9,2,2,200
260070412,30,86,82,66,50,24,13,11,362
260070413,17,5,3,3,1,1,0,0,30
260070414,3,3,1,3,1,0,0,0,11
260070501,21,37,79,74,54,35,15,12,327
260070502,45,52,44,55,42,23,13,11,285
260070503,26,36,67,67,52,40,11,25,324
260070504,27,37,39,41,32,18,8,4,206
260070505,14,29,35,50,37,40,10,16,231
260070506,8,40,41,63,35,36,7,8,238
260070507,19,28,55,63,31,30,12,11,249
260070508,35,27,46,59,38,31,14,22,272
260070509,44,34,62,42,37,23,12,12,266
260070510,41,47,71,83,71,47,16,15,391
260070511,36,32,46,72,43,24,13,9,275
260070601,50,72,80,61,43,23,9,18,356
260070602,50,47,46,40,25,8,8,5,229
260070603,42,95,60,41,26,11,5,5,285
260070604,64,66,78,76,53,26,9,5,377
260070605,46,67,100,63,58,36,14,13,397
260070606,25,48,63,35,24,14,7,9,225
260070607,38,54,50,56,44,32,17,15,306
260070608,30,54,77,73,46,35,13,12,340
260070609,47,87,82,66,60,29,8,10,389
260070610,47,58,70,78,48,26,11,6,344
260070611,18,26,22,30,20,13,4,3,136
260070612,93,88,83,59,46,23,4,7,403
260070613,59,58,27,26,8,5,2,0,185
260070614,74,122,50,36,17,8,0,0,307
260070615,84,96,79,68,21,13,1,2,364
260070701,12,17,15,9,9,6,3,4,75
260070702,31,42,45,43,27,24,7,13,232
260070703,16,26,43,44,56,31,16,23,255
260070704,42,52,50,62,54,33,26,29,348
260070705,41,40,55,60,36,31,10,14,287
260070706,11,26,38,51,38,15,7,7,193
260070707,25,48,77,72,56,37,15,24,354
260070708,20,33,60,77,66,38,27,22,343
260070709,37,43,46,78,59,31,14,16,324
260070710,11,30,52,68,58,42,8,12,281
260070711,16,32,43,55,39,27,14,13,239
260070712,35,39,37,63,39,23,4,9,249
260070801,54,57,62,42,35,8,1,1,260
260070802,75,86,106,99,50,27,8,4,455
260070803,52,45,51,47,28,16,8,3,250
260070804,51,54,73,76,48,17,4,7,330
260070805,48,45,69,64,36,17,7,8,294
260070806,69,102,106,80,51,36,6,7,457
260070807,28,45,48,42,22,11,3,7,206
260070808,32,51,43,43,27,14,5,3,218
260070809,29,43,53,37,23,12,6,7,210
260070810,35,34,50,58,19,13,2,6,217
260070811,49,103,100,92,47,15,13,3,422
260070812,35,54,72,75,53,29,11,10,339
260070813,46,65,52,55,30,15,4,4,271
260070901,81,100,66,58,16,10,4,0,335
260070902,77,98,68,50,16,10,0,0,319
260070903,88,161,83,58,34,14,5,2,445
260070904,53,91,58,65,24,7,2,1,301
260070905,76,116,60,35,15,11,0,2,315
260070906,70,87,55,45,19,1,2,1,280
260070907,64,75,84,55,32,7,2,1,320
260070908,59,71,77,71,27,6,3,3,317
260070909,32,37,29,39,9,8,1,1,156
260070910,33,51,47,53,21,6,2,1,214
260071001,43,32,8,5,0,0,0,0,88
260071002,117,118,57,29,19,3,1,1,345
260071003,61,48,11,9,2,1,1,0,133
260071004,41,71,34,21,11,3,1,0,182
260071005,59,90,50,33,14,3,4,0,253
260071006,42,92,49,43,17,4,1,1,249
260071007,69,100,51,39,17,7,0,0,283
260071008,55,75,33,32,13,3,0,0,211
260071009,55,74,48,31,15,5,3,0,231
260071010,102,100,96,46,25,4,1,2,376
260071011,70,70,47,32,11,2,1,0,233
260071012,41,41,47,32,15,3,1,2,182
260071013,31,34,20,37,17,0,1,0,140
260140101,36,6,3,0,2,0,0,0,47
260140102,19,7,6,2,1,2,0,0,37
260140103,12,17,12,16,6,5,3,3,74
260140104,35,51,43,47,37,12,8,4,237
260140105,63,65,58,52,23,17,3,5,286
260140106,39,47,53,43,30,21,6,7,246
260140107,19,34,35,41,22,26,12,8,197
260140108,51,63,37,45,26,9,3,3,237
260140201,1,0,1,0,0,0,1,0,3
260140202,2,9,4,5,2,0,0,0,22
260140203,3,0,2,1,1,0,0,0,7
260140204,5,1,0,0,0,0,0,0,6
260140205,2,0,1,0,0,0,0,0,3
260140206,0,0,1,0,0,0,0,0,1
260140207,6,4,0,0,0,0,0,0,10
260140208,2,1,0,0,1,0,0,0,4
260140209,1,0,2,2,0,0,0,0,5
260140301,29,13,14,8,3,4,2,4,77
260140302,14,6,10,11,5,0,0,0,46
260140303,44,43,46,44,30,9,6,5,227
260140304,14,7,1,1,1,2,0,0,26
260140305,25,9,11,3,3,2,1,1,55
260140306,12,18,7,2,2,0,0,1,42
260140307,15,10,10,7,2,0,0,1,45
260140401,18,22,8,4,2,0,0,1,55
260140501,3,2,2,3,0,0,0,0,10
260140601,5,7,4,2,0,0,0,0,18
260140701,9,8,2,0,1,1,0,0,21
260140702,20,13,8,7,1,1,0,0,50
260140703,1,0,0,1,1,0,0,0,3
260140704,16,14,9,2,1,1,0,0,43
260140705,85,82,74,58,39,22,10,3,373
260140801,49,52,34,27,20,4,0,3,189
260140802,13,10,3,1,0,0,0,1,28
260140803,32,49,73,54,33,15,7,5,268
260140804,42,65,55,41,28,11,3,2,247
260140901,207,239,196,167,81,35,10,10,945
260140902,11,9,1,2,0,2,1,1,27
260140903,35,40,38,61,30,18,4,4,230
260140904,47,69,52,53,21,7,4,1,254
260140905,42,63,65,38,18,4,4,2,236
260140906,45,53,56,45,30,17,6,3,255
260141001,17,13,12,11,8,2,1,1,65
260141002,15,12,9,5,4,2,0,0,47
260141003,39,35,29,24,10,6,2,0,145
260141004,62,72,76,65,27,13,7,5,327
260141101,9,7,5,3,1,0,0,0,25
260141102,104,90,97,88,50,21,8,4,462
260141103,50,72,55,48,27,13,5,2,272
260141104,30,40,47,35,15,9,0,3,179
260210101,22,5,4,0,0,0,0,1,32
260210102,3,6,5,5,3,0,0,0,22
260210103,14,7,4,1,0,0,0,1,27
260210104,7,2,2,2,0,0,0,0,13
260210201,9,7,4,2,2,0,2,0,26
260210202,34,9,2,4,1,0,0,0,50
260210203,7,4,2,0,0,0,0,0,13
260210204,51,71,92,68,56,23,6,8,375
260210301,20,7,1,1,0,0,0,0,29
260210302,4,3,2,0,0,0,0,0,9
260210401,2,0,0,0,0,0,0,0,2
260210402,5,13,19,19,7,2,2,0,67
260210403,7,18,20,27,10,0,0,0,82
260210404,29,58,74,75,33,9,3,0,281
260210405,40,63,69,62,29,10,1,0,274
260210406,50,85,69,69,30,11,3,0,317
260210407,24,63,79,95,58,18,5,5,347
260210408,26,56,47,52,26,3,6,4,220
260210409,37,52,63,56,23,6,3,1,241
260210410,31,84,49,41,27,8,5,0,245
260210411,35,73,39,30,12,6,0,1,196
260210412,32,51,34,47,17,8,2,2,193
260210413,41,65,58,44,18,5,0,1,232
260210414,26,47,62,45,19,13,1,2,215
260210501,8,1,1,0,1,0,1,0,12
260210502,19,49,46,38,44,14,10,8,228
260210503,9,18,21,31,18,8,4,2,111
260210504,0,0,1,1,0,0,0,0,2
260210505,46,50,65,62,46,26,9,8,312
260210506,44,64,69,65,24,13,4,5,288
260210507,43,61,54,45,25,12,3,2,245
260210508,24,33,24,27,16,6,3,0,133
260210509,15,37,42,53,28,18,8,6,207
260210510,19,37,58,45,43,28,11,7,248
260210511,14,33,64,74,54,21,9,7,276
260210512,28,43,83,71,39,35,11,10,320
260210513,41,96,104,103,58,27,6,7,442
260210514,65,92,98,102,65,37,8,6,473
260210515,76,80,98,78,42,20,6,7,407
260210516,13,26,49,60,48,32,7,2,237
260210517,8,36,40,78,42,24,6,8,242
260210518,22,44,65,72,50,24,7,9,293
260210601,16,23,27,25,9,7,0,1,108
260210602,41,44,37,29,27,10,3,3,194
260210603,4,16,15,17,15,2,2,2,73
260210604,24,61,67,58,41,13,9,4,277
260210605,57,80,83,76,47,12,4,8,367
260210606,26,63,60,62,40,19,5,4,279
260210607,45,63,73,79,40,18,10,6,334
260210608,50,88,91,89,75,33,10,13,449
260210609,15,37,71,96,69,26,12,10,336
260210610,34,72,77,93,51,33,15,9,384
260210611,66,106,66,58,35,17,2,1,351
260210612,62,68,56,57,18,13,3,2,279
260210613,40,43,42,38,19,10,2,2,196
260210614,45,73,69,44,25,6,4,1,267
260210615,54,65,56,48,23,5,0,0,251
260210701,20,7,5,5,1,1,0,0,39
260210702,67,54,41,45,22,5,3,4,241
260210703,7,17,25,16,7,8,1,2,83
260210704,53,91,89,87,60,35,11,14,440
260210705,15,23,22,22,13,5,2,4,106
260210706,33,45,53,49,27,11,7,5,230
260210707,36,44,55,48,42,11,8,7,251
260210708,27,37,48,42,43,15,5,3,220
260210709,46,54,69,72,41,33,7,15,337
260210710,40,42,54,62,33,28,7,12,278
260210711,26,32,31,36,30,15,6,2,178
260210712,36,44,56,60,43,19,8,5,271
260210801,3,11,5,8,2,0,1,0,30
260210802,79,131,101,80,31,13,5,2,442
260210803,11,12,8,10,3,2,2,0,48
260210804,28,39,31,24,12,4,0,3,141
260210805,44,73,36,44,18,6,3,1,225
260210806,45,63,43,21,27,6,1,1,207
260210807,90,122,72,50,27,5,5,1,372
260210808,55,91,60,37,14,8,1,1,267
260210809,24,34,35,25,18,6,2,3,147
260210810,43,81,74,57,30,6,6,4,301
260210811,10,11,13,10,7,2,0,0,53
260210812,48,87,65,48,31,21,13,8,321
260210813,10,25,36,33,9,1,0,0,114
260210814,57,72,96,97,37,21,4,6,390
260210815,58,105,91,78,40,21,6,3,402
260210901,82,70,61,48,22,15,4,5,307
260210902,84,64,26,27,9,2,0,0,212
260210903,74,63,30,30,13,2,2,1,215
260210904,44,51,14,9,5,2,1,0,126
260210905,58,65,31,20,9,2,0,1,186
260210906,55,47,33,9,5,2,1,0,152
260210907,58,66,37,29,7,2,2,2,203
260210908,85,86,49,23,6,6,0,1,256
260210909,35,43,42,44,38,17,4,0,223
260210910,37,47,24,21,10,4,3,1,147
260210911,88,77,53,42,20,3,2,2,287
260210912,43,45,35,19,7,2,2,1,154
260210913,38,34,27,16,6,4,2,1,128
260210914,57,49,42,21,11,2,1,2,185
260211001,125,106,50,37,13,3,2,0,336
260211002,110,86,36,21,15,4,0,0,272
260211003,118,101,49,32,15,9,1,1,326
260211004,62,76,55,26,11,5,0,0,235
260211005,36,41,35,21,9,5,2,0,149
260211006,45,39,37,41,16,8,2,2,190
260211007,38,53,25,31,19,7,2,2,177
260211008,52,57,42,34,10,8,2,1,206
260211009,44,50,34,27,6,5,4,0,170
260211010,66,50,35,32,18,4,1,9,215
260211011,32,25,24,18,5,1,0,0,105
260211012,156,156,98,39,22,3,1,1,476
260211013,83,100,58,38,20,15,1,1,316
260211101,20,17,22,35,18,16,7,5,140
260211102,46,56,61,38,35,19,5,4,264
260211103,42,30,24,24,11,6,0,1,138
260211104,79,98,76,68,30,16,2,2,371
260211105,41,48,38,21,14,9,4,4,179
260211106,39,37,43,45,25,15,7,4,215
260211107,53,51,68,58,42,26,14,15,327
260211108,88,67,84,70,50,24,7,6,396
260211109,79,76,69,37,27,10,3,2,303
260211110,56,83,66,47,34,22,4,3,315
260211111,56,61,58,53,26,11,8,6,279
260211112,43,46,36,33,14,5,1,3,181
260211113,69,80,69,53,26,12,8,5,322
260211114,48,62,45,49,14,8,2,7,235
260211115,32,51,50,33,8,10,1,3,188
260211116,53,58,56,28,23,14,9,4,245
260211117,47,56,40,39,24,5,6,2,219
260211201,36,42,62,77,53,23,14,16,323
260211202,29,48,48,43,28,20,9,6,231
260211203,53,52,71,55,44,35,16,8,334
260211204,51,72,88,72,41,23,11,9,367
260211205,31,36,37,31,24,8,2,9,178
260211206,70,73,65,55,33,25,13,7,341
260211207,56,83,74,68,34,17,6,9,347
260211208,42,57,56,60,32,16,8,6,277
260211209,52,65,80,54,28,23,12,5,319
260211210,45,30,40,32,12,6,2,3,170
260211301,61,68,67,55,38,19,6,11,325
260211302,49,80,90,78,59,29,11,14,410
260211303,39,54,48,39,34,13,4,5,236
260211304,28,55,54,53,28,9,2,2,231
260211305,71,89,73,60,35,29,10,12,379
260211306,69,67,53,34,20,13,4,5,265
260211307,29,47,39,38,23,10,4,4,194
260211308,37,45,48,43,25,10,4,6,218
260211309,34,57,74,44,26,24,8,4,271
260211310,67,68,48,41,25,12,4,6,271
260211311,44,45,50,36,20,10,0,4,209
260211312,87,104,100,72,35,16,5,5,424
260211401,76,117,81,60,35,18,3,7,397
260211402,57,95,55,49,25,10,4,2,297
260211403,36,56,63,35,30,8,3,1,232
260211404,64,85,85,75,30,12,5,0,356
260211405,40,55,68,48,16,8,1,4,240
260211406,76,94,84,50,17,10,1,0,332
260211407,78,114,93,78,33,17,2,4,419
260211408,47,81,58,36,11,7,3,1,244
260211409,33,36,63,60,19,10,11,3,235
260211410,39,55,41,23,14,5,1,0,178
260211411,34,88,54,48,15,10,4,2,255
260211412,57,88,71,47,26,7,1,1,298
260211413,72,84,73,50,30,21,5,4,339
260211501,32,49,58,44,29,15,5,2,234
260211502,38,66,70,66,35,30,5,11,321
260211503,48,66,86,52,39,23,8,9,331
260211504,42,67,79,64,35,11,5,3,306
260211505,22,43,51,69,29,15,5,2,236
260211506,32,60,64,56,43,16,9,4,284
260211507,43,48,58,49,24,11,5,1,239
260211508,20,56,56,55,29,13,2,2,233
260211509,31,54,61,52,15,9,3,0,225
260211510,14,50,56,58,48,35,8,18,287
260211511,20,53,75,64,51,48,21,8,340
260211601,45,40,68,70,61,41,12,15,352
260211602,18,23,17,23,15,6,5,4,111
260211603,34,20,46,42,30,15,6,5,198
260211604,22,34,44,45,33,13,5,7,203
260211605,55,58,55,62,56,21,11,17,335
260211606,36,40,55,47,33,30,8,8,257
260211607,52,51,62,62,28,20,11,3,289
260211608,34,51,60,48,42,25,12,13,285
260211609,35,50,48,71,47,36,19,18,324
260211610,41,53,58,96,61,41,16,15,381
260211611,39,45,54,60,33,18,4,3,256
260211612,12,38,70,45,28,10,2,5,210
260211613,38,66,83,91,59,30,13,11,391
260211614,23,33,39,38,19,23,7,8,190
260211615,18,25,51,58,34,16,9,5,216
260211701,9,13,22,27,5,0,1,0,77
260211702,28,65,50,61,30,42,19,14,309
260211703,32,31,40,34,28,13,0,1,179
260211704,37,38,50,53,44,22,8,9,261
260211705,20,41,46,73,50,40,8,8,286
260211706,48,38,54,74,50,22,4,4,294
260211707,17,26,51,57,35,16,4,4,210
260211708,16,26,59,100,54,31,10,7,303
260211709,22,55,94,94,66,49,17,10,407
260211710,23,34,53,68,49,24,7,6,264
260211711,65,61,82,71,76,45,11,9,420
260211712,29,40,47,67,57,35,8,12,295
260211713,16,17,23,36,22,17,13,13,157
260211714,30,44,98,57,43,38,6,11,327
260211801,48,39,36,38,17,6,2,2,188
260211802,35,36,57,51,24,8,7,1,219
260211803,14,34,58,72,51,23,7,6,265
260211804,28,42,62,70,34,26,8,10,280
260211805,29,35,45,46,33,21,14,23,246
260211806,18,23,42,38,25,29,12,4,191
260211807,20,24,41,50,28,11,5,4,183
260211808,15,56,65,84,43,17,11,13,304
260211809,46,70,95,86,45,22,9,2,375
260211810,38,51,60,48,22,6,4,2,231
260211811,53,69,87,47,31,12,2,1,302
260211812,29,46,52,58,19,11,4,2,221
260211813,30,57,45,50,25,13,3,0,223
260211901,34,50,46,32,19,8,3,4,196
260211902,42,91,63,62,29,14,1,1,303
260211903,68,74,80,85,34,19,9,4,373
260211904,29,52,34,45,13,8,3,1,185
260211905,32,53,44,68,28,16,6,10,257
260211906,53,52,43,47,20,14,5,3,237
260211907,55,47,62,50,21,12,3,2,252
260211908,32,58,49,49,44,23,1,6,262
260211909,42,43,50,68,33,13,7,3,259
260211910,36,49,64,59,26,18,4,4,260
260211911,41,45,76,57,34,17,3,5,278
260211912,34,49,46,88,51,32,12,8,320
260211913,33,30,65,75,55,28,13,2,301
260211914,36,27,37,26,21,18,2,3,170
260211915,44,35,64,63,36,16,4,6,268
260211916,58,26,50,40,27,20,4,2,227
260280101,9,5,9,1,1,0,0,0,25
260280102,1,1,1,1,0,0,0,0,4
260280201,22,5,3,2,1,0,0,0,33
260280301,11,2,0,0,0,0,0,0,13
260280302,15,6,2,1,0,0,0,0,24
260280303,81,67,66,79,43,26,9,9,380
260350101,15,12,12,6,5,0,1,0,51
260350102,10,5,3,4,1,2,0,0,25
260350201,51,34,14,14,7,3,2,2,127
260350202,21,7,2,1,0,0,0,0,31
260350301,33,29,26,30,14,5,1,0,138
260350302,38,38,41,39,15,9,4,6,190
260350303,21,51,56,51,24,10,3,1,217
260350304,38,79,44,52,23,8,2,0,246
260350305,62,58,52,45,24,6,0,2,249
260350306,36,66,43,47,12,5,1,1,211
260350307,71,81,56,44,18,1,2,0,273
260350308,34,48,26,17,10,1,1,0,137
260350309,84,96,65,44,16,4,0,2,311
260350310,29,36,28,24,15,4,3,1,140
260350311,102,99,79,55,21,6,5,4,371
260350312,32,46,54,41,35,22,6,6,242
260350313,32,27,52,43,26,15,7,14,216
260350401,5,1,1,0,0,0,0,0,7
260350402,21,5,2,2,1,1,0,0,32
260350403,24,15,19,14,5,6,4,1,88
260350404,106,127,127,134,50,26,13,4,587
260350405,18,3,0,0,0,0,0,0,21
260350501,3,5,1,0,0,0,0,0,9
260350502,16,16,7,12,5,0,0,0,56
260350503,10,8,2,5,4,0,0,0,29
260350504,21,4,4,2,1,0,0,0,32
260350505,65,35,33,26,14,7,3,4,187
260350506,12,9,5,5,3,0,0,0,34
260350507,32,32,28,29,19,6,1,3,150
260350508,24,27,14,6,7,1,3,1,83
260350509,49,56,67,52,29,17,2,1,273
260350510,82,99,95,81,34,13,4,1,409
260350511,27,46,38,31,15,4,2,0,163
260350512,30,37,39,44,21,8,0,0,179
260350513,55,60,58,55,34,12,3,3,280
260350514,41,75,70,57,24,13,9,2,291
260350515,19,27,66,81,71,28,19,7,318
260350601,49,57,83,76,32,19,11,3,330
260350602,41,47,53,56,35,11,3,6,252
260350603,35,53,58,46,38,20,7,8,265
260350604,35,35,35,43,24,9,6,6,193
260350605,35,34,55,47,27,10,8,4,220
260350606,28,41,45,36,20,8,2,1,181
260350607,54,49,32,30,10,5,2,0,182
260350608,50,78,45,19,18,2,1,1,214
260350609,47,63,34,17,6,3,2,2,174
260350610,63,83,43,35,6,3,3,0,236
260350611,76,70,50,27,25,7,3,2,260
260350612,62,64,59,36,8,4,1,0,234
260350613,40,57,38,39,21,6,4,2,207
260350614,41,64,44,35,17,9,4,1,215
260350615,48,84,63,47,21,12,5,4,284
260350701,78,88,62,44,14,8,2,4,300
260350702,46,49,59,56,33,24,15,11,293
260350703,33,48,81,82,67,31,13,11,366
260350704,57,62,43,42,23,10,4,6,247
260350705,63,80,89,71,26,13,3,3,348
260350706,42,64,64,48,17,5,3,1,244
260350707,59,94,93,70,45,16,4,5,386
260350708,24,41,65,96,55,34,11,5,331
260350709,25,38,59,82,56,33,15,9,317
260350710,28,69,80,73,60,23,12,4,349
260350711,32,47,39,33,11,8,3,0,173
260350712,23,44,76,113,62,32,8,5,363
260350713,41,51,34,33,10,3,1,0,173
260420101,9,2,2,0,1,0,0,0,14
260420102,15,9,1,1,0,0,0,0,26
260420103,5,3,0,0,1,0,0,0,9
260420201,33,3,1,0,0,0,0,0,37
260420301,17,14,9,8,7,4,0,0,59
260420302,11,4,2,0,0,0,0,0,17
260420401,0,0,1,0,0,0,0,0,1
260420402,1,3,1,0,0,0,0,0,5
260420403,23,23,16,17,15,7,7,2,110
260420404,8,9,7,6,0,3,0,0,33
260420405,10,10,7,2,4,3,0,1,37
260420406,21,8,6,6,4,1,0,0,46
260420407,12,15,16,6,5,2,0,1,57
260420408,15,10,8,12,4,2,1,1,53
260420409,30,41,16,25,9,7,0,2,130
260420410,34,56,58,86,36,24,7,11,312
260420411,39,34,21,32,10,10,1,6,153
260420412,14,15,8,13,11,5,1,1,68
260420413,122,117,113,73,51,20,17,15,528
260420414,78,84,82,72,28,31,12,10,397
260420415,50,60,78,87,53,33,15,16,392
260420416,85,79,55,38,17,11,5,6,296
260420417,59,80,82,51,21,25,10,8,336
260420418,77,105,82,71,44,9,2,2,392
260490101,22,6,6,2,1,1,0,1,39
260490102,14,7,2,0,2,0,0,0,25
260490103,21,10,6,4,6,2,0,0,49
260490104,17,9,8,3,0,0,0,0,37
260490105,27,18,15,10,8,9,0,1,88
260490106,38,33,41,35,20,10,1,3,181
260490201,1,2,1,0,1,0,0,0,5
260490202,15,8,3,1,0,0,1,0,28
260490203,25,16,8,4,4,2,0,1,60
260560101,14,10,6,2,4,0,0,0,36
260560102,10,7,1,0,0,0,0,0,18
260560103,11,6,2,1,0,0,0,0,20
260560104,40,18,16,15,8,2,1,1,101
260560105,17,8,2,1,0,0,0,0,28
260560106,16,8,5,2,1,1,0,0,33
260560107,29,15,18,15,8,3,0,2,90
260560108,44,31,31,30,15,6,0,0,157
260560201,10,2,4,2,0,0,0,0,18
260560202,18,14,7,8,1,0,0,1,49
260560203,4,0,0,1,0,0,0,0,5
260560204,4,5,3,0,0,0,0,0,12
260560205,8,2,2,2,0,0,0,0,14
260560206,83,86,83,63,38,20,11,8,392
260560301,23,22,19,22,7,5,1,1,100
260630101,3,1,1,2,1,0,0,0,8
260630102,5,5,2,0,1,0,0,0,13
260630103,10,3,2,2,1,1,2,0,21
260630201,9,10,2,4,0,0,0,1,26
260630202,16,4,3,1,0,0,1,0,25
260630203,39,29,43,22,20,2,2,3,160
260630301,10,3,4,0,0,0,0,0,17
260630401,10,3,2,2,0,0,0,0,17
260700101,10,5,4,1,3,3,0,0,26
260700102,20,4,0,1,0,0,0,0,25
260700103,9,3,2,1,0,0,0,0,15
260700104,41,26,19,10,4,4,1,1,106
260700105,15,8,5,1,0,0,0,0,29
260700106,10,5,0,1,1,1,0,0,18
260700107,5,3,2,0,0,0,0,0,10
260700108,77,59,75,72,51,23,12,8,377
260700201,12,3,2,1,0,0,0,0,18
260700202,11,5,4,4,0,1,0,0,25
260770101,2,1,0,0,0,0,0,0,3
260770102,11,0,2,0,0,0,0,0,13
260770103,7,1,2,0,0,0,0,0,10
260770104,10,6,2,0,0,0,0,0,18
260770201,15,3,2,1,1,0,0,0,22
260770202,1,1,0,0,0,0,0,0,2
260770203,29,20,1,1,0,0,0,0,51
260770204,6,9,13,15,11,1,2,1,58
260770301,28,28,27,22,7,1,2,0,115
260770302,68,74,45,34,7,3,0,0,231
260770303,47,38,29,39,13,4,0,1,171
260770304,14,24,39,49,43,22,8,9,208
260770305,37,53,72,62,34,19,11,7,295
260770306,18,65,44,59,18,9,1,1,215
260770307,51,62,25,19,15,1,1,0,174
260770308,30,35,18,12,7,2,0,2,106
260770309,20,26,13,12,2,1,1,0,75
260770310,30,40,39,16,7,0,0,0,132
260770311,27,31,28,14,5,3,0,0,108
260770312,26,38,23,11,4,3,0,0,105
260770313,30,54,23,11,3,1,1,0,123
260770314,29,38,13,21,6,1,1,0,109
260770315,35,57,26,20,4,2,1,1,146
260770316,20,26,14,16,7,3,1,1,88
260770401,32,28,19,14,8,8,1,3,113
260770402,20,9,10,9,7,1,2,2,60
260770403,45,46,27,20,14,10,2,3,167
260770404,53,55,37,32,16,9,4,5,211
260770405,32,20,11,5,5,3,3,4,83
260770501,0,2,1,0,0,0,0,0,3
260770502,21,31,56,55,65,31,15,11,285
260770503,18,28,29,54,34,21,10,8,202
260770504,10,27,53,59,36,25,4,5,219
260770505,21,34,53,62,44,26,6,6,252
260770506,26,29,56,61,46,23,5,4,250
260770507,15,47,38,68,42,15,2,2,229
260770508,13,24,27,49,37,11,6,4,171
260770509,15,40,51,53,31,16,4,4,214
260770510,47,62,80,63,44,16,5,4,321
260770511,23,52,58,45,18,9,3,6,214
260770512,32,33,42,44,27,11,5,5,199
260770513,34,35,30,24,32,16,6,6,183
260770514,41,46,48,39,28,21,0,5,228
260770515,37,57,48,47,21,14,4,4,232
260770516,31,52,49,48,19,4,5,5,213
260770517,32,46,47,36,20,7,8,5,201
260770518,33,27,50,49,45,20,9,6,239
260770519,20,23,38,46,23,22,9,3,184
260770520,20,34,22,28,8,2,1,1,116
260770601,63,60,35,26,12,3,3,0,202
260770602,63,96,62,34,15,2,0,1,273
260770603,63,73,66,43,17,9,4,0,275
260770604,24,46,36,36,28,8,1,2,181
260770605,56,63,72,59,38,18,9,11,326
260770606,51,72,68,66,36,14,10,6,323
260770607,23,44,32,37,13,11,4,6,170
260770608,60,81,58,53,31,21,7,6,317
260770609,73,79,57,41,25,5,0,1,281
260770610,37,41,35,28,13,8,5,3,170
260770611,60,73,50,41,27,8,5,3,267
260770612,43,50,58,35,12,8,6,2,214
260770701,66,96,130,96,55,26,5,8,482
260770702,31,65,63,68,43,17,5,6,298
260770703,43,70,70,100,64,27,12,11,397
260770704,45,58,91,121,74,50,13,13,465
260770705,42,41,50,62,55,32,6,11,299
260770706,21,25,34,52,31,24,9,15,211
260770707,56,44,65,66,57,27,14,21,350
260770708,32,35,38,48,14,21,9,15,212
260770709,58,73,81,89,42,34,12,14,403
260770710,50,64,69,63,38,14,7,12,317
260770711,32,47,37,25,19,14,6,8,188
260770712,53,83,67,61,39,23,12,8,346
260770713,55,61,60,64,32,19,5,10,306
260770714,33,42,57,36,27,17,3,8,223
260770715,43,60,31,31,12,13,5,3,198
260770801,59,42,59,76,43,24,7,9,319
260770802,38,58,68,72,30,23,10,8,307
260770803,47,75,74,85,59,35,11,7,393
260770804,48,73,59,37,29,9,6,4,265
260770805,48,55,48,59,23,16,4,2,255
260770806,81,108,76,61,35,24,7,11,403
260770807,35,43,34,18,16,10,3,1,160
260770808,57,83,74,74,33,26,8,8,363
260770809,54,53,60,54,27,17,5,7,277
260770810,47,77,66,39,28,10,5,5,277
260770811,36,55,43,23,10,1,0,0,168
260770812,69,67,34,32,11,5,3,3,224
260770813,71,89,65,58,24,8,5,2,322
260770814,36,43,48,52,14,9,5,8,215
260770815,59,77,68,52,44,17,7,6,330
260770901,27,48,73,87,78,36,29,12,390
260770902,33,43,63,74,59,24,13,16,325
260770903,40,56,77,95,67,45,23,25,428
260770904,62,75,66,37,20,15,5,5,285
260770905,69,80,79,57,39,13,4,9,350
260770906,52,99,74,61,27,23,9,10,355
260770907,48,51,51,38,24,18,6,4,240
260770908,45,50,57,46,37,12,9,8,264
260770909,35,32,61,40,35,12,11,12,238
260770910,50,50,70,70,52,27,10,15,344
260770911,44,41,71,78,54,35,19,18,360
260770912,58,67,77,85,65,52,14,17,435
260771001,46,54,54,46,30,6,4,5,245
260771002,61,71,46,42,15,8,2,1,246
260771003,61,37,23,23,9,3,1,1,158
260771004,66,60,39,40,20,9,1,2,237
260771005,97,91,58,35,19,4,2,0,306
260771006,38,48,27,17,7,2,1,0,140
260771007,80,64,26,13,4,1,1,0,189
260771008,71,57,35,16,7,2,0,0,188
260771009,72,58,36,25,8,4,1,1,205
260771010,84,64,32,23,7,3,0,0,213
260771011,59,54,26,11,2,1,0,1,154
260771012,55,51,20,18,9,5,0,0,158
260771013,73,110,58,49,17,3,2,3,315
260771014,84,105,67,49,16,4,3,0,328
260771015,51,61,80,76,31,8,3,2,312
260771016,70,102,125,100,55,24,4,8,488
260771017,51,84,90,70,43,21,8,8,375
260771018,28,39,46,42,43,17,1,2,218
260771101,13,19,28,40,26,15,7,10,158
260771102,28,57,89,120,73,37,10,11,425
260771103,41,59,90,72,60,20,13,11,366
260771104,32,30,43,45,33,14,9,16,222
260771105,53,49,51,48,34,26,18,14,293
260771106,42,55,75,49,41,16,5,5,288
260771107,98,75,83,44,34,11,13,8,366
260771108,54,64,48,24,15,2,5,3,215
260771109,71,50,35,22,9,2,0,0,189
260771110,102,42,9,8,1,1,0,0,163
260771111,44,46,24,18,6,4,1,0,143
260771112,90,97,40,26,12,2,2,2,271
260771113,94,96,64,44,23,15,3,0,339
260771114,31,51,29,32,33,11,4,2,193
260771201,36,79,107,127,63,23,9,5,449
260771202,45,59,60,53,33,21,6,6,283
260771203,80,108,89,67,27,13,3,5,392
260771204,48,78,75,51,21,6,3,3,285
260771205,66,102,62,70,21,9,2,4,336
260771206,62,109,65,56,22,4,0,1,319
260771207,95,99,77,51,23,10,0,1,356
260771208,107,104,50,42,14,4,1,1,323
260771209,52,68,42,32,10,2,1,0,207
260771210,100,94,60,42,17,6,1,0,320
260771211,89,132,74,65,22,5,1,1,389
260771212,74,109,71,52,31,8,2,2,349
260771213,61,89,61,37,22,8,2,1,281
260771214,36,66,82,91,61,25,13,4,378
260771215,40,60,82,94,51,18,10,8,363
260771301,25,76,68,78,44,29,10,6,336
260771302,38,75,108,100,69,36,11,9,446
260771303,99,110,75,58,13,9,0,0,364
260771304,93,105,74,69,35,13,2,4,395
260771305,76,117,90,81,23,2,2,1,392
260771306,86,120,117,75,34,6,4,1,443
260771307,63,112,72,56,29,11,4,4,351
260771308,56,57,101,106,39,15,2,2,378
260771309,50,88,107,125,58,15,1,5,449
260771310,45,77,56,32,19,10,1,1,241
260771311,47,76,80,63,20,2,4,1,293
260771312,39,63,57,64,29,12,3,1,268
260771313,31,44,49,44,32,8,2,2,212
260771314,19,25,32,37,12,5,0,0,130
260840101,4,1,1,0,0,0,0,0,6
260840102,25,4,2,1,1,0,0,0,33
260840103,28,6,6,0,1,1,0,0,42
260840104,4,0,0,0,0,0,0,0,4
260840105,4,0,0,1,0,0,0,0,5
260840106,9,12,7,8,3,4,0,0,43
260840107,56,56,43,34,16,6,6,1,218
260840108,43,59,65,56,31,16,6,5,281
260840201,49,12,5,1,1,0,0,0,68
260840202,14,11,19,6,7,3,2,0,62
260840301,5,3,2,1,1,0,0,0,12
260840302,4,3,1,1,0,0,0,0,9
260840303,8,1,1,0,1,0,0,0,11
260840304,29,8,1,1,0,0,0,0,39
260840305,79,90,90,93,61,28,11,14,466
260840306,78,70,43,38,21,13,2,5,270
260840307,17,11,31,26,13,2,3,0,103
260840401,9,6,4,2,0,0,0,0,21
260840402,24,5,0,0,0,0,0,0,29
260840403,17,11,15,9,6,5,2,0,65
260840501,4,4,1,1,0,0,0,0,10
260840502,9,4,1,4,0,0,0,0,18
260840503,12,3,2,2,2,1,0,0,22
260840504,10,5,2,1,4,2,0,0,24
260840505,29,11,8,9,7,3,1,2,70
260840506,9,16,7,10,5,3,0,3,53
260910101,19,4,2,0,0,0,0,0,25
260910102,8,7,6,8,2,1,0,2,34
260910201,10,9,5,2,0,1,0,0,27
260910301,4,2,0,1,0,0,0,0,7
260910302,5,3,0,0,1,0,0,0,9
260910303,26,7,3,0,0,0,0,0,36
260910304,38,20,19,11,8,5,0,1,102
260910305,2,2,0,0,0,0,0,0,4
260910306,2,1,0,0,0,0,0,0,3
260910401,36,36,58,39,18,20,3,2,212
260910402,14,27,38,29,20,14,4,6,152
260910403,9,21,19,38,12,12,1,2,114
260910404,46,44,41,54,33,35,15,15,283
260910405,24,37,71,81,54,37,10,7,321
260910406,23,32,33,26,19,11,1,8,153
260910407,41,43,45,22,14,11,1,3,180
260910408,39,49,34,30,16,5,1,2,176
260910409,66,80,57,47,26,10,6,2,294
260910410,66,73,60,36,21,11,3,3,273
260910411,39,41,32,32,17,10,4,1,176
260910412,47,40,48,37,27,13,7,2,221
260910413,23,37,54,58,31,13,8,8,232
260910414,30,41,41,60,28,13,11,4,228
260980101,12,3,0,0,0,0,0,0,15
260980102,16,7,3,1,0,0,0,0,27
260980103,43,49,59,36,26,12,3,6,234
260980104,64,63,52,48,25,10,5,8,275
260980201,16,3,1,0,0,0,0,0,20
260980202,14,5,3,2,0,0,0,0,24
260980203,11,5,0,2,0,1,0,0,19
260980204,0,0,0,0,0,0,0,0,0
260980205,96,90,93,77,40,24,8,4,432
260980206,79,78,65,47,24,12,3,9,317
260980301,0,0,0,0,0,0,0,0,0
260980302,0,1,0,0,0,0,0,0,1
260980303,8,0,1,1,0,1,0,0,11
260980304,16,1,3,1,1,0,0,0,22
260980305,19,13,10,2,4,5,1,2,56
260980306,73,70,82,51,24,20,12,8,340
261050101,13,6,4,1,2,1,1,0,28
261050102,8,2,2,1,1,0,0,0,14
261050103,31,7,6,4,1,0,0,0,49
261050104,19,5,0,1,0,1,0,0,26
261050105,59,56,34,30,15,7,2,2,205
261050201,16,8,2,1,0,0,0,0,27
261050202,3,4,2,0,0,1,0,0,10
261050203,4,1,2,1,0,0,0,0,8
261050204,22,12,9,6,2,1,0,1,53
261050205,42,47,50,33,27,9,1,3,212
300080101,30,22,38,26,11,2,2,2,133
300080102,47,33,43,36,16,7,4,1,187
300080103,35,50,38,34,17,5,3,2,184
300080104,27,54,34,25,17,9,2,3,171
300080105,34,33,39,25,17,12,3,7,170
300080106,40,57,39,33,10,7,4,2,192
300080107,37,28,11,29,9,2,0,0,116
300080108,42,53,34,26,7,7,4,0,173
300080109,36,58,40,46,22,5,2,0,209
300080110,46,71,46,34,16,9,4,0,226
300080111,62,78,60,48,25,11,3,7,294
300080112,45,68,43,38,16,5,2,2,219
300080113,37,50,37,33,18,5,1,7,188
300080114,39,58,45,38,20,4,1,0,205
300080201,40,46,23,25,10,4,0,2,150
300080202,31,40,22,16,4,3,0,0,116
300080203,37,42,26,19,10,2,2,0,138
300080204,53,70,40,27,8,5,1,0,204
300080205,54,63,33,33,14,6,1,2,206
300080206,55,86,64,42,14,10,1,0,272
300080207,60,81,77,64,30,16,5,1,334
300080208,33,61,69,65,46,30,12,13,329
300080209,44,43,37,19,12,4,2,3,164
300080210,38,44,39,27,18,8,2,1,177
300080211,49,36,35,37,9,4,0,1,171
300080212,17,23,16,11,5,0,1,1,74
300080213,8,20,15,9,5,2,0,0,59
300080214,22,24,30,19,8,1,0,2,106
300080215,20,49,38,37,19,9,2,7,181
300080216,19,41,41,26,26,10,8,6,177
300080301,6,15,12,9,6,1,1,0,50
300080302,14,12,26,12,8,4,1,0,77
300080303,13,25,24,17,6,8,0,2,95
300080304,10,21,29,16,8,2,1,3,90
300080305,29,34,33,44,24,17,4,8,193
300080306,30,37,56,63,35,27,10,15,273
300080307,27,30,48,43,20,8,3,2,181
300080308,35,63,58,58,23,11,9,3,260
300080309,14,16,18,17,9,1,2,2,79
300080310,33,46,35,62,22,14,2,4,218
300080311,30,50,49,50,23,19,9,9,239
300080312,23,34,40,57,28,9,4,7,202
300080313,14,26,40,41,26,15,9,14,185
300080314,14,29,25,20,8,4,1,1,102
300080315,21,35,23,18,10,7,3,1,118
300080316,7,10,3,2,3,2,1,0,28
300080317,7,19,16,7,5,2,3,1,60
300080318,7,19,12,10,4,3,0,0,55
300080319,12,16,9,7,4,6,0,0,54
300080401,27,28,39,34,23,10,0,5,166
300080402,54,82,73,80,33,21,8,11,362
300080403,83,70,72,49,23,14,7,8,326
300080404,53,82,70,51,38,16,11,5,326
300080405,59,64,69,70,43,22,6,5,338
300080406,90,96,56,65,44,22,3,6,382
300080407,24,34,31,36,16,11,2,4,158
300080408,43,80,42,46,22,9,4,1,247
300080409,74,89,58,38,17,6,1,1,284
300080410,59,78,72,78,21,15,5,3,331
300080411,40,61,70,48,31,19,1,3,273
300080412,68,119,81,71,55,16,7,9,426
300080413,36,46,35,35,18,5,0,1,176
300080501,9,10,3,13,5,1,0,0,41
300080502,8,25,8,15,7,5,0,1,69
300080503,8,21,24,11,7,2,1,1,75
300080504,29,33,25,27,14,15,9,4,156
300080505,8,8,14,9,10,2,2,2,55
300080506,61,65,61,61,41,26,12,25,352
300080507,51,65,60,61,47,26,9,17,336
300080508,52,62,61,64,49,37,14,12,351
300080509,24,44,32,37,20,12,4,2,175
300080510,35,47,44,42,17,9,4,1,199
300080511,13,13,15,16,9,4,0,0,70
300080601,51,87,55,56,26,11,3,3,292
300080602,53,81,77,73,42,20,2,5,353
300080603,26,45,46,41,11,12,3,2,186
300080604,55,92,49,64,22,8,2,3,295
300080605,58,109,80,70,39,6,3,2,367
300080606,95,101,64,46,16,6,2,4,334
300080607,73,100,61,41,20,8,1,0,304
300080608,62,101,84,73,33,12,2,2,369
300080609,48,58,34,21,16,3,2,0,182
300080610,45,70,48,33,16,7,3,3,225
300080611,87,97,68,46,24,14,3,1,340
300080612,63,54,67,50,16,9,3,3,265
300080701,0,3,2,1,1,0,0,0,7
300080702,4,12,4,4,3,3,0,1,31
300080703,14,25,23,15,12,7,0,1,97
300080704,0,2,2,3,1,1,1,0,10
300080705,8,17,11,10,6,3,1,2,58
300080706,1,5,4,4,1,0,1,0,16
300080707,8,9,9,6,2,2,0,0,36
300080708,6,7,2,3,1,1,0,0,20
300080709,4,7,6,2,2,2,0,0,23
300080710,1,6,4,4,4,3,0,0,22
300080711,1,40,4,11,8,1,0,2,67
300080801,4,3,4,2,3,1,0,0,17
300080802,2,3,1,2,3,0,1,0,12
300080803,2,2,3,2,1,0,0,0,10
300080804,4,13,3,9,3,2,1,1,36
300080805,6,3,4,6,1,3,0,1,24
300080806,3,6,2,2,2,1,0,0,16
300080807,18,26,10,11,14,6,1,4,90
300080808,3,12,10,13,4,4,1,0,47
300080809,1,4,4,2,3,1,0,0,15
300080810,7,12,10,10,4,2,0,0,45
300080811,8,10,12,3,2,0,2,0,37
300080901,2,6,7,3,2,2,0,1,23
300080902,2,12,3,4,2,0,0,0,23
300080903,3,3,7,4,3,0,0,0,20
300080904,0,0,3,2,2,0,1,0,8
300080905,4,9,6,6,3,1,0,1,30
300080906,24,17,11,12,2,2,1,1,70
300080907,4,3,2,3,1,1,0,0,14
300080908,1,1,2,1,0,0,0,0,5
300080909,8,4,5,5,6,2,1,0,31
300080910,45,67,41,34,19,7,4,7,224
300081001,3,6,8,8,1,1,0,0,27
300081002,4,9,3,5,2,0,0,0,23
300081003,37,51,31,24,19,7,1,1,171
300081004,1,5,5,4,1,1,0,0,17
300081005,10,8,6,4,1,1,1,4,35
300081006,1,8,3,3,1,0,0,0,16
300081007,22,43,29,8,13,6,8,5,134
300081008,7,5,6,2,0,1,1,0,22
300081009,4,2,2,1,0,1,0,0,10
300081101,8,10,8,4,2,0,1,1,34
300081102,5,3,2,4,4,2,1,2,23
300081103,9,5,0,4,1,3,1,4,27
300081104,2,4,6,1,0,1,0,2,16
300081105,7,10,6,9,5,0,1,1,39
300081106,1,0,1,1,0,1,0,0,4
300081107,4,10,5,3,1,0,0,0,23
300081108,26,40,58,51,27,10,4,8,224
300081109,22,22,29,23,8,6,2,0,112
300081110,52,80,81,68,59,43,16,18,417
300081111,16,20,19,26,29,11,5,8,134
300081201,1,0,0,0,0,0,0,0,1
300150101,31,68,84,82,54,43,10,16,388
300150102,30,47,64,64,56,54,18,16,349
300150103,31,58,80,97,91,65,29,58,509
300150104,37,62,85,99,45,47,36,47,458
300150105,29,35,74,67,43,36,15,30,329
300150106,27,58,68,78,75,45,32,24,407
300150107,33,50,59,68,57,36,12,31,346
300150108,18,50,67,53,40,24,12,22,286
300150109,33,57,66,50,43,22,7,14,292
300150110,14,24,38,46,26,18,16,15,197
300150111,52,66,102,81,65,68,23,28,485
300150112,29,47,62,66,55,45,18,24,346
300150113,45,49,111,91,51,40,16,22,425
300150201,35,59,92,97,63,38,9,18,411
300150202,25,63,52,51,44,19,6,11,271
300150203,15,53,53,57,48,22,10,16,274
300150204,28,55,62,53,52,29,26,32,337
300150205,52,76,91,85,69,53,22,29,477
300150206,34,78,87,56,48,20,5,9,337
300150207,36,39,45,37,20,12,3,3,195
300150208,57,69,78,59,42,22,14,8,349
300150209,61,82,95,76,45,35,14,8,416
300150210,34,71,87,83,55,43,30,19,422
300150211,43,62,72,64,39,26,8,20,334
300150212,52,75,86,72,59,31,13,13,401
300150213,58,98,85,66,46,29,10,14,406
300150214,62,54,39,33,24,16,2,6,236
300150301,33,76,66,44,36,13,7,6,281
300150302,57,89,86,65,35,16,6,0,354
300150303,63,89,112,80,39,27,7,7,424
300150304,41,87,89,72,33,19,5,3,349
300150305,41,48,79,79,56,35,16,26,380
300150306,7,11,11,12,8,2,0,1,52
300150307,22,24,23,21,12,3,1,0,106
300150308,45,81,96,83,43,20,10,10,388
300150309,37,45,59,77,47,36,10,21,332
300150310,25,48,39,54,35,14,7,6,228
300150401,65,53,51,45,33,27,5,8,287
300150402,36,62,36,29,18,5,1,2,189
300150403,62,86,76,57,27,13,4,9,334
300150404,59,63,74,56,31,15,8,3,309
300150405,43,71,65,54,36,25,10,18,322
300150406,56,94,80,88,40,13,7,8,386
300150407,46,74,74,56,36,27,7,8,328
300150408,30,49,72,80,44,15,9,13,312
300150409,18,35,66,58,34,15,7,7,240
300150410,35,57,63,73,47,24,9,10,318
300150411,32,66,94,115,48,40,14,32,441
300150412,40,62,82,89,62,41,17,19,412
300150413,47,103,92,98,47,18,9,8,422
300150414,61,97,53,31,13,8,0,0,263
300150415,17,36,33,14,12,3,2,2,119
300150416,114,130,80,59,32,13,8,5,441
300150501,51,55,31,25,15,6,1,1,185
300150502,82,110,99,61,28,8,3,2,393
300150503,45,61,37,38,19,5,5,5,215
300150504,43,49,39,45,14,9,3,4,206
300150505,22,30,35,37,24,16,7,14,185
300150506,30,73,58,52,27,19,2,6,267
300150507,27,36,59,53,42,25,8,6,256
300150508,30,51,43,46,34,25,11,9,249
300150509,35,62,53,52,34,25,6,9,276
300150510,32,46,36,42,15,10,3,4,188
300150511,30,48,45,33,18,9,2,3,188
300150512,33,45,39,28,10,1,2,1,159
300150513,39,51,24,35,12,5,0,0,166
300150514,40,49,29,21,5,0,1,1,146
300150515,66,68,44,28,5,8,1,1,221
300150516,54,59,27,21,15,6,2,1,185
300150517,68,65,33,25,11,6,0,0,208
300150518,25,56,29,21,10,4,1,3,149
300150519,45,74,40,24,10,1,2,1,197
300150520,53,48,38,35,25,14,6,4,223
300150521,18,25,32,18,9,6,2,3,113
300150522,52,68,79,73,50,27,15,20,384
300150601,40,45,54,80,45,38,21,29,352
300150602,38,28,39,36,29,15,7,14,206
300150603,45,77,90,93,64,49,21,35,474
300150604,56,86,95,69,55,25,17,15,418
300150605,27,42,31,30,10,5,2,3,150
300150606,40,63,61,37,31,18,6,8,264
300150607,70,85,79,61,23,13,4,5,340
300150608,61,74,47,36,17,5,3,2,245
300150609,65,75,45,42,18,6,0,3,254
300150610,58,76,35,40,15,5,0,1,230
300150611,43,54,43,15,9,6,1,0,171
300150612,37,63,41,33,15,5,1,1,196
300150613,63,88,71,61,28,30,11,5,357
300150614,69,116,110,72,48,24,6,4,449
300150615,44,57,54,36,22,6,1,8,228
300150616,52,83,59,47,32,12,7,9,301
300150617,51,53,62,59,28,9,1,5,268
300150618,26,38,31,17,7,1,0,4,124
300150619,51,56,52,31,16,4,2,1,213
300150620,31,32,25,11,8,3,1,1,112
300150621,65,39,16,7,4,4,1,0,136
300150701,30,53,69,44,41,17,8,7,269
300150702,34,45,33,28,13,11,5,0,169
300150703,59,56,36,25,11,7,1,0,195
300150704,43,47,31,20,10,2,1,0,154
300150705,48,38,30,18,9,3,0,0,146
300150706,40,41,21,9,6,1,0,0,118
300150707,49,50,31,20,14,4,0,0,168
300150708,37,56,39,28,10,4,0,0,174
300150709,30,37,41,35,22,8,2,4,179
300150710,28,29,63,52,31,21,14,18,256
300150711,33,52,44,49,29,11,4,7,229
300150712,26,26,47,35,41,29,17,26,247
300150713,26,48,47,45,15,8,3,5,197
300150714,37,54,35,33,14,7,1,1,182
300150715,21,39,31,41,23,13,11,4,183
300150716,31,51,50,53,31,35,12,21,284
300150717,0,2,2,3,3,1,3,3,17
300150718,64,72,65,74,51,39,19,37,421
300150719,51,51,68,74,43,49,24,27,387
300150720,17,19,22,21,16,7,15,14,131
300150801,50,56,24,18,6,3,2,2,161
300150802,60,37,17,16,6,5,1,0,142
300150803,50,39,20,16,6,0,1,0,132
300150804,50,52,20,18,7,2,0,0,149
300150805,43,54,29,36,13,5,1,0,181
300150806,28,45,45,43,20,9,6,4,200
300150807,86,84,74,62,33,13,2,5,359
300150808,62,55,43,37,12,4,3,1,217
300150809,43,41,39,36,11,5,1,1,177
300150810,54,52,46,38,17,7,4,2,220
300150811,48,52,48,40,18,13,1,1,221
300150812,41,59,34,38,13,11,1,1,198
300150813,2,0,2,0,0,1,0,0,5
300150814,69,75,71,61,37,14,12,16,355
300150815,15,21,26,12,6,6,4,3,93
300150901,7,18,14,15,15,4,1,6,80
300150902,9,18,14,16,13,12,3,6,91
300150903,4,5,6,1,4,2,0,1,23
300150904,35,46,59,50,29,24,7,12,262
300150905,34,59,56,64,45,31,12,15,316
300150906,45,43,57,61,47,29,18,18,318
300150907,30,42,60,58,38,32,19,19,298
300150908,21,38,68,70,47,29,12,18,303
300150909,19,35,37,23,17,9,1,1,142
300150910,13,27,36,24,12,8,3,1,124
300150911,1,3,3,5,1,1,0,0,14
300151001,26,39,28,31,23,26,8,6,187
300151002,29,75,97,104,53,30,9,13,410
300151003,15,28,40,43,29,17,2,9,183
300151004,56,83,107,111,53,33,16,13,472
300151005,46,78,78,80,38,42,13,19,394
300151006,43,46,56,55,38,30,15,20,303
300151007,33,69,66,61,36,17,11,14,307
300151008,25,49,68,68,57,30,22,16,335
300151009,23,56,91,89,65,46,23,23,416
300151010,26,63,76,79,36,9,3,5,297
300151011,45,50,78,78,52,50,18,27,398
300151012,39,33,80,80,57,69,34,49,441
300151013,29,37,50,70,41,38,7,23,295
300151101,26,39,62,49,35,12,8,7,238
300151102,2,1,1,4,0,0,2,1,11
300151103,39,35,63,50,28,7,2,0,224
300151104,22,38,48,29,24,12,4,4,181
300151105,42,52,73,83,42,27,17,13,349
300151106,33,50,42,42,18,13,1,6,205
300151107,12,28,41,47,25,25,14,11,203
300151108,16,30,43,54,34,25,13,19,234
300151109,8,11,16,9,6,2,1,1,54
300151110,48,53,50,41,25,14,2,4,237
300151111,29,34,46,31,17,8,7,5,177
300151201,12,11,9,11,3,9,1,3,59
300151202,8,5,6,7,4,1,1,1,33
300151203,8,10,10,9,4,1,0,0,42
300151204,7,8,5,5,5,5,2,5,42
300151205,3,3,3,3,0,0,0,0,12
300151206,6,5,7,6,2,0,3,0,29
300151207,5,4,2,1,2,2,0,0,16
300151208,14,7,13,7,10,3,3,8,65
300151209,8,2,3,4,5,0,1,0,23
300151210,12,14,12,6,0,3,0,1,48
300151211,8,6,13,14,9,2,3,3,58
300151212,34,45,53,59,35,22,12,15,275
300151213,40,52,82,63,31,16,6,10,300
300151214,29,69,72,57,40,16,7,6,296
300151301,18,20,23,23,13,6,1,6,110
300151302,5,3,9,1,2,0,0,0,20
300151303,6,5,3,0,2,1,0,0,17
300151304,31,45,73,66,37,30,13,11,306
300151305,13,21,31,23,24,10,12,6,140
300151306,7,9,8,10,5,1,2,2,44
300151307,11,5,14,13,3,3,1,0,50
300151308,1,10,7,3,6,4,1,2,34
300151309,6,0,3,3,3,0,0,0,15
300151310,32,43,42,40,27,18,8,14,224
300151311,41,44,61,40,38,15,10,6,255
300151312,29,42,43,22,23,21,9,4,193
300151401,3,2,2,1,2,1,0,0,11
300151402,1,3,2,1,1,1,0,0,9
300151403,14,16,5,11,5,6,0,1,58
300151404,10,11,9,6,9,7,1,6,59
300151405,2,8,3,4,1,1,1,2,22
300151406,7,5,9,2,2,4,0,1,30
300151407,10,2,11,2,3,2,2,0,32
300151408,17,13,14,10,12,4,5,7,82
300151501,10,13,10,10,8,2,2,2,57
300151502,12,10,13,8,5,4,1,1,54
300151503,1,1,1,0,1,1,0,1,6
300151504,9,9,13,16,8,3,0,2,60
300151505,14,11,12,8,8,1,0,3,57
300151506,13,20,14,9,3,4,1,4,68
300151507,10,11,14,9,3,3,3,3,56
300151508,7,6,7,10,7,4,1,1,43
300151509,13,9,5,3,3,1,0,0,34
300151510,26,31,26,32,19,15,4,8,161
300151511,32,44,40,43,34,26,8,9,236
300151512,13,17,22,13,4,5,3,1,78
300151513,17,16,10,17,15,9,2,1,87
300151514,13,19,20,21,10,11,4,4,102
300151515,10,23,21,19,15,4,3,4,99
300151601,1,4,2,3,1,0,0,0,11
300151602,9,11,6,7,7,5,1,5,51
300151603,5,2,4,6,3,2,0,2,24
300151604,3,4,2,4,1,0,0,0,14
300151605,4,7,9,1,3,0,0,1,25
300151606,24,22,30,23,13,4,10,5,131
300151607,20,19,26,29,10,16,3,11,134
300210101,47,61,49,57,27,14,2,4,261
300210102,45,60,71,52,36,16,6,5,291
300210103,10,8,9,8,7,2,0,0,44
300210104,60,79,71,54,27,13,2,7,313
300210105,39,69,49,34,22,3,0,1,217
300210106,79,74,46,44,18,10,1,0,272
300210107,51,64,54,51,28,22,6,7,283
300210108,36,60,73,61,44,35,25,17,351
300210109,40,50,28,34,17,8,3,0,180
300210110,49,34,34,18,9,6,0,0,150
300210111,37,57,34,30,8,4,2,0,172
300210112,35,41,39,43,23,13,8,4,206
300210201,44,45,40,39,27,8,3,1,207
300210202,35,47,26,21,11,4,1,1,146
300210203,40,56,61,57,31,8,2,6,261
300210204,8,7,5,2,2,4,0,0,28
300210205,10,20,20,29,22,19,3,4,127
300210206,13,12,22,21,16,5,3,1,93
300210207,18,35,33,40,30,16,2,10,184
300210208,29,41,34,29,18,15,2,0,168
300210209,13,29,36,26,11,13,3,3,134
300210210,65,73,57,55,32,12,2,1,297
300210211,39,55,51,48,31,12,6,6,248
300210212,49,65,74,78,47,23,7,15,358
300210301,13,9,12,6,10,7,1,1,59
300210302,23,20,21,24,16,7,3,1,115
300210303,39,52,36,25,8,7,1,2,170
300210304,30,33,24,30,17,6,3,1,144
300210305,12,28,36,29,17,9,3,6,140
300210306,11,12,6,4,4,1,0,1,39
300210307,13,13,6,12,7,2,1,1,55
300210308,13,17,16,20,10,11,3,3,93
300210309,16,28,31,33,21,17,7,7,160
300210310,13,15,28,13,9,4,4,3,89
300210311,15,18,7,6,6,3,2,1,58
300210312,10,15,7,5,3,1,0,0,41
300210401,23,47,25,33,8,7,1,0,144
300210402,2,4,4,4,0,1,0,0,15
300210403,12,12,11,21,15,4,2,2,79
300210404,8,14,12,8,5,3,0,1,51
300210405,18,39,34,49,15,6,1,1,163
300210406,16,24,24,26,15,3,2,3,113
300210407,2,2,2,2,1,0,0,0,9
300210408,7,3,3,4,3,1,0,0,21
300210409,8,16,12,11,9,1,1,1,59
300210410,20,20,22,16,13,7,4,3,105
300210501,14,24,12,11,3,3,2,1,70
300210502,15,15,9,21,5,5,2,2,74
300210503,4,9,3,6,1,3,3,2,31
300210504,7,15,17,11,5,4,0,2,61
300210505,53,72,61,53,20,7,0,0,266
300210506,49,62,47,56,27,7,1,2,251
300210507,26,44,39,59,21,10,2,3,204
300210508,6,8,4,2,6,0,0,1,27
300210509,1,2,1,1,0,0,1,0,6
300210510,6,14,10,7,4,2,0,0,43
300210511,6,8,7,16,6,1,1,1,46
300210512,29,42,27,40,17,9,1,1,166
300210601,13,17,11,7,7,4,1,0,60
300210602,6,13,8,19,8,1,2,0,57
300210603,7,8,10,7,5,2,1,1,41
300210604,26,32,43,31,12,10,5,2,161
300210605,3,11,8,12,5,0,1,0,40
300210606,3,5,5,3,2,1,0,2,21
300210701,1,2,1,2,1,2,1,0,10
300210702,1,7,3,3,3,0,0,0,17
300210703,1,0,1,0,0,0,0,0,2
300210704,4,9,5,7,5,3,0,0,33
300210705,7,5,3,1,0,0,0,0,16
300210706,23,74,32,33,9,2,0,0,173
300210707,21,40,30,35,12,3,2,0,143
300210708,31,64,46,38,21,13,4,1,218
300210709,68,87,45,33,15,12,2,0,262
300210710,54,102,64,28,16,3,1,0,268
300210711,5,4,5,8,2,0,0,0,24
300210712,48,58,32,38,15,5,3,0,199
300210713,24,60,20,21,3,2,0,2,132
300210714,52,102,49,31,10,4,0,0,248
300210715,99,75,40,28,16,3,0,1,262
300210716,41,74,41,34,16,6,1,1,214
300210801,1,4,5,1,1,2,0,0,14
300210802,0,12,10,4,3,1,0,0,30
300210803,2,9,4,6,4,2,1,0,28
300210804,14,27,24,24,13,6,1,1,110
300210805,0,5,4,8,1,1,0,1,20
300210806,3,6,7,6,4,0,1,0,27
300210807,10,9,3,5,5,2,0,0,34
300210808,2,2,0,3,5,0,1,1,14
300210809,2,5,6,9,2,3,1,4,32
300210901,5,12,18,19,7,7,2,1,71
300210902,15,29,32,19,1,4,1,2,103
300210903,54,64,44,42,15,6,1,2,228
300210904,31,46,31,16,9,5,2,1,141
300210905,91,90,91,65,36,15,7,7,402
300210906,6,28,19,20,15,7,1,2,98
300210907,44,71,45,41,20,10,6,0,237
300210908,43,66,30,24,20,4,1,0,188
300210909,35,62,52,33,17,3,2,1,205
300210910,28,49,50,35,13,11,1,1,188
300210911,23,65,45,33,28,12,4,6,216
300211001,4,6,5,9,2,2,1,0,29
300211002,25,36,28,31,21,7,5,0,153
300211003,8,25,17,19,9,2,2,0,82
300211004,36,52,40,33,15,9,4,1,190
300211005,10,26,25,29,14,3,3,2,112
300211006,31,48,39,33,26,6,4,7,194
300211007,42,66,56,37,24,6,2,0,233
300211101,4,8,9,7,5,3,1,1,38
300211102,4,11,7,5,6,1,0,0,34
300211103,5,9,2,7,4,1,0,0,28
300211104,4,2,4,3,4,2,0,0,19
300211105,3,4,3,4,1,1,0,0,16
300211201,1,0,2,1,1,0,0,0,5
300211202,0,0,3,0,1,0,0,0,4
300211203,2,3,4,6,4,1,2,1,23
300211204,6,12,11,6,3,1,2,1,42
300211205,5,6,5,4,0,1,0,0,21
300211206,7,10,4,3,2,1,1,3,31
300211207,5,5,3,3,3,2,2,0,23
300211208,2,9,4,13,5,4,0,2,39
300211209,7,7,3,5,3,4,1,2,32
300211210,37,42,42,31,20,9,8,7,196
300211211,2,4,0,4,0,2,1,0,13
300211212,2,8,8,10,7,1,1,1,38
300211301,11,9,6,3,2,1,0,0,32
300211302,5,1,2,4,0,0,0,0,12
300280101,11,46,11,11,7,0,0,0,86
300280102,32,55,68,66,51,33,11,7,323
300280103,45,65,45,26,16,13,6,3,219
300280104,43,57,33,26,12,7,1,0,179
300280105,53,83,70,70,44,22,13,11,366
300280106,17,45,47,66,50,39,14,27,305
300280107,36,52,56,51,30,19,4,8,256
300280108,32,65,50,26,16,15,0,4,208
300280109,26,48,36,34,18,4,2,2,170
300280110,36,56,66,64,43,26,14,20,325
300280111,30,36,37,32,12,5,0,4,156
300280112,25,43,54,37,22,8,4,4,197
300280113,15,18,20,17,27,11,7,6,121
300280114,9,5,14,9,5,3,2,2,49
300280201,5,18,17,10,5,1,1,0,57
300280202,3,7,12,13,3,3,0,1,42
300280203,15,25,43,46,42,46,13,20,250
300280204,50,40,61,57,64,45,22,27,366
300280205,28,46,70,60,46,36,21,27,334
300280206,20,49,50,55,36,32,12,20,274
300280301,11,12,8,6,2,4,0,1,44
300280302,3,0,2,1,1,0,0,0,7
300280303,7,12,23,20,7,4,4,2,79
300280304,0,4,0,3,0,0,0,0,7
300280305,2,3,8,5,3,1,0,0,22
300280306,12,11,8,11,5,3,0,3,53
300280307,1,0,0,1,0,0,1,0,3
300280308,2,7,2,1,0,0,0,0,12
300280401,23,23,32,34,15,8,9,4,148
300280402,29,48,64,64,24,17,8,3,257
300280403,33,65,81,54,51,30,14,8,336
300280404,23,30,50,61,31,18,9,2,224
300280405,26,34,47,38,33,16,6,9,209
300280406,28,63,61,62,41,14,5,5,279
300280407,26,36,32,35,34,19,6,12,200
300280408,37,52,57,43,34,19,3,7,252
300280409,30,35,30,29,26,6,1,3,160
300280410,38,53,78,44,29,16,7,6,271
300280411,44,46,49,41,14,14,4,3,215
300280412,39,64,54,38,24,9,1,4,233
300280413,41,51,46,32,18,8,1,2,199
300280414,31,46,32,37,23,12,9,5,195
300280415,35,44,46,31,30,14,4,3,207
300280416,46,67,61,63,23,11,5,7,283
300280417,44,46,47,54,22,13,2,5,233
300280418,28,69,59,47,28,19,6,9,265
300280419,28,43,61,62,37,19,16,15,281
300280501,18,35,40,61,37,26,16,12,245
300280502,34,46,79,59,37,15,7,9,286
300280503,36,54,54,55,34,20,11,13,277
300280504,28,27,45,40,33,18,11,17,219
300280505,44,50,66,61,42,26,14,28,331
300280506,15,27,40,25,10,11,2,2,132
300280507,39,67,40,53,32,17,11,8,267
300280508,53,41,31,35,14,2,1,1,178
300280509,70,73,47,29,11,4,0,1,235
300280510,45,53,37,24,11,1,1,0,172
300280511,49,57,48,34,20,11,2,1,222
300280512,52,78,77,59,32,18,3,4,323
300280513,16,41,45,31,15,4,2,2,156
300280514,43,79,63,63,24,10,4,7,293
300280515,54,53,45,32,16,6,0,1,207
300280516,40,39,24,24,10,3,1,1,142
300280517,56,82,67,60,29,11,7,4,316
300280518,29,71,72,50,30,23,10,8,293
300280519,36,48,56,55,29,16,2,9,251
300280601,11,20,18,12,8,7,2,5,83
300280602,7,13,9,20,8,4,3,0,64
300280603,27,27,27,38,25,24,6,10,184
300280604,7,6,6,5,11,2,3,2,42
300280605,11,20,22,17,16,8,3,1,98
300280606,14,15,24,20,8,8,10,10,109
300280607,10,26,25,31,10,10,4,2,118
300280608,20,32,49,39,30,18,10,9,207
300280609,23,39,47,52,27,7,8,4,207
300280610,3,5,5,2,2,6,2,0,25
300280611,5,13,10,11,8,7,2,3,59
300280701,0,1,1,0,0,0,0,0,2
300280702,0,0,0,1,1,1,0,0,3
300280703,4,6,0,2,1,0,0,0,13
300280704,5,8,10,5,2,1,0,1,32
300280705,0,1,1,0,0,1,0,0,3
300280706,3,2,2,1,4,0,0,0,12
300280707,1,3,1,3,0,0,0,0,8
300280708,10,20,12,14,12,10,5,18,101
300280709,31,69,53,37,31,19,7,13,260
300280710,45,72,71,66,41,21,10,16,342
300280711,33,46,51,44,19,16,6,5,220
300280712,26,35,33,26,30,22,12,16,200
300280801,1,8,8,9,2,6,5,1,40
300280802,3,13,6,5,8,2,0,0,37
300280803,5,5,20,14,9,4,1,2,60
300280804,0,0,0,3,0,0,0,0,3
300280805,17,18,15,14,8,4,1,2,79
300280806,5,12,11,13,6,3,0,0,50
300280807,0,5,8,7,3,0,1,0,24
300280808,9,9,18,14,5,6,4,2,67
300280809,31,45,60,68,45,27,9,22,307
300280810,23,43,40,45,24,8,1,2,186
300280811,28,33,30,35,7,12,2,3,150
300280812,16,27,30,24,9,9,4,4,123
300280901,9,14,6,14,8,3,3,3,60
300280902,2,2,2,5,0,2,1,2,16
300280903,15,10,9,14,7,6,4,2,67
300280904,2,15,14,13,4,4,1,1,54
300280905,1,5,7,8,7,3,0,0,31
300280906,3,10,6,3,3,5,1,0,31
300280907,32,35,49,54,27,22,10,8,237
300281001,2,0,4,0,1,0,1,1,9
300281002,7,5,7,0,3,1,0,0,23
300281003,3,2,2,0,0,0,0,0,7
300281004,2,1,2,0,0,1,0,0,6
300281005,6,16,2,2,8,1,0,0,35
300281006,0,2,1,1,0,2,0,0,6
300281007,1,3,3,1,1,0,0,0,9
300281008,6,19,14,16,12,13,3,3,86
300281101,2,0,5,4,7,1,0,0,19
300281102,0,0,1,0,1,0,0,0,2
300281103,10,8,4,3,7,0,0,0,32
300281104,4,6,6,9,5,1,3,3,37
300281105,3,3,3,2,0,0,1,0,12
300281106,4,3,2,0,1,1,0,0,11
300281107,28,32,31,34,25,16,5,9,180
300281108,16,32,30,25,19,14,2,5,143
300281201,4,9,6,9,9,6,5,1,49
300281202,1,0,0,1,0,0,0,0,2
300281203,4,5,4,8,4,5,0,0,30
300281204,10,12,18,9,10,1,1,1,62
300281205,3,8,7,4,2,3,2,0,29
300281206,5,3,13,5,7,1,2,1,37
300281207,4,13,8,12,11,8,0,3,59
300281208,27,43,44,36,28,21,8,7,214
300281209,0,4,4,3,0,2,1,1,15
300281210,11,16,17,27,13,6,1,0,91
300281211,4,6,12,9,13,3,1,4,52
300281212,6,13,14,17,5,2,2,3,62
300281213,13,5,7,6,1,3,1,0,36
300281214,8,11,11,8,4,3,1,0,46
300281215,15,34,17,26,14,6,3,3,118
300281301,4,5,5,0,0,2,0,0,16
300281302,4,3,0,0,3,1,1,0,12
300281303,5,7,11,16,11,5,3,4,62
300281304,5,6,4,6,4,0,1,1,27
300281305,0,1,2,1,4,0,0,0,8
300281306,3,9,4,7,5,3,0,0,31
300281307,8,11,11,11,8,4,1,3,57
300281308,1,2,3,2,2,0,0,0,10
300281309,15,20,19,19,19,10,5,1,108
300281310,1,3,3,3,0,2,0,0,12
300350101,25,32,35,37,25,14,15,20,203
300350102,29,34,45,41,28,18,8,10,213
300350103,25,39,31,33,22,4,3,5,162
300350104,48,67,75,76,54,33,19,17,389
300350105,43,45,57,69,34,21,15,13,297
300350106,34,31,40,51,31,25,17,15,244
300350107,55,62,59,48,26,8,7,7,272
300350108,35,41,38,41,28,4,3,1,191
300350109,23,34,21,23,19,9,2,3,134
300350110,29,32,42,44,32,19,11,10,219
300350111,20,28,34,21,17,13,4,3,140
300350112,42,54,61,60,39,21,7,10,294
300350113,66,78,64,39,20,5,1,2,275
300350114,24,43,40,32,29,9,5,7,189
300350115,25,51,47,34,29,13,4,13,216
300350116,45,51,70,75,33,20,17,7,318
300350117,53,74,72,44,32,23,3,8,309
300350118,36,42,54,40,25,23,7,9,236
300350119,24,31,40,36,33,23,16,22,225
300350201,5,3,4,4,3,2,4,4,29
300350202,6,10,9,6,3,6,3,1,44
300350203,8,15,12,6,8,3,3,1,56
300350204,24,37,20,31,18,22,9,13,174
300350205,3,5,10,3,6,5,0,4,36
300350206,5,11,19,20,8,7,5,5,80
300350301,1,0,1,0,0,0,0,2,4
300350302,0,1,0,1,1,1,1,0,5
300350303,2,1,3,1,1,0,1,0,9
300350304,1,3,3,1,3,1,0,0,12
300350305,3,0,2,0,0,0,0,0,5
300350401,7,3,6,4,4,1,0,0,25
300350402,3,2,1,1,1,0,0,0,8
300350403,6,5,5,6,8,4,1,1,36
300350404,3,1,0,0,0,0,0,0,4
300350405,3,5,5,2,2,2,1,1,21
300350406,3,2,3,2,5,0,0,0,15
300350407,3,7,9,2,4,0,0,1,26
300350408,5,10,9,5,3,2,0,0,34
300350409,14,12,8,5,3,3,0,0,45
300350410,2,2,1,1,1,1,0,0,8
300350411,1,3,0,6,0,0,2,0,12
300350412,3,1,0,0,1,1,0,0,6
300350413,3,0,0,0,0,0,0,0,3
300350414,18,14,12,11,20,13,4,5,97
300350501,7,8,5,2,2,1,0,1,26
300350502,4,0,4,2,3,1,1,1,16
300350503,1,1,0,2,0,0,0,0,4
300350504,7,9,8,5,1,3,0,0,33
300350505,2,4,3,3,1,0,0,0,13
300350506,1,2,4,4,1,2,0,0,14
300350507,6,20,20,8,5,5,0,2,66
300350601,2,2,0,0,0,1,0,0,5
300350602,1,1,3,1,0,1,0,0,7
300350603,5,4,4,2,2,1,1,1,20
300350604,1,4,2,0,0,1,0,1,9
300350605,7,7,6,3,1,1,0,0,25
300350606,5,2,5,3,0,2,0,0,17
300350701,11,12,6,8,3,2,5,6,53
300350702,8,4,7,4,2,3,2,0,30
300350703,4,4,4,5,1,1,0,0,19
300350704,7,2,7,4,1,0,1,0,22
300350705,10,7,2,3,2,0,0,0,24
300350706,8,8,8,6,4,1,1,1,37
300350801,10,6,2,3,4,0,1,0,26
300350802,1,12,4,8,7,5,1,1,39
300350803,8,7,4,5,3,0,0,1,28
300350804,7,1,10,11,5,4,0,3,41
300350805,7,2,3,6,7,1,0,1,27
300350901,8,5,5,1,3,0,1,1,24
300350902,9,9,8,4,1,3,0,0,34
300350903,0,6,3,0,1,0,0,0,10
300350904,1,0,2,2,0,0,0,0,5
300350905,6,6,11,1,4,0,0,1,29
300350906,3,1,0,2,2,1,1,0,10
300350907,2,0,1,2,1,0,2,0,8
300351001,0,0,0,1,0,0,0,0,1
300351002,2,0,0,0,1,1,0,0,4
300351003,6,6,7,4,1,3,1,0,28
300351004,3,3,2,3,0,1,1,0,13
300351005,11,19,21,14,5,6,3,7,86
300351006,12,16,27,21,5,3,4,4,92
300351007,32,34,43,38,28,14,6,5,200
300351101,7,6,2,2,0,1,0,0,18
300351102,5,11,6,9,3,3,0,0,37
300351103,67,66,74,61,42,23,5,14,352
300351104,41,49,46,31,15,3,4,6,195
300351105,35,41,46,42,17,16,5,5,207
300351106,24,29,36,23,11,6,4,1,134
300420101,27,40,40,43,34,15,12,13,224
300420102,31,25,52,47,28,26,14,28,251
300420103,28,48,27,37,27,21,11,15,214
300420104,59,56,51,51,33,15,7,12,284
300420105,28,45,39,34,30,10,4,8,198
300420106,34,60,65,44,17,23,15,12,270
300420107,46,58,53,44,20,14,8,8,251
300420108,18,27,31,34,28,18,12,16,184
300420109,15,24,26,21,17,11,5,12,131
300420110,35,31,48,46,23,13,9,17,222
300420111,26,32,48,41,33,25,11,20,236
300420112,17,29,30,38,25,22,9,14,184
300420201,9,9,9,13,7,5,1,4,57
300420202,10,15,17,9,4,4,2,7,68
300420203,7,5,10,8,5,3,2,4,44
300420204,20,14,25,27,16,13,7,12,134
300420205,9,17,17,19,10,10,8,9,99
300420206,15,18,13,9,14,11,4,8,92
300420301,5,4,2,3,4,2,3,2,25
300420302,9,12,7,12,8,7,1,7,63
300420303,15,13,10,10,10,2,4,8,72
300420304,1,0,2,1,2,1,0,0,7
300420305,7,8,16,11,5,1,1,0,49
300420401,3,3,3,3,1,0,0,2,15
300420402,6,4,4,5,4,2,0,0,25
300420403,0,4,2,2,2,3,0,0,13
300420404,9,9,10,6,9,3,0,3,49
300420405,4,2,1,0,0,1,0,0,8
300420406,5,6,3,5,3,3,0,0,25
300420501,5,2,4,2,3,1,0,0,17
300420502,2,2,1,0,3,1,1,2,12
300420503,18,11,24,14,14,9,4,13,107
300420504,7,9,5,6,6,1,2,5,41
300420601,0,2,0,1,1,1,0,0,5
300420602,7,4,5,3,5,4,0,0,28
300420603,5,5,10,4,3,2,0,4,33
300420604,6,3,5,6,4,4,0,6,34
300420605,0,3,3,4,4,1,1,0,16
300420701,6,6,3,4,1,0,0,0,20
300420702,1,4,5,3,0,2,0,0,15
300420703,10,9,8,4,3,5,1,2,42
300420704,15,10,20,12,10,7,5,6,85
300490101,12,18,17,21,16,3,3,1,91
300490102,56,70,105,93,57,26,8,13,428
300490103,36,48,65,54,35,9,3,2,252
300490104,16,44,32,30,15,10,4,4,155
300490105,57,78,91,48,26,10,2,1,313
300490106,63,79,83,62,31,8,0,2,328
300490107,39,72,67,77,22,17,1,6,301
300490108,72,63,73,56,22,15,1,3,305
300490109,31,51,36,15,10,4,0,2,149
300490110,45,59,29,34,15,3,1,2,188
300490111,55,68,52,55,28,7,0,2,267
300490112,27,43,58,37,22,5,2,6,200
300490113,28,28,47,30,19,3,0,0,155
300490114,29,38,32,30,8,4,4,0,145
300490201,44,57,58,48,18,7,4,6,242
300490202,43,91,70,75,44,25,8,7,363
300490203,27,42,38,44,33,13,6,7,210
300490204,43,52,33,32,12,4,2,2,180
300490205,26,69,36,39,15,7,5,2,199
300490206,26,46,40,38,22,12,7,3,194
300490207,35,41,36,27,3,1,4,3,150
300490208,49,63,36,31,11,5,1,0,196
300490209,35,65,59,36,16,10,2,4,227
300490210,55,62,70,57,42,30,11,13,340
300490211,53,82,54,43,15,12,3,1,263
300490212,36,45,27,17,3,1,1,0,130
300490213,55,69,63,21,15,4,2,1,230
300490214,51,50,35,23,5,2,1,0,167
300490215,33,31,26,26,9,6,0,0,131
300490216,15,20,31,25,12,10,7,3,123
300490217,15,18,11,26,7,4,1,2,84
300490218,51,69,54,38,38,12,4,3,269
300490219,95,75,47,30,13,7,1,1,269
300490220,63,80,54,47,30,16,6,5,301
300490221,27,32,42,48,34,30,11,13,237
300490222,32,47,38,33,26,17,13,16,222
300490301,76,114,84,56,32,13,5,9,389
300490302,47,62,36,30,11,7,2,0,195
300490303,42,40,26,21,9,3,0,0,141
300490304,39,57,34,33,15,3,0,0,181
300490305,51,75,56,32,13,4,2,1,234
300490306,51,63,60,55,34,17,10,6,296
300490307,36,47,46,56,32,23,10,8,258
300490308,52,68,74,62,38,27,13,15,349
300490309,51,71,83,71,48,32,13,17,386
300490310,32,57,56,99,61,40,17,23,385
300490311,15,22,38,32,21,14,6,5,153
300490312,25,42,41,54,39,23,10,25,259
300490401,17,38,31,23,10,7,6,4,136
300490402,15,24,23,21,5,8,3,1,100
300490403,12,16,19,14,10,10,2,7,90
300490404,3,2,2,5,1,2,0,2,17
300490405,5,1,6,4,2,3,0,0,21
300490406,2,1,2,1,1,0,0,0,7
300490407,23,21,25,23,6,2,7,0,107
300490408,8,10,10,9,4,0,1,0,42
300490409,13,35,33,30,11,8,1,4,135
300490410,2,2,0,0,0,0,0,0,4
300490411,22,38,31,31,29,7,5,3,166
300490412,44,70,82,63,48,27,7,16,357
300490413,36,53,56,65,49,33,15,13,320
300490414,25,42,50,54,29,24,1,6,231
300490415,10,26,53,47,31,23,9,11,210
300490416,0,0,3,0,0,0,0,0,3
300490417,14,17,16,11,12,6,3,10,89
300490501,2,7,3,4,3,4,0,0,23
300490502,0,4,4,2,3,0,1,1,15
300490503,5,9,4,7,3,5,2,2,37
300490504,3,8,0,2,1,1,0,0,15
300490505,4,6,5,5,2,0,0,0,22
300490506,2,4,5,3,2,1,0,2,19
300490507,9,6,5,3,3,1,0,0,27
300490508,7,6,7,4,8,2,0,0,34
300490509,9,10,6,6,0,3,0,1,35
300490510,4,12,3,6,6,2,2,2,37
300490511,13,34,21,18,13,9,6,4,118
300490512,3,14,11,12,3,2,0,4,49
300490513,2,3,7,3,0,1,0,0,16
300490601,6,9,4,2,4,1,1,0,27
300490602,5,8,6,6,1,0,0,0,26
300490603,4,8,6,4,0,1,0,1,24
300490604,7,2,2,3,2,0,0,0,16
300490605,5,9,8,4,3,1,0,1,31
300490606,4,7,7,1,1,2,0,0,22
300490607,2,6,1,1,0,0,0,0,10
300490608,0,0,0,2,0,0,1,0,3
300490609,8,10,6,7,2,4,0,0,37
300490610,3,2,5,2,3,0,0,0,15
300490611,27,18,27,17,11,5,6,3,114
300490701,2,7,2,2,2,1,1,0,17
300490702,6,14,15,10,5,2,1,3,56
300490703,3,5,5,3,2,1,0,0,19
300490704,1,4,0,0,2,0,0,0,7
300490705,2,6,2,0,0,0,1,0,11
300490706,6,11,7,9,2,4,0,0,39
300490707,3,9,2,3,2,1,0,0,20
300490708,5,10,8,4,4,1,0,0,32
300490709,1,6,1,5,0,1,0,0,14
300490710,3,1,4,1,1,1,0,0,11
300490711,1,5,1,5,2,1,0,0,15
300490712,2,6,4,0,0,0,0,0,12
300490801,4,1,1,0,0,0,0,0,6
300490802,10,3,2,4,4,3,1,1,28
300490803,12,3,2,1,3,2,0,1,24
300490804,7,5,6,4,1,3,1,0,27
300490805,12,5,4,4,2,0,0,1,28
300490806,9,10,9,9,3,5,0,1,46
300490807,5,0,3,1,1,0,0,0,10
300490901,11,9,4,2,2,2,0,1,31
300490902,33,24,5,3,5,3,2,2,77
300491001,0,1,0,0,0,0,0,0,1
300491002,2,1,1,1,5,0,0,0,10
300491003,1,7,3,5,1,1,1,1,20
300491004,3,5,5,4,1,0,0,0,18
300491005,19,11,16,14,9,5,2,3,79
300491006,56,64,34,21,19,5,0,0,199
300491007,56,74,56,70,29,10,5,5,305
300491008,37,36,46,38,12,13,2,0,184
300491009,24,33,38,25,14,5,1,0,140
300491010,64,77,63,64,25,16,6,7,322
300491011,42,62,69,56,38,21,10,10,308
300560101,41,54,70,69,39,18,6,2,299
300560102,13,34,46,68,43,23,10,12,249
300560103,31,68,71,103,36,31,13,11,364
300560104,61,72,67,61,32,13,1,2,309
300560105,70,95,71,60,40,17,5,15,373
300560106,59,80,79,72,32,20,9,14,365
300560107,46,75,91,81,51,20,6,9,379
300560108,48,75,90,73,40,14,1,1,342
300560109,38,58,64,48,17,10,3,5,243
300560110,70,90,90,65,39,16,9,3,382
300560111,61,97,69,71,30,13,1,2,344
300560112,33,56,31,24,8,3,0,0,155
300560113,46,66,31,29,9,4,0,0,185
300560114,53,70,42,39,19,3,2,0,228
300560115,67,115,92,67,39,10,6,4,400
300560116,67,93,71,68,24,12,3,2,340
300560117,59,85,58,44,24,13,6,1,290
300560118,27,35,23,19,9,1,0,0,114
300560119,37,63,35,37,16,5,1,0,194
300560120,67,74,31,29,20,5,1,0,227
300560121,50,48,31,28,7,6,0,0,170
300560122,58,58,58,30,14,7,1,1,227
300560201,31,61,65,72,33,8,3,1,274
300560202,24,40,57,53,31,12,2,7,226
300560203,40,55,78,84,48,34,14,23,376
300560204,20,32,25,39,15,15,2,5,153
300560205,40,51,66,90,65,30,20,20,382
300560206,49,64,78,76,41,38,20,15,381
300560207,38,61,54,44,26,6,3,3,235
300560208,28,46,45,45,17,10,5,5,201
300560209,33,39,46,42,27,14,0,2,203
300560210,33,57,47,42,12,2,3,1,197
300560211,33,39,27,19,17,7,0,0,142
300560212,44,66,44,31,12,3,0,1,201
300560213,54,57,44,35,20,3,0,1,214
300560214,44,68,46,39,19,13,3,2,234
300560215,55,64,43,30,19,13,0,3,227
300560216,47,67,53,57,28,26,6,8,292
300560217,34,49,60,40,25,15,4,4,231
300560218,43,56,41,27,11,7,1,1,187
300560219,44,53,24,27,14,5,2,0,169
300560220,84,78,40,43,16,3,3,0,267
300560221,48,52,34,27,10,4,1,1,177
300560301,31,20,11,10,4,0,0,0,76
300560302,53,29,22,9,6,0,0,0,119
300560303,83,68,52,32,13,4,3,0,255
300560304,64,59,27,25,6,0,0,0,181
300560305,31,40,17,27,8,4,0,1,128
300560306,45,59,31,30,7,4,1,2,179
300560307,60,53,44,37,14,3,3,0,214
300560308,57,69,64,48,28,6,5,2,279
300560309,43,58,37,17,11,6,2,1,175
300560310,73,74,49,31,12,4,0,0,243
300560311,56,47,34,25,17,4,1,1,185
300560312,32,60,43,44,25,11,5,1,221
300560313,55,68,67,66,41,23,10,13,343
300560314,49,58,57,54,28,20,1,5,272
300560315,24,21,27,21,13,8,2,2,118
300560316,35,55,49,40,20,3,6,2,210
300560317,59,76,62,70,33,19,8,5,332
300560318,37,67,68,75,34,34,7,8,330
300560319,16,16,35,19,20,10,2,7,125
300560401,39,64,48,34,13,13,0,3,214
300560402,46,43,43,34,16,6,3,1,192
300560403,33,38,38,16,12,5,0,0,142
300560404,39,63,26,19,10,2,0,1,160
300560405,76,107,64,29,28,9,4,1,318
300560406,60,70,49,32,23,5,1,1,241
300560407,44,69,63,46,27,11,11,1,272
300560408,45,60,72,75,47,23,6,5,333
300560409,60,81,67,63,43,14,4,4,336
300560410,28,89,89,81,52,16,4,0,359
300560411,40,59,64,53,34,27,5,5,287
300560412,23,35,54,56,45,28,17,14,272
300560413,18,49,47,49,41,21,7,13,245
300560414,33,41,74,89,77,45,13,14,386
300560415,39,52,63,52,46,25,15,14,306
300560416,35,35,38,42,25,14,8,6,203
300560417,33,62,55,69,31,18,6,9,283
300560418,21,33,62,68,42,14,6,11,257
300560501,17,36,33,30,16,5,4,0,141
300560502,14,33,30,37,29,4,3,1,151
300560503,18,32,32,29,16,7,5,6,145
300560504,43,92,73,51,31,21,5,1,317
300560505,21,22,39,50,27,19,7,10,195
300560506,21,31,44,36,16,9,1,0,158
300560507,34,50,54,41,33,9,7,2,230
300560508,23,36,49,57,38,13,3,9,228
300560509,23,45,46,36,21,12,8,7,198
300560510,25,55,60,51,30,12,11,5,249
300560511,53,72,68,51,34,18,1,2,299
300560512,33,38,39,39,22,12,1,2,186
300560513,52,73,60,69,30,9,7,5,305
300560601,13,11,10,12,8,2,4,2,62
300560602,12,26,31,28,14,4,1,4,120
300560603,4,6,4,7,0,2,0,0,23
300560604,3,13,13,8,6,0,0,3,46
300560605,23,51,64,79,56,57,23,18,371
300560606,33,70,67,77,37,18,5,5,312
300560607,10,22,36,27,13,10,0,1,119
300560608,28,43,72,110,60,22,8,6,349
300560609,7,4,7,2,2,1,0,0,23
300560610,19,45,32,41,28,19,7,7,198
300560611,13,18,5,13,12,4,0,2,67
300560612,4,5,6,3,0,0,0,1,19
300560701,42,62,86,89,55,27,10,18,389
300560702,44,60,80,80,38,23,6,11,342
300560703,11,25,15,7,4,5,1,1,69
300560704,10,7,5,7,2,1,0,1,33
300560705,15,17,15,14,10,9,2,5,87
300560706,36,53,55,64,33,20,3,8,272
300560707,6,10,16,11,7,2,1,0,53
300560801,3,3,3,3,2,0,1,1,16
300560802,3,3,1,4,0,0,1,0,12
300560803,1,0,0,0,0,0,0,0,1
300560804,8,12,6,7,4,6,1,0,44
300560805,6,1,2,3,2,0,0,0,14
300560806,1,2,3,4,0,1,0,0,11
300560807,1,2,2,0,0,1,0,0,6
300560808,14,11,16,7,3,1,2,0,54
300560809,12,10,3,2,0,0,0,0,27
300560810,9,12,11,10,8,2,2,3,57
300560811,38,32,31,28,11,10,0,2,152
300560812,22,23,16,8,10,14,2,5,100
300560901,2,5,4,4,0,3,0,1,19
300560902,18,12,6,3,3,0,1,1,44
300560903,1,2,1,3,0,0,0,0,7
300560904,4,3,3,0,1,1,0,0,12
300560905,1,4,1,2,0,0,0,0,8
300560906,4,9,7,2,1,0,0,0,23
300560907,7,12,11,7,4,1,0,0,42
300560908,6,9,16,8,8,1,1,0,49
300560909,6,8,8,5,5,2,2,0,36
300560910,3,2,2,2,3,1,1,1,15
300560911,18,25,27,17,19,10,1,1,118
300560912,1,2,1,3,1,0,1,0,9
300560913,5,5,1,2,2,0,0,0,15
300560914,2,1,2,0,1,0,0,0,6
300560915,16,50,29,23,21,7,0,1,147
300560916,39,57,54,39,13,7,2,2,213
300561001,9,9,12,6,1,3,1,3,44
300561002,1,0,2,2,0,0,0,0,5
300561003,9,10,7,7,3,3,2,2,43
300561004,17,22,7,12,7,3,1,1,70
300561005,7,6,9,7,3,2,2,1,37
300561006,1,2,0,1,0,0,1,0,5
300561007,3,4,4,1,2,0,0,0,14
300561008,6,4,4,5,1,3,0,0,23
300561009,15,21,18,9,6,4,0,2,75
300561010,6,5,2,4,1,1,0,0,19
300561011,12,14,9,8,4,2,3,0,52
300561101,2,2,0,0,1,0,0,0,5
300561102,4,7,3,3,0,0,0,0,17
300561103,5,4,0,5,1,2,0,0,17
300561104,3,4,1,4,0,2,0,0,14
300561105,2,6,3,4,0,0,0,0,15
300561106,7,6,3,4,0,0,0,0,20
300561107,5,5,4,3,1,1,0,1,20
300561108,1,6,0,0,0,0,0,0,7
300561109,3,4,5,5,1,0,1,0,19
300561110,10,2,3,3,1,0,0,0,19
300561111,23,32,27,9,12,3,1,1,108
300561201,16,23,12,8,7,4,1,1,72
300561202,10,14,7,8,7,2,1,0,49
300561203,9,10,2,4,0,0,0,0,25
300561204,14,14,2,6,4,1,1,0,42
300561205,13,9,8,7,6,2,1,0,46
300561206,14,19,8,4,4,1,2,1,53
300561207,7,8,7,8,6,3,0,0,39
300561208,8,9,6,10,5,2,1,0,41
300561209,2,3,3,7,1,0,0,0,16
300561301,1,4,1,0,1,0,0,0,7
300561302,10,13,9,3,8,1,1,3,48
300561303,8,8,2,2,0,3,0,0,23
300561304,4,5,1,0,0,1,0,0,11
300561305,4,0,4,1,0,2,0,1,12
300561306,7,14,9,9,7,2,1,2,51
300561307,2,4,6,3,2,0,0,1,18
300561308,10,6,6,4,2,1,1,0,30
300561309,3,2,1,1,1,0,0,0,8
300561310,7,7,4,1,3,1,0,1,24
300561401,8,13,13,11,4,0,0,0,49
300561402,3,0,4,2,0,0,0,1,10
300561403,11,3,2,0,0,1,0,0,17
300561404,1,5,6,3,0,0,0,0,15
300561405,3,5,3,5,2,0,0,0,18
300561406,32,58,48,36,25,10,7,9,225
300561501,37,47,22,30,15,11,4,10,176
300561502,27,35,38,41,31,13,10,11,206
300561503,51,43,34,37,35,6,11,7,224
300561504,43,45,46,32,18,9,6,3,202
300561505,44,51,24,17,9,2,1,1,149
300561506,43,61,45,37,16,7,4,3,216
300561507,48,74,76,49,20,8,3,1,279
300561508,41,53,28,29,8,1,1,0,161
300561509,73,84,43,27,20,7,1,0,255
300561510,26,30,16,17,13,5,1,1,109
300561511,33,58,58,64,32,11,1,4,261
300561512,54,67,60,34,17,7,2,1,242
300561513,61,83,61,36,26,12,4,1,284
300561601,6,14,10,11,10,8,4,2,65
300561602,14,10,11,6,4,2,0,1,48
300561603,0,1,0,0,0,0,0,0,1
300561604,22,37,34,20,15,1,1,2,132
300561605,3,8,3,2,0,1,0,0,17
300561701,4,7,6,3,1,0,0,0,21
300561702,10,14,16,9,9,4,1,2,65
300561703,17,28,35,38,18,13,4,6,159
300561704,49,70,56,48,21,12,5,1,262
300561705,42,49,44,55,37,8,6,5,246
300561706,21,26,37,20,19,6,3,2,134
300561707,24,34,45,48,41,13,5,11,221
300561708,20,41,32,42,25,5,4,6,175
300561709,34,44,28,30,20,6,2,2,166
300561710,26,29,29,30,20,10,5,5,154
300561711,29,42,36,36,22,3,5,0,173
300561712,23,31,52,36,23,4,2,3,174
300561801,8,13,6,2,4,0,0,0,33
300561802,2,1,3,2,3,2,0,0,13
300561803,0,1,3,2,2,0,0,0,8
300561804,7,10,3,4,3,1,0,1,29
300561805,9,7,7,2,0,0,0,0,25
300561806,9,6,1,3,1,1,0,0,21
300561807,3,4,3,5,2,0,0,0,17
300561808,20,10,8,11,11,5,0,0,65
300561809,18,23,13,12,4,3,3,1,77
300561810,29,39,32,23,20,9,4,2,158
300561811,33,39,43,37,16,9,3,4,184
300561812,29,38,31,17,11,2,0,2,130
300561813,13,31,13,23,7,7,0,0,94
300561814,11,28,23,16,12,1,0,0,91
300561815,11,4,4,1,1,0,0,0,21
300630101,7,11,2,3,4,1,1,1,30
300630102,10,6,2,2,0,3,0,0,23
300630103,21,17,24,19,9,4,3,3,100
300630104,10,12,9,6,4,2,0,0,43
300630105,8,7,7,4,4,0,0,3,33
300630106,4,3,0,1,2,1,0,0,11
300630107,10,9,10,11,3,2,2,3,50
300630108,10,12,3,8,5,2,1,0,41
300630109,2,1,0,0,2,0,0,1,6
300630110,30,53,62,48,41,15,7,9,265
300630111,31,51,49,43,31,16,7,15,243
300630201,13,2,9,4,5,2,1,1,37
300630202,4,7,0,2,3,0,0,1,17
300630203,19,8,10,6,9,6,3,5,66
300630204,45,38,46,56,38,19,16,16,274
300630205,43,47,58,68,54,36,11,10,327
300630206,54,61,59,53,31,17,8,10,293
300630207,43,43,44,48,32,26,15,23,274
300630301,29,7,4,1,1,1,0,0,43
300630302,5,1,3,3,3,1,0,1,17
300630303,8,4,7,4,2,2,0,1,28
300630304,52,24,28,32,19,11,5,8,179
300630401,3,0,0,0,0,0,0,0,3
300630402,1,0,0,0,0,0,0,0,1
300630403,2,3,1,0,0,0,0,0,6
300630404,1,1,0,1,1,0,1,0,5
300630405,5,2,2,1,1,2,1,0,14
300630406,9,12,8,4,7,5,2,3,50
300630407,4,2,2,3,2,0,1,0,14
300630408,3,6,2,3,0,2,0,0,16
300630409,5,2,4,1,1,0,0,1,14
300630410,1,0,0,0,0,0,0,0,1
300630411,3,0,0,0,0,0,0,0,3
300630412,16,37,28,37,25,20,5,13,181
300630413,39,33,52,47,38,30,7,13,259
300630501,10,4,3,1,4,1,0,0,23
300630502,8,7,8,4,4,8,0,0,39
300630503,2,2,0,1,2,0,1,0,8
300630504,4,6,8,8,2,2,1,2,33
300630505,20,18,14,13,4,3,3,1,76
300630506,0,2,2,2,1,0,0,0,7
300630507,7,5,3,3,6,2,3,2,31
300630508,38,28,22,14,10,10,2,4,128
300630509,9,19,9,6,7,2,0,1,53
300630510,2,0,5,2,0,1,0,0,10
300630511,4,3,2,4,1,0,0,0,14
300630512,19,11,4,10,3,3,1,0,51
300630513,2,0,1,1,0,0,0,0,4
300630514,0,0,0,0,1,0,0,0,1
300700101,20,37,19,13,9,4,3,3,108
300700102,39,57,30,16,11,4,4,2,163
300700103,28,30,39,26,10,4,4,6,147
300700104,22,39,35,23,17,14,13,19,182
300700105,41,32,37,28,15,12,6,13,184
300700106,46,43,42,43,29,28,14,20,265
300700107,51,59,37,29,14,12,6,0,208
300700108,46,67,45,44,20,11,8,3,244
300700109,61,81,41,28,20,14,4,8,257
300700110,42,37,31,30,23,8,9,11,191
300700111,48,52,42,33,15,17,5,10,222
300700112,37,48,28,35,11,11,4,2,176
300700113,52,72,71,43,26,17,4,12,297
300700114,68,69,61,56,45,23,17,33,372
300700115,58,77,62,57,24,20,7,12,317
300700201,34,43,47,58,39,24,14,13,272
300700202,21,36,34,39,23,18,10,19,200
300700203,25,35,40,39,43,27,16,25,250
300700204,25,22,42,51,26,22,11,20,219
300700205,17,16,26,38,22,19,10,11,159
300700206,29,40,50,40,35,30,9,31,264
300700207,19,26,22,32,15,16,5,3,138
300700208,17,23,26,21,17,22,6,17,149
300700209,12,33,32,34,30,33,18,19,211
300700210,21,29,42,39,27,27,17,19,221
300700301,1,0,2,1,1,0,0,0,5
300700302,5,14,9,15,7,5,3,2,60
300700303,28,49,56,43,30,12,9,11,238
300700304,39,60,46,39,28,18,1,8,239
300700305,12,27,19,17,10,6,6,10,107
300700306,13,17,10,13,10,3,1,1,68
300700307,7,13,10,3,6,3,4,6,52
300700308,32,58,60,45,19,21,9,2,246
300700309,8,28,28,27,23,4,4,0,122
300700310,41,72,46,44,33,23,10,17,286
300700311,14,26,25,36,28,10,4,8,151
300700312,12,17,10,8,8,4,8,7,74
300700313,9,4,5,3,5,1,1,1,29
300700314,1,3,4,0,0,0,1,0,9
300700401,7,3,13,9,4,9,3,6,54
300700402,2,8,7,5,4,3,2,4,35
300700403,2,1,1,1,0,0,0,0,5
300700404,4,2,6,2,0,1,0,0,15
300700405,5,6,4,3,0,1,3,3,25
300700406,17,12,15,18,9,10,1,6,88
300700407,4,5,6,15,2,1,5,5,43
300700408,5,16,14,9,7,9,2,6,68
300700409,3,5,6,7,2,4,2,2,31
300700410,1,2,0,0,0,0,0,0,3
300700411,6,9,8,11,6,3,4,2,49
300700412,2,2,2,4,1,1,1,1,14
300700413,7,5,10,3,3,4,2,1,35
300700414,4,7,11,4,2,2,1,6,37
300700415,7,10,16,14,5,2,5,1,60
300700416,5,1,1,3,3,5,2,1,21
300700501,10,15,8,4,2,0,0,0,39
300700502,6,9,3,6,3,3,1,1,32
300700503,6,4,4,6,9,3,3,2,37
300700504,1,5,0,1,1,0,1,1,10
300700505,2,16,10,10,1,5,1,1,46
300700506,5,13,8,6,6,1,2,1,42
300700507,9,7,6,5,7,0,1,4,39
300700508,1,3,1,1,0,1,0,0,7
300700509,7,7,5,5,1,2,1,1,29
300700510,15,26,28,25,16,8,7,7,132
300700511,23,32,36,32,35,18,8,18,202
300700601,3,2,0,2,0,1,0,0,8
300700602,0,3,1,2,3,2,0,0,11
300700603,2,3,2,1,1,0,0,1,10
300700604,3,1,5,4,3,2,2,1,21
300700605,2,2,0,0,0,0,1,0,5
300700606,0,0,0,2,2,2,0,0,6
300700607,3,2,5,4,1,3,0,1,19
300700608,11,14,4,8,9,9,3,9,67
300700609,5,4,4,5,2,1,2,2,25
300700701,10,11,11,10,7,0,5,3,57
300700702,3,4,5,4,2,1,0,3,22
300700703,6,7,12,8,4,2,3,7,49
300700704,2,6,5,2,2,1,0,2,20
300700705,4,8,8,7,2,1,1,0,31
300700706,10,5,15,7,4,4,1,0,46
300700801,0,2,2,1,2,3,0,3,13
300700802,3,0,3,0,2,1,0,2,11
300700803,1,10,3,5,4,1,1,1,26
300700804,3,3,2,2,3,3,0,0,16
300700805,5,4,4,2,1,0,0,0,16
300700806,4,3,5,4,2,2,0,1,21
300700807,0,5,8,1,1,0,1,0,16
300700808,3,2,4,1,1,0,0,0,11
300700809,0,4,6,5,1,1,0,0,17
300700810,26,24,28,13,21,7,5,9,133
300700901,5,5,11,5,3,0,3,1,33
300700902,1,1,3,0,1,3,1,0,10
300700903,9,18,10,12,9,6,4,0,68
300700904,10,4,1,4,6,2,0,1,28
300700905,2,3,5,5,5,2,0,1,23
300700906,0,2,1,0,1,0,1,0,5
300700907,10,12,16,8,9,3,5,0,63
300700908,9,6,8,5,1,1,0,1,31
300700909,13,14,10,15,10,9,3,3,77
300701001,0,1,0,0,0,0,0,0,1
300701002,4,1,2,2,0,1,0,1,11
300701003,20,22,9,27,14,8,5,6,111
300701004,13,27,29,26,28,24,13,36,196
300701005,31,34,28,28,32,13,18,26,210
300701006,21,23,27,24,16,11,4,4,130
300701007,32,40,40,24,10,5,5,3,159
300701008,40,73,56,61,35,16,16,13,310
300701009,31,49,53,50,34,24,14,20,275
300701010,63,80,73,53,31,13,6,10,329
300701011,37,43,43,27,22,11,5,4,192
300701101,42,47,46,25,16,8,3,6,193
300701102,37,35,37,21,10,7,7,7,161
300701103,41,52,42,36,21,14,6,8,220
300701104,54,56,47,55,37,25,14,32,320
300701105,27,37,28,29,19,11,14,17,182
300701106,63,90,75,58,29,18,8,17,358
300701107,21,37,44,40,25,24,14,19,224
300701108,27,43,54,47,27,11,4,5,218
300701109,16,31,44,40,32,23,12,16,214
300701110,27,48,61,75,48,35,24,25,343
300701111,33,55,67,51,41,35,18,31,331
300701112,12,9,13,14,9,8,10,14,89
300701201,21,22,9,11,6,6,3,5,83
300701202,8,2,4,2,3,0,1,1,21
300701203,4,2,5,2,1,3,2,1,20
300701204,10,15,15,13,5,4,1,5,68
300701205,3,8,4,7,1,2,0,0,25
300701206,7,4,5,7,2,0,2,1,28
300701207,9,9,6,8,4,1,0,2,39
300701208,2,6,5,4,4,4,0,0,25
300701209,1,8,9,5,6,2,2,1,34
300701210,6,0,4,8,1,2,0,0,21
300701211,0,0,0,0,0,0,0,0,0
300701212,12,19,20,14,10,5,1,1,82
300701213,45,60,59,55,48,21,14,8,310
300701301,7,20,16,20,13,3,2,3,84
300701302,17,21,14,15,16,5,2,3,93
300701303,5,2,6,4,3,5,1,0,26
300701304,9,4,11,12,4,5,0,0,45
300701305,4,3,3,1,0,0,0,1,12
300701306,2,7,2,2,2,1,1,1,18
300701307,4,3,6,4,2,1,1,1,22
300701308,12,5,18,10,2,10,1,0,58
300701309,25,30,28,36,21,21,13,11,185
300701310,33,25,18,19,12,3,3,2,115
300701311,34,24,31,35,21,14,13,3,175
300701312,22,25,45,22,16,11,11,12,164
300701401,1,1,1,5,3,0,1,0,12
300701402,4,3,1,5,1,2,2,0,18
300701403,2,2,5,2,2,1,0,0,14
300701404,0,5,6,4,1,0,1,0,17
300701405,31,45,49,66,44,34,15,28,312
300701406,42,55,45,29,22,17,8,9,227
300701407,30,41,50,40,13,21,9,13,217
300701408,30,37,33,55,43,24,13,13,248
300701409,31,56,43,42,28,14,5,6,225
300701410,49,62,40,25,17,9,1,4,207
300701411,61,96,87,57,37,20,7,7,372
300701412,47,57,73,35,21,9,9,7,258
300701413,36,39,71,54,48,36,17,28,329
300701501,1,0,1,0,1,0,0,1,4
300770101,24,20,22,23,15,4,9,7,124
300770102,31,48,65,52,39,15,10,9,269
300770103,30,34,40,43,13,11,5,3,179
300770104,24,44,40,38,32,11,9,8,206
300770105,26,39,45,45,26,19,10,15,225
300770106,19,48,41,37,29,11,1,5,191
300770107,34,51,54,43,22,6,5,0,215
300770108,36,40,49,25,14,12,6,2,184
300770109,43,48,57,40,24,6,3,7,228
300770110,56,93,67,61,50,16,3,5,351
300770111,39,36,32,27,7,4,1,1,147
300770112,17,15,22,18,13,9,2,2,98
300770113,66,83,61,43,23,16,8,6,306
300770114,67,71,69,42,23,4,0,0,276
300770115,59,76,45,31,15,7,0,1,234
300770201,22,48,64,51,22,14,4,2,227
300770202,63,73,66,50,27,6,3,2,290
300770203,23,32,24,24,9,6,7,6,131
300770204,55,54,43,25,16,11,3,3,210
300770205,62,58,38,26,22,6,4,1,217
300770206,47,42,32,22,24,12,6,7,192
300770207,39,54,48,51,34,8,0,4,238
300770208,54,57,49,29,10,7,1,3,210
300770209,31,42,33,29,21,19,7,6,188
300770210,33,61,54,38,25,22,9,7,249
300770211,47,59,55,41,24,16,4,8,254
300770212,16,19,19,17,14,8,4,5,102
300770213,29,57,60,59,33,18,11,14,281
300770214,12,38,49,44,22,5,3,9,182
300770215,19,29,44,66,27,13,5,7,210
300770216,35,35,60,74,44,35,20,21,324
300770217,12,22,18,30,7,13,2,9,113
300770301,8,6,1,2,0,1,0,0,18
300770302,20,17,13,15,4,2,2,2,75
300770303,2,2,7,4,2,2,1,0,20
300770304,13,17,14,19,8,5,5,3,84
300770305,15,30,12,20,10,6,5,2,100
300770306,8,18,15,14,6,8,3,4,76
300770401,3,3,4,3,1,0,0,0,14
300770402,0,6,7,1,3,3,0,0,20
300770403,4,10,10,7,7,1,0,0,39
300770404,1,6,8,6,2,2,2,0,27
300770405,5,12,10,13,5,5,0,1,51
300770406,1,6,8,4,4,1,2,1,27
300770407,2,3,7,10,2,2,1,1,28
300770408,7,6,5,7,5,5,1,2,38
300770409,4,1,2,3,3,1,1,0,15
300770410,7,6,5,5,4,1,1,2,31
300770411,9,5,5,4,2,0,1,0,26
300770412,4,3,1,3,1,2,1,0,15
300770413,2,1,4,2,0,0,0,0,9
300770414,1,12,16,8,3,0,0,1,41
300770415,1,9,5,4,4,0,1,0,24
300770416,6,6,4,5,5,1,2,3,32
300770417,3,4,2,2,4,0,1,0,16
300770501,2,7,9,8,3,1,1,1,32
300770502,0,0,2,3,0,0,0,0,5
300770503,3,9,5,3,3,0,1,0,24
300770504,4,4,5,2,2,0,0,1,18
300770505,7,10,8,11,3,7,1,1,48
300770506,5,11,7,7,5,3,1,1,40
300770507,5,12,8,6,7,3,0,1,42
300770508,3,8,5,4,0,1,0,0,21
300770509,2,2,1,2,0,0,0,0,7
300770510,2,14,10,0,3,1,1,1,32
300770511,3,3,1,2,0,1,0,0,10
300770512,1,1,0,2,1,0,0,0,5
300770513,7,12,7,2,0,1,1,0,30
300770514,4,7,8,4,7,0,1,2,33
300770515,2,4,7,3,1,2,1,0,20
300770516,9,12,8,10,6,3,1,1,50
300770517,3,5,9,9,2,1,0,0,29
300770518,6,2,5,1,2,3,1,1,21
300770519,2,3,1,1,0,0,0,0,7
300770601,7,9,7,13,4,5,1,0,46
300770602,3,2,1,4,0,1,0,0,11
300770603,8,5,8,11,5,3,1,0,41
300770604,1,1,4,0,0,0,0,0,6
300770605,3,10,5,10,11,6,0,0,45
300770606,6,8,8,7,5,3,0,1,38
300770607,10,5,7,5,4,3,1,0,35
300770608,4,6,2,0,2,0,0,0,14
300770609,3,5,5,3,0,1,0,1,18
300770610,8,1,5,5,5,2,4,0,30
300770611,1,3,4,5,3,2,0,1,19
300770612,14,28,18,9,15,7,2,2,95
300770613,0,1,2,2,0,0,0,0,5
300770701,2,13,14,9,6,1,1,1,47
300770702,6,6,8,4,0,3,1,2,30
300770703,3,3,2,6,2,0,0,0,16
300770704,1,10,5,1,2,0,0,0,19
300770705,6,8,3,3,4,0,0,0,24
300770706,54,56,55,38,18,6,6,2,235
300770707,34,46,57,66,30,9,7,10,259
300770708,1,1,2,1,3,0,1,1,10
300770709,3,5,4,7,3,2,1,0,25
300770710,6,3,3,4,4,1,0,0,21
300770711,3,1,0,1,2,0,0,0,7
300770801,16,22,19,13,8,6,3,2,89
300770802,26,34,35,20,19,4,0,2,140
300770803,36,40,19,31,11,6,2,1,146
300770804,61,48,29,17,9,2,3,1,170
300770805,4,11,8,6,0,1,1,0,31
300770806,14,17,11,9,6,4,1,0,62
300770807,0,4,1,1,0,0,0,0,6
300770901,7,4,2,4,1,1,0,2,21
300770902,2,3,3,0,3,2,0,0,13
300770903,6,8,5,4,2,0,0,0,25
300770904,13,16,12,9,6,5,3,2,66
300770905,1,2,1,1,1,0,1,1,8
300770906,30,21,20,11,8,3,2,0,95
300770907,6,5,2,3,2,2,0,0,20
300770908,5,6,3,2,3,2,1,1,23
300771001,4,7,8,6,1,1,0,0,27
300771002,6,5,7,5,2,3,0,3,31
300771003,1,2,2,3,3,1,1,1,14
300771004,3,1,3,0,1,0,1,0,9
300771005,4,3,4,1,1,0,0,0,13
300771006,1,0,2,1,0,0,0,0,4
300771101,11,5,11,3,4,2,0,0,36
300771102,0,4,4,7,2,2,1,0,20
300771103,12,15,12,8,6,5,0,1,59
300771104,3,7,8,3,2,0,0,0,23
300771105,1,8,4,6,1,0,0,0,20
300771106,3,1,1,1,1,1,0,0,8
300771107,2,0,0,0,1,0,0,0,3
300771108,3,5,3,7,2,0,0,1,21
300771109,4,5,6,7,1,1,1,1,26
300771110,5,8,6,2,2,3,2,5,33
300771111,8,7,5,3,2,1,0,1,27
300771112,6,9,7,7,5,3,0,0,37
300771113,2,11,14,5,3,3,0,0,38
300771114,9,9,4,5,2,0,1,1,31
300771115,4,3,4,2,5,1,0,1,20
300771201,52,65,59,48,31,18,11,11,295
300771202,25,31,26,25,13,7,1,4,132
300771203,50,62,41,39,12,5,1,3,213
300771204,64,55,24,27,18,7,3,1,199
300771205,55,51,30,28,24,7,3,1,199
300771206,36,44,29,36,11,6,5,3,170
300771207,58,66,37,49,11,6,3,6,236
300771208,6,8,5,5,3,1,3,4,35
300771209,5,7,6,6,3,2,0,0,29
300771210,2,4,5,2,1,0,0,0,14
300771211,2,3,2,0,2,0,1,0,10
300771212,5,3,0,1,1,0,1,0,11
300771213,1,0,0,0,1,0,0,0,2
300840101,34,61,52,57,29,19,10,11,273
300840102,22,29,56,55,40,22,10,12,246
300840103,18,21,13,24,15,7,4,3,105
300840104,26,53,57,69,38,27,8,16,294
300840105,34,38,48,58,52,33,4,9,276
300840106,19,31,32,38,35,18,9,12,194
300840107,25,28,43,27,29,14,5,9,180
300840108,36,49,68,74,56,43,21,26,373
300840109,14,19,26,13,28,8,3,5,116
300840110,17,24,41,55,32,16,10,5,200
300840111,29,31,54,79,60,51,23,24,351
300840112,34,44,74,63,47,32,11,19,324
300840113,46,58,63,74,55,30,14,14,354
300840114,49,62,66,77,70,38,13,26,401
300840201,31,47,29,42,38,18,8,10,223
300840202,52,53,20,22,15,6,2,0,170
300840203,55,83,44,30,20,3,0,0,235
300840204,52,68,28,31,11,4,2,0,196
300840205,89,95,62,48,18,12,1,1,326
300840206,55,64,28,25,10,5,0,0,187
300840207,40,45,35,30,17,6,1,0,174
300840208,25,51,58,64,33,32,15,27,305
300840209,62,63,54,30,15,7,1,0,232
300840210,43,29,24,20,10,1,1,0,128
300840211,68,53,27,27,17,3,2,0,197
300840212,91,72,38,35,11,2,0,1,250
300840213,78,77,56,28,11,2,2,0,254
300840214,37,35,33,29,13,7,2,2,158
300840215,63,61,53,35,29,6,1,3,251
300840216,54,67,64,65,33,23,8,12,326
300840217,61,78,59,43,22,7,2,0,272
300840218,66,71,55,35,14,6,0,0,247
300840219,70,55,44,29,17,7,1,0,223
300840220,62,64,42,25,8,5,0,0,206
300840221,80,63,34,16,12,2,1,0,208
300840222,59,56,25,18,8,2,0,0,168
300840223,82,49,24,7,5,0,0,0,167
300840224,74,42,21,13,5,1,1,0,157
300840301,110,85,68,45,16,10,0,1,335
300840302,46,48,47,58,40,33,10,16,298
300840303,33,63,52,36,31,15,7,9,246
300840304,46,62,55,41,17,10,5,2,238
300840305,46,58,75,98,46,46,17,28,414
300840306,73,73,55,44,17,3,0,1,266
300840307,68,67,38,25,9,1,1,0,209
300840308,60,70,37,32,13,4,1,1,218
300840309,89,80,54,28,12,2,2,1,268
300840310,72,79,54,61,23,6,3,7,305
300840311,60,81,54,39,21,7,1,1,264
300840312,73,63,40,21,14,7,0,1,219
300840313,84,57,24,10,5,1,0,0,181
300840314,86,91,72,37,28,5,0,0,319
300840315,45,42,28,16,7,4,1,0,143
300840316,39,67,45,26,10,6,1,0,194
300840317,74,63,50,28,11,4,2,1,233
300840318,126,144,82,44,26,2,2,0,426
300840319,45,39,22,8,2,0,0,0,116
300840320,75,77,33,29,3,4,0,0,221
300840321,73,54,26,15,5,1,1,0,175
300840322,47,34,20,5,1,2,1,0,110
300840323,72,53,20,17,4,2,1,1,170
300840401,38,52,65,72,52,28,13,8,328
300840402,25,43,41,42,36,36,11,15,249
300840403,19,34,19,18,14,5,2,1,112
300840404,65,94,83,56,34,22,10,6,370
300840405,49,76,51,47,30,19,5,4,281
300840406,35,54,59,37,23,14,8,7,237
300840407,43,51,43,27,15,11,6,1,197
300840408,39,54,52,43,24,19,5,6,242
300840409,49,64,79,57,52,24,7,13,345
300840410,26,54,39,41,33,29,10,12,244
300840411,47,75,77,97,48,28,12,12,396
300840412,24,63,56,77,43,15,7,4,289
300840413,27,53,51,52,29,11,4,4,231
300840414,54,70,48,54,38,13,7,4,288
300840415,51,78,71,84,53,32,10,21,400
300840416,63,94,79,73,37,24,9,11,390
300840417,56,109,69,55,28,18,7,3,345
300840418,48,59,52,65,33,29,10,11,307
300840419,31,30,21,31,18,12,5,3,151
300840420,30,49,54,50,24,18,3,3,231
300840421,34,58,53,54,27,10,3,1,240
300840501,83,124,78,50,33,14,8,2,392
300840502,43,70,44,46,20,11,2,6,242
300840503,45,52,58,44,28,13,5,12,257
300840504,55,89,82,53,38,14,5,3,339
300840505,71,105,97,125,59,30,9,12,508
300840506,26,46,54,42,25,20,8,3,224
300840507,28,50,53,54,31,10,4,3,233
300840508,30,53,78,68,43,13,13,8,306
300840509,12,29,51,49,23,14,3,3,184
300840510,29,72,42,49,29,10,5,1,237
300840511,7,42,50,34,18,14,2,7,174
300840512,27,69,75,96,37,14,7,5,330
300840513,22,37,43,71,31,14,5,4,227
300840514,44,83,82,55,51,30,9,16,370
300840515,32,51,42,37,23,14,4,8,211
300840516,73,91,64,76,35,21,6,7,373
300840517,39,63,64,51,18,22,11,3,271
300840518,45,62,51,41,24,6,1,5,235
300840519,39,57,47,38,25,8,4,2,220
300840520,45,82,64,36,32,10,5,5,279
300840521,47,71,47,25,15,7,2,0,214
300840522,81,110,75,49,22,8,3,2,350
300840523,68,112,74,66,32,13,4,1,370
300840524,77,95,61,69,29,11,1,4,347
300840601,146,92,50,30,9,3,1,1,332
300840602,42,43,8,7,3,1,0,0,104
300840603,53,59,38,22,9,3,0,2,186
300840604,67,100,72,43,19,6,2,0,309
300840605,99,58,28,20,5,1,0,0,211
300840606,69,60,32,13,12,3,1,1,191
300840607,76,53,28,17,10,1,0,1,186
300840608,89,86,79,54,11,14,1,1,335
300840609,31,46,31,12,12,2,0,0,134
300840610,45,22,6,6,1,1,0,0,81
300840611,38,48,17,10,11,0,1,0,125
300840612,97,73,40,23,7,4,0,1,245
300840613,59,50,26,16,9,2,1,1,164
300840614,53,59,36,15,11,3,0,0,177
300840615,64,87,46,40,15,9,2,1,264
300840616,70,85,62,55,18,8,3,2,303
300840617,66,83,51,47,21,10,1,2,281
300840618,78,71,44,34,22,4,1,0,254
300840619,68,75,57,50,22,5,3,1,281
300840620,97,96,64,53,25,2,4,2,343
300840621,66,84,74,44,28,10,3,0,309
300840622,29,68,43,47,18,7,3,4,219
300840623,54,81,61,44,16,13,2,1,272
300840701,64,78,52,54,21,10,7,6,292
300840702,86,90,41,30,20,4,1,1,273
300840703,54,30,16,16,3,1,0,0,120
300840704,63,24,15,4,2,1,0,0,109
300840705,65,47,23,6,7,4,2,0,154
300840706,57,57,49,29,9,8,0,1,210
300840707,45,61,23,15,6,2,1,1,154
300840708,111,103,45,39,16,6,1,4,325
300840709,103,100,81,50,28,14,2,2,380
300840710,111,75,71,56,17,5,1,3,339
300840711,125,91,66,51,16,4,2,1,356
300840712,72,97,72,46,22,9,3,5,326
300840713,27,39,68,69,50,44,8,25,330
300840714,63,76,88,73,39,28,7,16,390
300840715,67,67,61,55,29,16,9,7,311
300840801,22,50,33,52,31,7,6,2,203
300840802,37,52,65,70,38,26,10,2,300
300840803,34,54,45,47,30,16,5,9,240
300840804,42,80,89,67,30,22,8,13,351
300840805,68,84,83,62,39,30,9,10,385
300840806,40,56,62,60,36,24,9,13,300
300840807,51,84,82,60,39,9,5,2,332
300840808,36,48,39,27,15,7,11,2,185
300840809,27,64,48,54,27,10,3,3,236
300840810,38,56,65,67,39,20,9,11,305
300840811,41,92,70,57,28,6,2,2,298
300840812,26,47,49,62,36,19,4,9,252
300840813,43,0,0,0,0,0,1,0,44
300840814,62,80,76,65,28,20,5,2,338
300840815,42,58,65,59,41,13,12,3,293
300840816,37,60,66,52,44,20,23,15,317
300840817,31,55,60,63,33,21,8,7,278
300840818,42,72,86,73,44,18,4,9,348
300840819,46,79,84,75,43,23,5,9,364
300840820,49,74,62,84,31,9,3,5,317
300840821,43,83,101,84,40,16,10,6,383
300840822,38,66,77,92,42,25,4,4,348
300840823,35,38,32,34,25,13,5,2,184
300840901,77,96,65,42,20,7,4,2,313
300840902,68,77,59,43,27,7,3,2,286
300840903,38,30,25,26,11,7,0,0,137
300840904,72,83,64,52,20,12,0,0,303
300840905,32,34,38,26,17,6,1,1,155
300840906,43,68,46,36,26,15,2,1,237
300840907,76,104,104,71,38,24,4,14,435
300840908,17,38,25,27,15,5,1,3,131
300840909,63,96,52,55,29,21,5,7,328
300840910,54,68,52,38,17,10,3,4,246
300840911,49,64,87,69,41,14,6,2,332
300840912,48,61,67,45,24,15,4,6,270
300840913,69,81,87,55,41,18,7,8,366
300840914,44,73,61,60,34,19,6,6,303
300840915,22,34,26,17,18,11,4,2,134
300840916,22,48,62,65,38,27,5,3,270
300840917,62,83,74,75,33,14,7,13,361
300841001,61,66,63,54,21,10,4,1,280
300841002,38,53,50,55,29,22,10,10,267
300841003,34,53,72,48,30,17,6,3,263
300841004,34,61,43,19,13,6,1,4,181
300841005,44,64,46,27,21,5,3,2,212
300841006,41,67,43,39,18,5,1,2,216
300841007,64,59,47,51,24,8,3,2,258
300841008,58,72,64,59,34,12,3,2,304
300841009,36,79,67,64,41,26,5,3,321
300841010,39,64,49,36,27,7,0,0,222
300841011,62,76,58,57,29,8,5,2,297
300841012,36,70,47,35,23,18,6,4,239
300841013,24,59,55,53,34,9,4,5,243
300841014,37,62,83,91,46,19,5,8,351
300841015,27,56,69,84,41,28,10,4,319
300841016,47,58,38,33,14,10,4,3,207
300841017,48,64,66,83,40,14,5,5,325
300841018,26,51,60,79,49,19,13,16,313
300841019,21,42,35,35,22,3,0,2,160
300841020,30,64,81,81,52,28,9,7,352
300841021,37,53,66,85,33,17,0,1,292
300841101,23,33,16,26,2,3,3,2,108
300841102,30,56,44,46,38,15,6,6,241
300841103,31,46,63,69,41,36,10,19,315
300841104,12,38,38,57,32,30,13,24,244
300841105,17,25,21,22,17,14,1,4,121
300841106,24,63,64,54,41,32,21,21,320
300841107,58,88,86,74,42,17,2,9,376
300841108,42,53,64,41,27,10,5,5,247
300841109,14,12,15,20,5,2,2,1,71
300841110,42,75,88,78,54,36,16,18,407
300841111,37,46,71,57,33,10,9,10,273
300841112,33,52,53,51,37,18,4,1,249
300841113,28,32,23,45,36,10,5,4,183
300841114,44,55,55,63,41,26,13,17,314
300841201,10,14,12,22,12,4,3,2,79
300841202,20,43,37,52,23,9,1,0,185
300841203,6,12,10,7,10,3,1,1,50
300841204,4,18,13,10,7,1,0,0,53
300841205,27,49,50,46,33,16,10,8,239
300841206,15,5,19,19,8,3,2,0,71
300841207,73,69,73,51,11,10,3,0,290
300841208,12,9,6,11,12,6,0,0,56
300841209,15,15,8,8,6,2,1,1,56
300841210,13,17,27,38,14,15,8,5,137
300841211,14,31,35,40,25,11,6,6,168
300841212,1,2,0,0,1,1,0,2,7
300841301,26,49,47,52,52,30,15,24,295
300841302,36,21,37,43,29,16,3,5,190
300841303,5,11,11,10,3,4,1,1,46
300841304,24,38,35,43,27,13,3,5,188
300841305,2,5,11,14,4,3,1,2,42
300841306,9,16,33,38,41,14,6,4,161
300841307,34,32,30,36,28,17,3,4,184
300841401,41,58,69,64,36,16,5,1,290
300841402,59,82,75,76,46,16,11,4,369
300841403,34,64,61,61,52,17,5,4,298
300841404,49,57,84,66,50,16,9,10,341
300841405,26,41,71,62,41,34,13,18,306
300841406,36,73,95,105,59,23,9,2,402
300841407,48,89,93,89,36,12,10,5,382
300841408,38,64,54,45,20,11,3,2,237
300841409,33,80,64,64,30,20,7,7,305
300841410,33,51,46,76,38,12,12,5,273
300841411,30,52,66,90,40,14,3,7,302
300841412,37,61,75,74,56,31,8,7,349
300841413,12,29,40,41,18,10,6,3,159
300841414,35,73,78,76,47,20,8,7,344
300841415,14,26,31,29,16,3,1,4,124
300841416,40,50,62,77,33,18,8,7,295
300841417,39,52,73,77,54,30,7,10,342
300841501,29,56,65,67,42,9,3,5,276
300841502,12,20,27,43,22,10,4,1,139
300841503,53,71,94,104,39,32,7,4,404
300841504,32,49,60,70,46,13,7,4,281
300841505,15,22,34,37,22,8,3,3,144
300841506,33,56,86,82,49,26,3,12,347
300841507,42,56,57,87,59,33,6,15,355
300841508,45,55,77,85,56,19,8,4,349
300841509,23,36,44,46,27,12,2,6,196
300841510,30,54,66,65,37,14,3,8,277
300841511,20,33,29,47,22,9,1,0,161
300841512,25,47,79,91,58,18,10,6,334
300841513,0,1,1,2,0,0,0,0,4
300841601,37,46,61,68,42,28,9,20,311
300841602,26,63,61,51,32,9,0,0,242
300841603,45,65,67,59,31,12,9,5,293
300841604,19,42,68,49,27,15,2,3,225
300841605,25,46,57,43,19,8,2,0,200
300841606,36,59,69,80,39,9,3,3,298
300841607,65,73,77,67,34,14,5,1,336
300841608,52,65,83,73,59,14,4,0,350
300841609,24,59,64,68,30,17,2,2,266
300841610,24,63,78,62,30,19,7,1,284
300841611,16,53,86,102,41,16,3,2,319
300841701,20,14,23,18,17,19,9,2,122
300841702,33,40,51,55,42,31,17,17,286
300841703,41,52,63,49,27,23,6,15,276
300841704,56,53,46,46,27,26,11,8,273
300841705,38,49,50,55,30,14,6,4,246
300841706,34,38,26,30,23,8,6,3,168
300841707,52,84,92,75,33,28,10,13,387
300841708,22,43,69,58,42,24,11,14,283
300841709,29,42,56,57,32,41,9,15,281
300841710,22,55,64,68,56,38,10,14,327
300841711,27,59,58,52,32,20,4,8,260
300841712,15,47,48,53,36,12,3,9,223
300841713,49,65,67,61,38,29,3,3,315
300841714,49,60,78,82,59,51,9,16,404
300841715,24,43,46,52,38,29,16,17,265
300841716,21,32,38,45,27,24,8,15,210
300841717,12,40,40,44,18,24,14,12,204
300841718,21,26,40,38,28,16,10,16,195
300841719,28,40,64,71,53,37,22,40,355
300841801,3,9,4,5,1,6,0,1,29
300841802,24,38,65,56,44,27,13,9,276
300841803,23,25,31,22,17,7,1,2,128
300841804,13,22,19,20,10,4,3,6,97
300841901,2,8,6,5,3,1,1,0,26
300841902,1,3,2,3,1,0,0,0,10
300841903,1,1,0,2,0,0,0,0,4
300841904,1,1,1,0,0,0,0,1,4
300841905,15,22,27,39,25,19,5,3,155
300841906,11,25,27,37,16,11,5,4,136
300841907,8,14,18,18,8,9,5,1,81
300841908,1,4,0,6,1,2,2,1,17
300841909,20,21,21,18,16,7,3,3,109
300841910,18,34,30,29,26,11,0,4,152
300841911,20,28,30,26,15,9,1,3,132
300841912,6,19,11,6,4,3,0,0,49
300842001,1,4,0,3,0,2,0,0,10
300842002,14,13,16,17,7,2,1,2,72
300842003,8,16,9,14,6,3,0,1,57
300842004,28,9,2,2,4,1,0,0,46
300842005,2,9,3,6,4,0,0,0,24
300842006,8,10,1,1,3,1,0,0,24
300842007,11,4,6,3,0,2,0,0,26
300842101,32,38,74,80,46,29,12,7,318
300842102,17,20,23,40,11,5,1,2,119
300842103,13,27,36,33,24,12,7,7,159
300842104,13,28,38,30,22,12,3,9,155
300842105,11,17,22,28,19,9,3,3,112
300842106,56,79,115,76,66,35,17,19,463
300842107,34,57,43,57,23,20,4,5,243
300842108,30,45,60,59,31,18,5,4,252
300842201,19,28,43,33,18,10,4,2,157
300842202,23,25,33,27,12,6,2,2,130
300842203,10,8,10,11,9,3,1,3,55
300842204,8,18,24,19,15,4,6,0,94
300842205,10,8,17,16,7,7,6,2,73
300842206,21,44,39,60,32,17,3,3,219
300842207,5,8,6,7,6,5,0,1,38
300842208,1,5,3,5,2,2,0,2,20
300842301,0,3,0,2,1,0,0,1,7
300842302,12,13,14,10,10,3,3,2,67
300842303,0,2,1,2,0,0,0,0,5
300842304,3,7,8,7,5,6,1,1,38
300842305,35,47,48,44,25,9,3,1,212
300842306,73,76,35,29,18,13,2,1,247
300842307,42,37,24,24,16,9,4,0,156
300842308,135,87,46,33,9,5,3,1,319
300842309,106,88,55,35,12,8,3,0,307
300842310,110,66,33,26,11,8,3,2,259
300842311,6,19,11,11,5,1,1,0,54
300842401,14,7,10,7,6,2,2,1,49
300842402,2,7,2,5,5,2,1,0,24
300842403,16,20,13,9,3,3,1,3,68
300842404,8,6,5,5,6,5,0,1,36
300842405,8,11,12,7,7,6,0,1,52
300842406,3,5,9,8,4,1,0,1,31
300842407,13,17,15,16,8,5,1,1,76
300842408,2,3,2,5,3,0,1,0,16
300842409,43,50,44,57,31,14,3,1,243
300842501,2,0,2,0,0,0,0,2,6
300842502,1,3,0,1,1,1,0,0,7
300842503,11,10,5,5,1,3,2,2,39
300842504,8,6,12,2,5,2,1,1,37
300842505,6,9,4,4,5,0,2,2,32
300842506,4,23,39,64,43,22,9,7,211
300842507,42,44,59,35,28,21,11,8,248
300842508,61,68,72,48,36,22,15,11,333
300842509,52,54,53,45,35,18,10,7,274
300842510,60,51,50,34,17,5,2,0,219
300842511,40,61,43,49,25,7,4,4,233
300842512,17,20,17,15,9,3,0,2,83
300842601,5,1,1,0,0,0,0,0,7
300842602,4,0,0,1,1,0,0,0,6
300842603,2,1,1,0,2,0,0,0,6
300842604,2,3,2,1,0,2,0,1,11
300842605,3,1,4,3,3,0,0,0,14
300842606,0,3,3,2,1,2,0,0,11
300842607,5,5,6,5,2,3,1,0,27
300842608,1,5,3,1,2,1,1,0,14
300842609,7,15,13,7,7,2,2,0,53
300842610,2,6,1,12,4,4,1,1,31
300842611,0,3,4,6,3,1,1,0,18
300842612,2,4,5,3,4,1,0,1,20
300842613,2,5,6,4,6,8,1,2,34
300842614,0,1,2,4,0,0,0,2,9
300842615,16,12,20,25,16,4,6,9,108
300842616,19,20,15,23,13,7,4,4,105
300842701,3,3,6,3,3,1,0,0,19
300842702,7,4,6,3,0,1,0,1,22
300842703,23,24,55,50,37,9,4,2,204
300842704,51,72,74,39,27,12,5,4,284
300842705,67,60,60,44,30,12,1,1,275
300842706,18,19,15,26,14,8,8,4,112
300842707,56,69,70,56,41,15,8,8,323
300842708,24,42,35,38,39,29,9,14,230
300842801,20,20,18,12,10,8,2,6,96
300842802,2,2,1,2,1,0,0,1,9
300842803,4,7,3,6,2,2,0,0,24
300842804,1,1,1,1,1,1,0,0,6
300842805,1,2,2,6,4,1,1,0,17
300842806,3,4,5,4,3,2,0,1,22
300842807,2,2,2,1,2,1,0,0,10
300842808,6,6,3,4,1,1,0,0,21
300842809,8,6,6,2,2,0,1,0,25
300842810,4,8,0,1,3,0,1,1,18
300842811,5,2,1,3,3,0,0,0,14
300842812,4,6,7,1,3,1,1,1,24
300842813,3,8,2,1,3,1,0,1,19
300842901,1,0,1,3,1,0,0,0,6
300842902,1,1,2,1,3,1,0,0,9
300842903,1,2,1,4,2,2,0,0,12
300842904,2,2,3,4,1,0,0,0,12
300842905,0,1,1,4,0,1,0,0,7
300842906,0,6,3,2,0,0,0,0,11
300842907,0,2,1,1,1,0,0,0,5
300842908,0,0,0,2,0,0,0,0,2
300842909,1,5,6,0,0,0,0,0,12
300842910,31,48,45,31,29,17,7,8,216
300843001,1,5,5,4,4,2,1,2,24
300843002,6,8,4,12,9,9,2,3,53
300843003,6,3,4,7,1,1,0,1,23
300843004,1,4,2,0,2,0,0,0,9
300843005,8,10,7,26,12,12,1,3,79
300843006,42,48,43,41,29,16,1,2,222
300843007,25,52,32,37,30,12,4,7,199
300843008,21,30,39,34,11,5,4,2,146
300843009,25,34,32,22,13,11,4,0,141
300843010,17,29,28,27,16,4,2,0,123
300843011,27,31,28,29,19,8,3,5,150
300843012,57,81,56,44,21,9,4,1,273
300843013,25,31,58,52,38,12,5,4,225
300843014,16,14,11,8,2,1,1,4,57
300843101,0,5,4,2,8,0,1,1,21
300843102,6,9,4,5,5,2,3,2,36
300843103,0,5,4,1,2,0,0,0,12
300843104,1,0,0,1,1,2,0,0,5
300843105,3,6,2,0,2,1,1,2,17
300843106,3,2,2,1,4,0,1,0,13
300843107,13,17,6,10,3,3,1,3,56
300843108,0,5,1,3,4,1,0,0,14
300843109,6,8,4,6,4,0,1,1,30
300843110,8,8,5,6,0,1,0,2,30
300843111,4,2,3,1,4,2,1,0,17
300843112,2,9,11,6,4,3,0,0,35
300843113,5,10,6,3,3,1,0,0,28
300843114,1,6,3,5,1,1,0,0,17
300843115,23,27,14,19,5,8,1,2,99
300843116,21,33,22,21,5,3,2,1,108
300843201,5,7,1,5,1,1,0,2,22
300843202,17,12,12,10,6,5,1,0,63
300843203,8,11,12,5,4,3,0,0,43
300843204,9,18,6,6,4,3,0,0,46
300843205,19,25,21,21,14,2,4,3,109
300843206,13,12,19,26,9,8,2,3,92
300843207,16,18,10,12,7,3,0,4,70
300843208,7,7,11,5,4,1,0,1,36
300843209,37,20,38,36,17,7,1,3,159
300843210,6,7,6,3,6,2,0,1,31
300843211,15,14,6,0,6,0,1,1,43
300843212,22,22,16,16,12,6,1,3,98
300843213,21,17,15,12,9,5,1,2,82
300843301,1,3,1,3,1,1,0,0,10
300843302,6,8,3,5,2,2,0,1,27
300843303,1,5,2,3,4,1,0,0,16
300843304,0,4,2,1,0,0,0,0,7
300843305,22,25,13,11,10,5,2,1,89
300843306,64,71,52,54,34,15,10,8,308
300843307,66,80,61,67,40,17,9,6,346
300843308,77,114,76,59,36,14,5,2,383
300843309,44,42,43,35,22,15,6,10,217
300843310,13,13,29,12,14,14,4,4,103
300843311,16,25,27,16,18,10,7,7,126
300843312,47,64,44,36,17,7,3,2,220
300843313,30,50,37,40,34,17,6,5,219
300843314,37,59,75,68,43,22,9,5,318
300843401,4,0,0,0,0,0,0,0,4
300843402,6,1,4,1,2,2,0,0,16
300843403,3,2,1,2,0,0,0,0,8
300843404,3,5,0,2,1,0,1,0,12
300843405,1,1,1,2,4,2,0,0,11
300843406,0,0,0,0,0,0,0,0,0
300843407,7,16,13,2,7,3,1,0,49
300843408,3,11,10,14,8,2,0,1,49
300843409,3,2,3,5,3,0,1,0,17
300843410,2,3,2,4,4,0,1,1,17
300843411,2,6,4,0,2,0,0,0,14
300843412,6,9,16,10,5,1,0,1,48
300843413,4,0,7,3,6,1,1,0,22
300843414,6,7,5,7,5,1,1,0,32
300843415,12,15,16,19,5,6,2,0,75
300843416,35,26,22,21,20,10,6,7,147
300843501,1,2,2,5,1,0,1,0,12
300843502,1,6,2,2,1,0,1,0,13
300843503,2,4,6,4,1,1,1,0,19
300843504,0,2,1,2,3,0,0,0,8
300843505,3,3,7,0,2,1,0,0,16
300843506,15,23,25,28,19,16,2,5,133
300843507,22,18,30,27,9,7,4,1,118
300843508,20,30,37,25,17,6,2,2,139
300843601,3,3,5,3,0,3,0,0,17
300843602,0,8,4,3,3,1,1,0,20
300843603,8,10,2,2,4,0,0,0,26
300843604,3,2,7,4,2,1,0,1,20
300843701,29,41,40,36,21,15,7,3,192
300843702,15,34,23,38,24,8,5,8,155
300843703,10,25,34,20,17,5,1,3,115
300843704,67,93,79,77,36,13,2,3,370
300843705,36,60,36,32,12,8,3,2,189
300843706,45,60,47,39,22,9,7,6,235
300843707,26,51,38,42,17,9,0,3,186
300843708,23,30,30,29,11,4,3,4,134
300843709,12,20,30,36,24,17,4,2,145
300843710,32,50,39,44,17,11,4,10,207
300843711,45,77,50,47,22,12,2,2,257
300843712,17,25,36,28,22,28,9,13,178
300843713,6,13,26,28,38,16,13,6,146
300843714,41,71,57,42,31,12,6,5,265
300843715,3,1,5,7,5,1,0,0,22
300843801,0,1,0,2,1,0,0,0,4
300843802,3,4,2,3,1,1,0,0,14
300843803,1,1,7,3,3,0,0,0,15
300843804,3,5,1,7,2,0,0,0,18
300843805,8,7,12,1,2,3,1,0,34
300843806,1,4,3,2,2,0,0,0,12
300843807,3,4,3,8,4,2,1,0,25
300843808,3,7,8,2,3,2,1,0,26
300843809,1,6,4,1,1,1,2,0,16
300843901,9,14,6,6,3,3,0,0,41
300843902,8,0,7,5,2,1,0,3,26
300843903,12,9,12,12,5,1,0,0,51
300843904,5,11,3,7,9,2,1,0,38
300843905,0,5,3,1,0,0,0,0,9
300843906,1,0,2,0,4,0,0,0,7
300843907,1,2,6,1,2,1,0,1,14
300843908,2,5,9,10,3,1,0,0,30
300843909,1,3,4,11,4,3,0,0,26
300844001,6,7,14,9,9,1,2,0,48
300844002,6,3,3,4,4,1,0,1,22
300844003,2,9,4,6,3,0,0,0,24
300844004,5,15,17,15,7,1,1,2,63
300844005,2,4,7,6,4,0,1,0,24
300844006,1,2,4,4,1,0,1,0,13
300844007,3,1,4,6,8,4,1,0,27
300844008,7,8,6,5,10,1,4,1,42
300844009,2,10,11,11,5,1,0,1,41
300844101,1,1,3,1,0,1,0,0,7
300844102,2,7,4,0,2,0,0,0,15
300844103,2,3,2,7,4,1,0,0,19
300844104,3,4,4,4,2,1,1,0,19
300844105,60,75,72,54,21,8,3,0,293
300844106,52,57,57,54,30,13,3,6,272
300844107,0,0,2,0,0,0,0,0,2
300844108,65,81,75,49,35,14,2,4,325
300844109,49,56,45,27,16,10,1,2,206
300844110,26,36,38,27,21,4,0,3,155
300844201,0,2,2,1,3,0,0,0,8
300844202,4,14,8,12,3,5,1,0,47
300844203,1,2,7,6,2,0,0,0,18
300844204,9,11,13,8,4,3,0,2,50
300844205,2,4,2,4,1,1,0,0,14
300844206,2,2,3,2,0,1,0,0,10
300844207,3,6,2,6,3,1,1,0,22
300844208,2,2,5,2,6,1,1,1,20
300844209,6,11,8,9,5,2,0,0,41
300844301,64,57,58,73,55,28,5,3,343
300844302,26,45,41,48,20,7,3,2,192
300844303,54,71,41,51,24,7,2,2,252
300844304,38,64,40,29,25,5,4,0,205
300844305,60,75,52,40,19,8,6,0,260
300844306,60,86,49,47,21,7,3,0,273
300844307,41,60,66,61,36,10,4,1,279
300844308,34,60,50,33,18,11,1,0,207
300844309,79,102,86,50,33,11,4,3,368
300844310,30,25,39,30,12,9,2,2,149
300844311,13,33,40,51,35,13,3,5,193
300844312,28,41,46,41,20,15,10,4,205
300844313,21,34,41,45,28,15,7,8,199
300844401,57,77,75,49,25,9,1,0,293
300844402,16,18,16,21,13,3,1,0,88
300844403,64,100,83,73,36,10,1,1,368
300844404,61,93,69,68,36,17,9,6,359
300844405,36,43,21,28,8,8,2,0,146
300844406,33,66,40,37,13,5,2,0,196
300844407,60,94,54,50,27,7,1,3,296
300844408,37,60,67,73,34,14,2,2,289
300844409,20,21,36,29,15,13,7,3,144
300844410,37,62,57,52,38,23,2,4,275
300844411,37,42,47,46,27,8,3,5,215
300844501,3,7,6,11,2,3,3,0,35
300844502,3,6,5,9,3,2,1,1,30
300844503,9,8,9,7,4,1,2,0,40
300844504,5,16,4,12,9,2,0,3,51
300844505,9,8,14,6,8,4,1,0,50
300844506,5,7,8,8,2,5,1,0,36
300844507,16,35,38,37,15,0,1,0,142
300844508,9,34,36,32,11,4,0,0,126
300844509,7,12,13,10,12,4,1,1,60
300844510,9,17,24,46,16,4,2,2,120
300844511,7,10,8,5,1,2,0,0,33
300844601,9,6,1,1,0,0,0,0,17
300880101,62,79,53,42,29,10,3,1,279
300880102,67,76,58,43,21,4,1,1,271
300880103,70,96,75,69,29,17,4,4,364
300880104,53,80,37,41,17,13,3,2,246
300880105,48,83,46,35,13,4,0,1,230
300880106,41,70,68,45,28,19,2,2,275
300880107,51,49,50,46,19,10,2,5,232
300880201,7,10,9,12,7,3,4,1,53
300880202,8,8,8,2,5,3,3,1,38
300880203,9,12,9,12,4,2,3,1,52
300880204,26,38,50,58,40,32,5,14,263
300880205,29,50,69,90,59,46,22,21,386
300880206,43,73,66,62,44,26,11,16,341
300880207,24,50,72,88,58,22,2,2,318
300880208,37,64,68,68,45,24,3,6,315
300880209,26,27,31,47,25,24,7,9,196
300880210,17,19,15,22,18,8,1,8,108
300880301,19,22,26,30,19,8,3,4,131
300880302,4,3,1,1,2,1,0,0,12
300880303,2,3,1,0,0,0,0,0,6
300880304,10,14,25,26,17,7,1,1,101
300880305,20,43,30,27,15,19,0,3,157
300880306,56,54,34,37,20,12,11,12,236
300880307,34,48,33,29,7,3,5,3,162
300880308,31,40,28,24,16,9,4,9,161
300880401,0,2,2,0,0,1,0,0,5
300880402,4,4,6,2,4,3,0,0,23
300880403,3,2,3,1,0,0,0,0,9
300880404,5,5,2,1,4,0,0,0,17
300880405,6,12,5,3,4,1,0,2,33
300880501,3,5,3,5,1,3,0,0,20
300880502,0,3,2,0,0,0,0,0,5
300880503,2,2,6,1,2,1,0,0,14
300880504,8,3,2,5,3,2,0,0,23
300880601,1,1,0,0,0,0,0,0,2
300880602,4,3,1,3,0,0,0,0,11
300880603,2,0,3,1,1,0,0,0,7
300880604,1,6,1,1,1,1,0,0,11
300880605,0,0,1,0,0,0,0,0,1
300880606,1,3,2,2,0,0,0,0,8
300880701,2,13,7,7,4,0,0,0,33
300880702,1,3,6,3,2,2,0,0,17
300880703,0,4,2,1,0,0,0,0,7
300880704,4,5,4,6,3,1,0,0,23
300880705,0,0,1,1,2,0,0,0,4
300880706,3,5,2,6,2,2,0,1,21
300880707,3,7,8,6,4,2,0,0,30
300910101,47,35,54,41,40,29,10,21,277
300910102,54,59,61,64,39,23,3,11,314
300910103,94,114,75,42,31,21,4,4,385
300910104,72,82,50,38,13,2,2,2,261
300910105,46,51,34,37,21,5,3,1,198
300910106,49,73,41,20,3,2,0,0,188
300910107,48,42,45,24,11,7,3,1,181
300910108,41,59,51,52,26,18,5,6,258
300910109,54,78,60,55,17,14,5,5,288
300910110,34,38,44,40,14,8,3,2,183
300910111,46,68,46,26,5,3,1,1,196
300910112,37,41,34,33,17,5,1,2,170
300910113,42,44,35,44,22,16,3,6,212
300910114,13,14,6,4,12,0,4,3,56
300910115,22,30,44,41,18,7,5,8,175
300910116,72,94,57,55,30,12,4,8,332
300910117,47,52,45,36,16,9,2,1,208
300910118,37,50,43,53,23,13,9,11,239
300910201,2,0,5,0,1,1,0,0,9
300910202,2,2,3,0,1,0,1,1,10
300910203,7,13,13,11,6,6,0,0,56
300910204,11,4,4,2,2,0,1,4,28
300910205,8,14,8,7,6,1,0,2,46
300910206,1,1,4,0,0,0,0,0,6
300910207,11,14,10,4,6,4,2,1,52
300910208,22,21,24,18,9,7,2,0,103
300910209,3,5,5,1,0,1,2,3,20
300910301,2,3,4,3,1,0,0,2,15
300910302,23,21,17,18,6,6,0,4,95
300910303,5,6,5,1,1,2,0,0,20
300910304,18,18,8,9,4,3,0,0,60
300910305,5,5,8,4,1,4,0,1,28
300910306,7,8,8,10,3,1,0,2,39
300910307,14,11,7,11,3,3,0,1,50
300910308,1,6,2,0,0,0,0,0,9
300910309,9,5,5,4,1,0,0,0,24
300910401,1,0,0,0,0,0,0,0,1
300910402,2,4,4,4,2,1,0,0,17
300910403,11,11,4,7,3,1,0,0,37
300910404,12,9,5,7,0,4,1,2,40
300910405,5,4,5,1,1,3,0,0,19
300910406,1,3,3,2,0,2,0,0,11
300910407,2,5,3,3,0,0,0,0,13
300910501,46,55,48,30,23,9,3,5,219
300910502,64,62,59,44,14,6,6,3,258
300910503,49,60,50,42,21,7,3,4,236
300910504,37,48,42,40,29,19,5,9,229
300910505,35,54,21,16,5,5,1,1,138
300910506,79,63,73,49,25,14,3,5,311
300910507,53,67,45,47,31,11,1,5,260
300910508,27,29,48,38,38,24,11,17,232
300910509,11,16,9,12,5,4,0,1,58
300910510,6,3,7,4,4,1,0,0,25
300910511,3,2,0,1,4,0,0,1,11
300910512,0,4,2,3,2,0,0,0,11
300910601,6,3,1,3,3,0,0,2,18
300910602,2,4,5,0,1,0,0,0,12
300910603,1,1,0,2,1,1,0,0,6
300910604,1,3,2,4,4,2,1,2,19
300910605,2,2,0,2,1,1,0,1,9
300910606,37,32,35,24,13,10,2,5,158
300910701,5,4,1,3,1,0,0,0,14
300910702,17,19,19,10,5,4,0,0,74
300910703,3,5,1,3,5,0,0,1,18
300910704,2,1,0,1,1,0,0,0,5
300910705,2,2,2,0,1,0,0,0,7
300910706,0,2,2,0,1,0,0,1,6
300910801,2,3,3,1,3,1,0,0,13
300910802,3,5,3,2,1,1,1,1,17
300910803,2,3,1,3,1,0,0,1,11
300910804,1,1,2,0,0,0,0,1,5
300910805,4,3,0,1,2,0,0,0,10
300910806,3,1,2,2,0,0,0,0,8
300910807,8,1,1,2,2,0,0,0,14
300910808,14,10,9,17,6,4,5,0,65
300910901,4,5,3,0,1,0,0,1,14
300910902,1,1,1,1,0,0,1,0,5
300910903,8,10,6,4,3,3,1,0,35
300910904,5,2,2,1,0,0,0,0,10
300910905,8,4,5,2,1,3,0,0,23
300910906,1,1,1,0,1,0,0,0,4
300911001,25,39,27,21,13,5,6,1,137
300911002,45,53,34,32,15,5,2,3,189
300911003,41,44,28,28,14,11,1,4,171
300911004,48,45,43,37,15,10,4,3,205
300911005,19,28,14,15,10,2,1,0,89
300911101,2,2,3,0,2,0,0,0,9
300911102,7,4,3,2,0,0,0,0,16
300911103,3,4,3,1,1,1,0,0,13
300911104,2,3,1,0,1,0,0,0,7
300911105,14,11,12,5,6,1,1,0,50
300911106,7,6,5,3,2,0,0,0,23
300980101,35,66,79,69,38,33,18,25,363
300980102,37,72,54,66,28,15,3,3,278
300980103,33,40,55,52,19,20,9,5,233
300980104,47,59,56,68,18,13,4,2,267
300980105,32,54,72,53,31,17,5,4,268
300980106,44,72,87,86,43,15,15,8,370
300980107,33,47,42,51,26,15,4,3,221
300980108,60,64,59,37,23,10,5,4,262
300980109,94,86,64,62,25,8,4,4,347
300980110,67,82,77,63,18,10,4,2,323
300980111,28,64,48,53,48,29,13,15,298
300980112,59,88,77,54,28,23,7,5,341
300980113,84,115,76,70,15,8,6,3,377
300980114,46,59,52,33,12,6,1,3,212
300980115,59,67,55,51,23,6,3,0,264
300980116,74,107,91,68,42,23,15,15,435
300980117,39,75,61,64,27,18,1,11,296
300980118,42,61,44,51,28,11,6,5,248
300980119,24,48,52,41,21,26,6,7,225
300980120,30,34,35,30,22,5,3,2,161
300980201,54,76,67,50,34,8,9,6,304
300980202,64,70,71,50,29,17,13,10,324
300980203,53,81,58,51,30,18,3,6,300
300980204,77,99,69,53,17,6,1,0,322
300980205,76,101,67,52,12,6,3,1,318
300980206,29,46,25,27,11,1,3,0,142
300980207,49,49,39,40,15,6,1,7,206
300980208,79,87,73,49,17,10,5,4,324
300980209,41,62,60,64,44,24,13,10,318
300980210,40,57,55,48,27,17,2,5,251
300980211,50,66,82,65,33,15,13,3,327
300980212,45,68,72,89,27,14,7,11,333
300980213,25,61,58,49,21,11,4,1,230
300980214,28,56,72,69,35,14,9,4,287
300980215,38,72,46,39,26,8,3,2,234
300980301,36,45,36,28,11,2,2,0,160
300980302,55,71,37,30,14,3,0,2,212
300980303,100,120,55,51,16,4,2,1,349
300980304,94,99,64,47,19,6,1,1,331
300980305,68,90,52,56,20,9,2,1,298
300980306,50,64,46,26,11,7,0,2,206
300980307,63,84,35,36,12,1,0,0,231
300980308,78,68,32,15,10,3,0,1,207
300980309,57,61,30,34,10,10,0,0,202
300980310,71,52,45,16,6,3,1,0,194
300980311,20,20,7,7,2,0,0,0,56
300980312,78,48,36,11,8,2,0,0,183
300980313,33,48,29,15,6,2,0,0,133
300980314,38,61,39,44,13,4,2,0,201
300980315,34,52,36,12,11,1,1,0,147
300980316,63,87,56,47,9,12,3,0,277
300980317,34,51,36,17,10,1,1,1,151
300980318,61,77,39,27,13,6,0,0,223
300980401,44,51,30,36,15,4,1,1,182
300980402,39,70,51,41,17,5,3,0,226
300980403,68,75,52,35,17,10,2,4,263
300980404,57,54,26,27,12,2,0,0,178
300980405,34,60,24,21,9,2,1,0,151
300980406,71,72,35,20,7,3,1,1,210
300980407,41,47,21,25,10,2,0,0,146
300980408,50,61,38,21,11,8,0,0,189
300980409,45,76,42,31,18,10,2,0,224
300980410,46,59,67,51,21,27,9,13,293
300980411,58,65,54,53,34,15,8,2,289
300980412,35,69,50,35,17,5,4,1,216
300980413,42,72,66,66,31,17,8,1,303
300980414,51,75,37,37,18,13,6,10,247
300980415,58,56,37,14,8,4,0,2,179
300980416,54,66,45,43,13,4,0,0,225
300980417,70,79,43,36,13,5,2,1,249
300980418,37,50,57,45,39,26,7,7,268
300980419,33,36,46,25,12,8,1,5,166
300980420,52,56,28,17,11,2,0,1,167
300980421,48,59,26,31,13,2,1,1,181
300980501,17,27,19,24,21,6,3,1,118
300980502,26,44,28,23,14,7,6,5,153
300980503,12,6,9,6,7,5,0,2,47
300980504,33,32,41,53,44,27,16,21,267
300980505,7,1,10,4,1,1,1,1,26
300980506,28,44,71,82,43,32,11,8,319
300980507,37,36,40,43,36,27,8,8,235
300980508,33,36,54,64,49,57,6,20,319
300980509,33,57,72,73,49,49,22,24,379
300980510,20,33,55,77,36,17,4,7,249
300980511,32,86,76,79,34,17,2,2,328
300980512,35,42,70,61,26,22,6,6,268
300980513,22,42,41,49,28,20,8,13,223
300980514,7,12,16,14,15,3,2,1,70
300980601,1,0,1,5,1,1,1,1,11
300980602,3,16,16,9,3,6,2,2,57
300980603,18,25,20,16,8,2,1,1,91
300980604,9,26,16,11,12,7,0,1,82
300980605,31,50,51,48,24,11,9,5,229
300980606,32,55,69,84,58,34,14,19,365
300980607,28,48,51,68,45,27,16,15,298
300980608,39,75,86,69,45,19,9,1,343
300980609,25,25,30,25,20,4,1,1,131
300980610,16,49,56,48,28,17,7,8,229
300980611,45,55,83,83,44,19,10,4,343
300980612,12,7,0,7,5,4,2,0,37
300980613,3,7,7,3,8,2,2,1,33
300980614,17,18,16,5,7,3,2,0,68
300980701,83,86,80,69,24,17,8,3,370
300980702,6,24,16,25,12,3,1,3,90
300980703,46,70,41,50,26,5,6,6,250
300980704,41,51,30,35,16,13,0,3,189
300980705,10,26,26,23,19,5,2,4,115
300980706,35,60,38,20,15,2,1,1,172
300980707,51,66,57,63,23,13,5,7,285
300980708,43,53,39,32,15,4,1,0,187
300980709,41,58,54,27,14,10,3,2,209
300980710,54,60,41,27,12,6,1,0,201
300980711,34,39,36,29,22,9,4,2,175
300980712,30,42,33,19,15,7,3,2,151
300980713,46,46,40,39,22,8,3,1,205
300980714,40,38,24,29,21,12,8,2,174
300980715,30,45,38,53,21,20,6,10,223
300980716,16,25,19,17,11,10,4,6,108
300980801,5,2,2,2,1,0,0,1,13
300980802,3,4,1,4,0,1,0,1,14
300980803,3,1,0,0,1,1,0,0,6
300980804,2,4,2,2,2,0,0,0,12
300980805,10,0,4,3,2,1,1,0,21
300980901,2,2,2,2,1,1,0,0,10
300980902,0,1,3,3,2,0,0,0,9
300980903,34,40,24,14,16,4,2,2,136
300980904,0,0,0,0,0,0,0,1,1
300980905,1,3,0,2,0,0,0,1,7
300980906,12,16,5,11,3,2,1,0,50
300980907,25,30,25,18,6,7,1,1,113
300980908,18,26,22,15,9,6,1,4,101
300980909,3,4,4,7,3,1,1,0,23
300980910,8,8,5,3,4,4,1,0,33
300980911,1,5,4,1,0,1,0,0,12
300980912,16,21,16,13,4,5,0,0,75
300980913,27,15,17,10,7,4,2,2,84
300980914,13,13,10,11,3,3,1,1,55
300980915,4,3,2,3,2,3,0,1,18
300980916,2,6,1,2,2,1,0,0,14
300980917,4,9,1,3,2,0,1,0,20
300981001,63,64,42,36,13,2,2,1,223
300981002,43,67,42,36,17,5,4,4,218
300981003,11,10,9,7,3,2,1,1,44
300981004,6,8,4,3,1,1,0,1,24
300981005,8,12,15,7,3,1,0,1,47
300981006,4,1,1,1,2,1,0,1,11
300981007,2,1,0,3,1,0,0,0,7
300981101,16,46,30,16,7,2,1,1,119
300981102,29,22,23,22,15,5,3,1,120
300981103,28,28,28,14,15,7,3,4,127
300981104,23,16,22,17,12,2,2,5,99
300981105,6,4,2,1,2,0,1,0,16
300981106,2,3,2,2,1,0,0,0,10
300981201,1,1,3,1,2,2,0,0,10
300981202,2,1,2,0,0,0,1,0,6
300981203,6,1,3,2,0,0,1,0,13
300981204,3,1,1,1,0,0,0,0,6
300981205,4,2,0,2,0,1,0,0,9
300981206,1,2,0,2,2,0,0,0,7
300981301,2,5,1,3,1,0,0,0,12
300981302,2,2,1,2,0,0,0,0,7
300981303,2,2,6,2,0,1,0,1,14
300981304,1,0,3,0,0,0,0,1,5
300981305,2,2,2,5,0,0,1,1,13
300981306,6,5,4,4,2,0,2,0,23
300981307,6,11,6,9,8,2,1,0,43
300981308,5,4,6,4,3,0,0,0,22
300981309,32,30,37,19,11,3,3,6,141
300981310,35,37,26,26,15,10,1,3,153
300981311,33,34,23,17,15,5,2,1,130
300981312,14,11,12,10,7,2,0,3,59
300981313,4,3,6,3,2,3,0,0,21
300981314,4,4,3,4,0,1,0,2,18
300981401,3,10,8,8,4,1,0,0,34
300981402,5,9,7,5,4,1,0,1,32
300981403,1,12,11,4,7,1,1,0,37
300981404,1,3,1,4,1,1,0,0,11
300981405,50,74,46,32,23,12,4,2,243
300981406,7,13,7,8,2,2,0,0,39
300981407,4,6,5,7,4,0,0,0,26
300981408,6,3,2,3,0,0,0,0,14
300981409,58,93,64,59,29,15,4,5,327
300981410,15,25,18,23,11,4,0,0,96
300981411,15,25,23,18,11,5,0,1,98
300981412,8,4,3,1,2,2,0,0,20
300981413,10,10,8,11,4,3,0,2,48
300981414,9,19,7,6,7,2,1,1,52
300981415,5,9,6,2,5,1,0,0,28
300981416,6,9,11,7,4,2,0,0,39
300981501,6,14,9,5,3,0,0,0,37
300981502,16,16,22,21,11,4,2,2,94
300981503,38,54,57,41,35,13,3,12,253
300981504,35,30,31,20,11,2,3,2,134
300981505,9,10,7,4,2,1,0,0,33
300981506,4,5,3,6,0,1,0,0,19
300981507,7,11,5,10,2,2,2,0,39
300981508,6,15,11,6,4,2,0,0,44
300981509,4,16,11,12,9,4,0,0,56
300981510,34,56,15,23,13,8,1,2,152
300981511,35,44,49,38,19,9,4,2,200
300981512,30,32,28,16,13,4,1,1,125
300981513,22,29,26,27,8,5,1,1,119
300981514,4,2,2,4,1,1,0,0,14
300981515,3,3,2,6,1,1,0,1,17
300981516,6,7,6,7,3,2,0,0,31
300981601,1,1,1,0,2,0,0,0,5
300981602,1,2,3,4,0,0,0,0,10
300981603,13,17,9,7,4,1,0,0,51
300981604,9,8,9,9,3,11,0,0,49
300981605,8,30,18,15,11,4,0,0,86
300981606,3,16,5,10,5,1,0,0,40
300981701,6,11,4,3,0,2,2,0,28
300981702,23,26,20,18,9,2,2,4,104
300981703,18,25,14,20,10,16,4,6,113
300981704,21,34,17,13,15,7,0,2,109
300981705,5,6,10,7,2,1,0,0,31
300981706,0,5,1,4,1,0,0,0,11
300981707,1,5,3,2,0,1,0,1,13
300981708,10,3,1,4,4,1,1,1,25
300981709,3,3,5,3,4,5,0,1,24
300981801,3,0,0,0,0,0,0,0,3
300981802,3,1,4,3,1,0,0,0,12
301050101,32,32,36,53,24,11,2,9,199
301050102,17,19,29,32,30,12,12,5,156
301050103,22,32,34,44,31,17,2,3,185
301050104,33,49,53,58,35,17,9,17,271
301050105,11,27,22,28,16,15,3,7,129
301050106,17,21,22,32,17,7,2,4,122
301050107,46,51,51,45,34,7,5,4,243
301050108,41,51,57,42,29,13,2,2,237
301050109,25,38,25,37,17,16,6,4,168
301050110,59,76,62,34,21,10,3,2,267
301050111,43,33,35,27,12,2,0,0,152
301050112,40,43,30,29,12,5,0,1,160
301050201,33,31,29,27,18,15,2,3,158
301050202,25,42,40,54,24,13,9,9,216
301050203,35,42,48,40,29,13,4,10,221
301050204,32,31,37,39,21,9,1,5,175
301050205,28,40,44,35,28,11,1,3,190
301050206,23,51,48,40,30,12,2,2,208
301050207,34,32,32,44,24,24,10,12,212
301050208,24,25,40,50,26,16,8,13,202
301050209,61,67,49,48,25,7,6,6,269
301050210,59,62,48,43,21,4,3,0,240
301050211,34,56,33,31,10,5,1,0,170
301050212,56,47,37,40,14,7,3,1,205
301050213,37,33,53,44,14,16,7,3,207
301050301,42,44,70,43,29,15,7,6,256
301050302,5,12,7,8,4,1,0,0,37
301050303,83,96,68,60,28,22,9,5,371
301050304,43,45,48,35,30,16,10,9,236
301050305,46,54,40,33,15,3,0,1,192
301050306,78,69,63,51,19,11,2,3,296
301050307,35,44,53,53,26,12,5,6,234
301050308,50,64,42,53,22,9,2,1,243
301050309,33,53,42,32,31,7,4,7,209
301050310,53,67,49,32,29,7,4,6,247
301050401,42,38,24,5,7,1,2,0,119
301050402,30,45,15,21,14,6,1,0,132
301050403,48,61,39,32,9,6,1,1,197
301050404,30,58,59,51,33,15,8,7,261
301050405,32,45,44,24,15,5,7,4,176
301050406,48,65,65,55,33,20,1,4,291
301050407,20,33,32,51,21,21,7,7,192
301050408,13,30,16,13,8,1,3,2,86
301050409,43,47,50,56,31,24,4,13,268
301050410,47,43,54,65,47,30,11,17,314
301050501,13,14,14,16,8,3,0,1,69
301050502,4,4,4,2,0,1,0,0,15
301050503,17,14,7,10,6,7,0,2,63
301050504,14,11,9,10,3,5,4,4,60
301050601,4,9,8,9,3,2,1,2,38
301050602,13,4,5,6,1,0,0,0,29
301050603,2,1,2,1,2,0,0,0,8
301050604,5,5,3,6,1,1,0,0,21
301050605,7,14,11,8,4,8,2,1,55
301050606,16,30,26,18,12,3,4,2,111
301050607,7,4,3,3,2,0,0,0,19
301050608,6,3,2,1,1,0,0,0,13
301050609,5,18,7,9,4,1,3,0,47
301050610,42,32,45,36,22,5,5,4,191
301050611,6,6,3,9,7,3,0,1,35
301050612,14,16,9,11,8,3,2,0,63
301050701,3,4,4,0,1,0,1,0,13
301050702,9,9,6,3,1,1,0,0,29
301050703,7,15,7,6,4,2,0,1,42
301050704,8,4,3,2,1,0,0,0,18
301050705,1,14,10,1,1,2,0,0,29
301050706,5,5,5,2,2,1,1,0,21
301050707,4,3,5,2,4,3,1,0,22
301050708,9,5,8,4,4,6,3,3,42
301050709,4,6,3,5,2,0,0,1,21
301050710,9,1,0,0,0,0,0,0,10
301050711,31,33,23,15,21,6,5,2,136
301050712,24,14,22,24,18,13,7,10,132
301050713,4,5,1,4,1,2,1,0,18
301050714,2,1,5,1,3,0,0,0,12
301050715,10,17,19,11,7,1,1,2,68
301050801,18,7,0,0,0,0,0,0,25
301050802,3,0,4,2,1,3,0,0,13
301050803,7,1,1,0,1,1,0,0,11
301050804,4,3,5,2,1,2,0,0,17
301050805,8,5,1,2,3,0,1,1,21
301050806,8,1,5,5,4,1,0,1,25
301050807,14,3,5,2,1,0,0,1,26
301050808,10,2,3,4,3,0,0,0,22
301050809,7,2,2,3,0,0,0,1,15
301050810,17,4,9,2,1,2,0,1,36
301050811,7,6,2,4,4,0,0,2,25
301050812,20,11,10,10,3,3,0,1,58
301130101,9,12,27,20,11,14,3,1,97
301130102,1,0,0,0,0,0,0,0,1
301130103,15,38,55,57,50,33,12,12,272
301130104,31,36,34,47,37,7,7,7,206
301130105,52,83,74,73,45,25,7,9,368
301130106,22,45,50,44,37,12,7,9,226
301130107,34,42,35,30,17,12,4,7,181
301130108,37,62,54,51,36,17,8,2,267
301130109,98,82,78,46,37,18,5,4,368
301130110,47,45,43,45,28,13,7,6,234
301130111,40,55,58,54,42,17,2,6,274
301130112,72,72,69,57,20,14,3,4,311
301130113,46,64,45,23,23,6,2,2,211
301130114,47,64,43,23,12,5,2,5,201
301130115,58,58,64,74,21,26,11,4,316
301130116,29,40,39,41,25,8,3,8,193
301130117,31,36,30,37,23,24,2,8,191
301130118,48,52,48,53,30,13,6,8,258
301130119,55,76,40,36,13,9,3,1,233
301130120,29,32,24,14,6,1,1,0,107
301130121,50,51,27,28,8,4,0,0,168
301130122,61,74,65,54,39,17,10,9,329
301130123,84,89,60,44,16,16,2,5,316
301130201,65,83,54,34,22,6,1,1,266
301130202,28,34,20,16,10,2,1,0,111
301130203,52,47,42,20,14,11,0,0,186
301130204,44,59,55,31,23,11,2,7,232
301130205,70,72,54,33,21,11,2,1,264
301130206,42,38,23,14,7,1,1,1,127
301130207,42,40,21,19,6,1,0,2,131
301130208,52,56,51,30,17,8,2,1,217
301130209,58,64,44,33,20,9,4,3,235
301130210,37,69,52,30,21,5,5,1,220
301130211,29,48,48,48,40,21,8,18,260
301130212,37,57,55,57,40,22,11,8,287
301130213,12,18,23,31,15,21,5,5,130
301130214,38,57,65,42,33,18,7,9,269
301130215,25,32,31,40,31,14,16,5,194
301130216,16,22,48,42,23,16,11,13,191
301130301,1,2,1,0,1,0,1,1,7
301130302,9,15,16,14,6,5,1,1,67
301130303,31,27,29,32,23,16,10,15,183
301130304,14,16,15,10,6,3,2,0,66
301130305,23,31,39,33,31,20,5,15,197
301130306,9,16,13,8,4,6,1,1,58
301130307,34,54,68,73,38,21,10,10,308
301130308,33,23,30,25,12,10,4,7,144
301130309,29,32,35,47,35,28,14,20,240
301130310,37,52,61,71,45,38,12,22,338
301130311,28,29,32,46,21,23,7,20,206
301130312,1,3,2,2,3,1,0,1,13
301130401,1,0,3,0,2,0,0,0,6
301130402,2,0,0,0,0,0,1,0,3
301130403,3,2,4,1,1,0,1,0,12
301130404,45,34,39,35,22,15,7,12,209
301130405,62,71,51,30,20,7,12,8,261
301130406,29,50,51,53,34,25,15,33,290
301130501,0,5,1,2,0,2,0,0,10
301130502,0,0,0,0,0,0,0,0,0
301130503,2,8,2,0,2,0,0,0,14
301130504,23,29,24,16,23,18,9,15,157
301130505,22,37,30,18,15,9,1,5,137
301130506,24,35,20,18,11,4,3,3,118
301130507,18,20,23,13,14,5,5,3,101
301130601,3,7,1,5,2,0,0,0,18
301130602,1,2,4,2,2,1,1,1,14
301130603,7,9,17,9,7,7,3,5,64
301130604,2,8,0,3,2,1,0,1,17
301130605,3,2,4,1,1,1,0,0,12
301130606,14,32,19,19,16,5,5,10,120
301130607,6,6,8,6,4,3,1,2,36
301130608,15,14,16,8,12,5,4,5,79
301130609,6,6,6,8,6,1,1,4,38
301130610,3,10,4,5,1,2,0,2,27
301130701,3,3,10,2,3,0,1,0,22
301130702,22,27,19,9,7,6,0,7,97
301130703,10,13,14,8,4,4,1,2,56
301130704,4,7,6,6,1,2,1,1,28
301130705,13,21,5,8,5,1,2,1,56
301130706,30,35,20,15,9,4,2,1,116
301130801,2,3,2,2,2,5,0,0,16
301130802,0,1,0,0,3,1,0,1,6
301130803,4,3,2,4,0,0,0,1,14
301130804,1,1,4,6,2,0,0,2,16
301130805,6,4,8,5,5,3,4,3,38
301130806,5,8,10,13,8,8,5,4,61
301130807,5,4,12,7,4,2,2,1,37
301130808,7,11,9,5,4,1,3,1,41
301130809,5,3,5,2,1,0,1,0,17
301130810,6,6,1,2,0,0,1,0,16
301130811,1,1,5,2,2,0,1,0,12
301130812,2,4,6,0,1,2,0,0,15
301130813,7,8,4,1,1,1,0,1,23
301130814,2,2,2,5,6,0,0,0,17
301130815,8,7,7,3,2,0,1,2,30
301130901,4,4,4,7,1,1,0,1,22
301130902,1,5,6,3,2,0,2,0,19
301130903,6,5,9,1,4,2,0,1,28
301130904,3,9,6,3,0,2,0,0,23
301130905,5,6,2,3,3,1,0,0,20
301130906,11,14,11,11,6,2,0,1,56
301130907,4,2,5,3,1,1,2,1,19
301130908,4,1,3,1,3,1,0,0,13
301131001,15,13,4,2,4,0,0,0,38
301131002,17,6,17,11,5,4,3,2,65
301131003,7,3,8,8,2,0,0,2,30
301131004,14,14,5,6,6,2,3,3,53
301131005,13,12,4,7,8,2,2,1,49
301131006,9,3,4,5,2,1,0,0,24
301131007,6,7,8,6,3,2,2,3,37
301131008,7,8,5,4,5,5,3,4,41
301131101,0,3,4,2,1,0,0,1,11
301131102,0,0,2,1,1,0,0,0,4
301131103,6,13,4,2,10,3,2,2,42
301131104,9,7,10,8,6,2,1,4,47
301131105,8,11,11,6,3,2,0,1,42
301131106,13,13,22,16,10,10,1,3,88
301131107,4,0,3,1,1,1,0,1,11
301131108,5,4,5,4,1,1,0,0,20
301131109,4,7,7,3,1,0,1,2,25
301131110,6,7,10,7,5,0,1,1,37
301131201,4,6,5,0,2,1,0,2,20
301131202,4,2,2,2,1,1,0,1,13
301131203,28,24,22,24,12,10,2,3,125
301131204,16,23,18,12,4,2,2,0,77
301131205,2,2,3,2,0,1,0,0,10
301131206,4,9,7,2,2,1,0,2,27
301131207,5,6,4,4,0,0,0,0,19
301131208,3,11,3,6,1,1,1,5,31
301131209,10,13,7,9,4,3,1,0,47
301131301,0,2,1,0,0,1,0,0,4
301131302,0,8,11,8,3,0,3,0,33
301131303,1,1,4,2,1,0,0,2,11
301131304,10,2,3,0,5,3,0,1,24
301131305,0,2,0,1,0,0,0,2,5
301131306,3,2,2,4,3,1,1,0,16
301131307,1,1,2,0,0,1,0,0,5
301131308,28,29,24,13,11,7,4,3,119
301131309,10,14,16,16,7,6,2,3,74
301131401,1,2,4,4,3,0,0,0,14
301131402,6,6,3,4,5,4,2,0,30
301131403,1,4,0,0,1,0,0,1,7
301131404,0,0,3,2,1,2,0,0,8
301131405,5,8,9,4,4,0,2,1,33
301131406,5,6,4,2,0,0,0,0,17
301131407,2,4,1,1,0,2,0,0,10
301131408,2,1,0,2,0,0,0,1,6
301131409,1,3,3,1,0,0,0,0,8
301131410,1,1,1,0,1,0,0,0,4
301131411,16,22,30,14,18,3,6,4,113
340070101,2,7,10,12,9,10,9,24,83
340070102,16,26,41,45,44,45,23,67,307
340070201,25,31,33,38,24,20,7,25,203
340070202,5,3,6,9,2,1,2,5,33
340070203,41,33,27,31,22,7,7,24,192
340070204,20,32,25,21,16,23,10,21,168
340070301,19,5,3,7,7,7,3,9,60
340070401,17,4,12,4,7,6,3,6,59
340070402,32,26,32,16,16,12,3,14,151
340070403,32,39,24,24,18,18,7,9,171
340070404,17,25,30,23,20,13,3,7,138
340070405,39,41,47,33,29,29,9,14,241
340070406,32,34,48,34,20,16,12,10,206
340070407,22,19,33,22,25,7,2,5,135
340070408,28,32,20,22,12,10,6,6,136
340070409,22,15,29,9,18,13,8,6,120
340070501,51,42,35,19,12,18,5,15,197
340070502,12,10,9,11,5,3,0,2,52
340070503,34,35,29,25,20,26,5,12,186
340070504,22,17,6,4,0,1,0,0,50
340070505,28,33,26,26,20,14,6,3,156
340070601,11,5,3,7,3,0,1,0,30
340070602,19,19,12,15,5,20,2,5,97
340070603,5,1,6,4,1,0,0,0,17
340070701,9,4,5,3,2,2,0,2,27
340070702,20,16,18,25,25,19,9,13,145
340070703,14,19,19,15,13,9,0,5,94
340070801,29,13,17,7,10,9,3,6,94
340140101,44,51,79,58,55,28,10,17,342
340140102,32,39,55,57,34,22,2,7,248
340140103,19,27,19,16,9,3,2,0,95
340140104,72,70,62,28,17,3,1,2,255
340140105,37,67,47,49,21,11,3,3,238
340140106,33,44,57,54,30,22,8,8,256
340140107,27,31,43,45,25,16,8,7,202
340140108,47,60,84,86,60,29,15,24,405
340140109,28,67,64,57,37,26,8,14,301
340140110,46,51,60,75,53,34,12,25,356
340140111,28,43,52,44,21,22,2,3,215
340140112,26,56,45,54,28,22,13,7,251
340140113,56,86,60,48,23,15,7,5,300
340140114,53,75,60,46,29,18,6,5,292
340140115,24,44,32,36,23,12,2,2,175
340140116,42,80,62,49,31,11,6,3,284
340140117,40,53,53,41,23,22,8,7,247
340140118,36,45,35,24,20,10,1,5,176
340140119,30,53,30,31,17,6,0,0,167
340140120,84,101,64,67,30,11,4,3,364
340140121,34,45,36,30,19,6,0,0,170
340140122,21,41,56,50,36,12,8,11,235
340140123,45,50,56,57,23,9,3,3,246
340140124,33,43,44,45,22,22,4,5,218
340140125,14,49,50,46,24,14,2,4,203
340140126,23,38,37,47,19,8,3,1,176
340140201,31,42,65,73,51,50,19,30,361
340140202,40,52,64,52,36,27,12,15,298
340140203,44,81,73,58,36,22,4,12,330
340140204,28,42,39,35,27,11,2,2,186
340140205,32,62,67,65,45,36,24,14,345
340140206,25,32,44,60,45,41,24,28,299
340140207,45,29,47,42,33,32,6,10,244
340140208,29,57,47,49,33,23,13,7,258
340140209,64,77,74,64,43,17,9,11,359
340140210,44,57,51,35,30,13,5,3,238
340140211,40,76,53,39,26,20,5,3,262
340140212,46,58,50,47,33,9,6,5,254
340140213,48,45,44,22,24,4,0,1,188
340140214,78,93,67,40,20,10,2,1,311
340140215,61,72,55,33,18,16,2,1,258
340140216,60,52,49,35,16,8,6,1,227
340140217,49,67,33,38,16,4,4,4,215
340140218,53,64,47,28,9,7,3,1,212
340140219,26,31,39,35,25,12,10,7,185
340140220,45,74,79,65,48,25,15,19,370
340140221,15,28,33,38,28,27,7,17,193
340140222,23,37,34,42,24,15,4,21,200
340140223,32,31,48,35,24,31,13,26,240
340140301,59,72,48,35,32,19,4,5,274
340140302,76,73,67,53,24,21,2,6,322
340140303,61,64,53,45,23,9,5,4,264
340140304,74,84,57,36,21,6,2,1,281
340140305,67,68,50,33,17,12,4,1,252
340140306,63,45,48,42,21,19,5,5,248
340140307,57,74,76,59,36,22,4,11,339
340140308,56,59,64,64,34,18,11,13,319
340140309,13,28,28,30,28,19,10,20,176
340140310,46,61,64,72,39,33,10,28,353
340140311,30,33,57,51,36,26,24,25,282
340140312,46,39,41,42,32,25,11,14,250
340140313,28,29,52,62,51,22,15,22,281
340140401,34,50,50,41,21,20,2,3,221
340140402,43,38,48,29,16,6,4,5,189
340140403,56,74,78,57,47,39,11,20,382
340140404,62,90,86,62,34,11,7,15,367
340140405,47,53,56,30,18,10,5,4,223
340140406,52,97,80,66,37,26,5,13,376
340140407,45,68,43,28,21,11,4,2,222
340140408,56,100,50,43,18,13,3,2,285
340140409,56,90,81,56,31,17,13,6,350
340140410,47,70,58,40,22,10,8,3,258
340140411,32,38,49,49,20,11,2,11,212
340140412,26,43,67,49,35,17,11,14,262
340140413,41,54,61,68,39,24,5,14,306
340140414,30,43,46,43,37,19,11,14,243
340140415,45,50,76,62,53,36,15,29,366
340140416,27,40,66,68,33,29,8,19,290
340140417,58,52,47,49,42,27,6,9,290
340140418,34,36,45,57,33,24,6,10,245
340140419,34,40,53,58,40,19,3,12,259
340140501,7,4,2,1,0,1,1,1,17
340140502,66,54,62,49,31,41,17,31,351
340140503,4,4,2,2,0,0,1,1,14
340140504,13,21,24,25,18,7,5,14,127
340140505,20,13,15,15,11,4,7,8,93
340140506,15,32,25,23,32,16,10,14,167
340140601,6,0,0,0,0,0,0,0,6
340140602,39,30,18,17,13,6,8,10,141
340140603,16,14,17,21,17,14,4,12,115
340140604,11,3,3,5,2,0,1,0,25
340140605,12,8,11,10,8,10,3,5,67
340140606,7,18,15,5,7,10,0,2,64
340140607,16,16,18,17,6,13,3,5,94
340140608,2,0,0,1,0,0,0,0,3
340140609,0,0,0,0,0,0,0,0,0
340140701,51,29,33,23,23,19,8,17,203
340140702,34,36,33,38,31,17,14,18,221
340140703,13,17,35,34,25,26,15,31,196
340140704,14,22,25,35,33,33,17,17,196
340140705,26,39,66,46,52,41,17,32,319
340140706,21,39,38,66,45,49,18,25,301
340140707,13,25,29,50,35,28,8,35,223
340140708,16,29,42,55,33,36,12,47,270
340140709,24,46,55,63,42,66,13,29,338
340140710,11,27,38,54,48,40,16,28,262
340140711,22,39,48,63,57,59,20,29,337
340140712,1,0,0,1,0,2,0,1,5
340140713,15,32,51,33,41,38,9,29,248
340140714,4,25,47,59,45,44,20,31,275
340140715,22,32,56,71,56,43,18,25,323
340140716,29,31,14,20,12,7,7,6,126
340140717,32,42,33,20,26,12,7,18,190
340140801,9,12,5,3,4,0,0,0,33
340140802,7,2,3,1,1,2,0,0,16
340140803,11,4,5,6,8,7,1,4,46
340140804,11,8,9,9,5,9,0,3,54
340140901,20,17,17,20,13,13,6,9,115
340140902,8,10,6,3,4,0,0,1,32
340141001,17,11,12,10,6,4,2,2,64
340141002,0,4,1,0,2,0,0,0,7
340141003,2,2,0,1,0,0,0,0,5
340141004,24,29,20,14,12,9,0,4,112
340141005,22,23,36,31,24,7,5,8,156
340141101,4,13,4,7,6,2,1,2,39
340141102,7,1,3,1,0,0,1,0,13
340141103,20,11,6,10,2,7,3,0,59
340141104,23,12,20,11,26,10,2,5,109
340141201,9,11,5,11,4,2,6,7,55
340141301,23,5,9,7,0,2,2,0,48
340141302,4,2,0,1,0,0,0,0,7
340141401,8,7,6,4,8,1,0,2,36
340141402,20,9,9,4,6,2,0,2,52
340141403,19,33,31,34,22,11,4,8,162
340141404,16,14,20,17,14,11,2,5,99
340141501,49,63,56,87,59,42,11,14,381
340141502,21,35,46,39,39,24,12,12,228
340141503,19,36,78,42,29,8,2,0,214
340141504,51,87,91,77,36,22,10,15,389
340141505,27,46,60,64,29,13,13,12,264
340141506,16,43,65,86,38,22,8,8,286
340141507,61,67,89,102,44,32,13,13,421
340141508,53,75,86,75,37,38,8,4,376
340141509,45,50,54,60,34,31,14,10,298
340141510,22,37,45,35,31,19,12,11,212
340141511,27,24,21,19,15,14,7,2,129
340141512,56,78,68,58,35,26,6,15,342
340141513,43,73,67,52,48,11,11,12,317
340141514,72,83,85,92,51,34,13,13,443
340141515,14,31,46,39,32,7,7,3,179
340141516,29,50,52,57,34,26,11,11,270
340141517,47,79,76,72,49,17,5,7,352
340141518,34,55,62,63,36,25,4,4,283
340141519,17,42,31,39,43,15,8,17,212
340141520,18,41,51,30,16,4,2,3,165
340141521,14,31,40,44,31,31,13,11,215
340141522,14,35,42,53,40,14,6,9,213
340141523,28,30,45,52,37,20,8,14,234
340141524,35,36,53,23,31,24,9,2,213
340141525,18,51,63,75,40,26,4,7,284
340141526,25,30,43,43,31,13,3,1,189
340141527,26,39,49,41,31,15,4,2,207
340141528,23,37,62,57,42,27,8,10,266
340141601,27,19,44,39,29,21,12,14,205
340141602,44,53,78,72,48,40,15,20,370
340141603,18,29,43,47,29,11,5,7,189
340141604,19,37,44,44,39,27,5,5,220
340141605,35,61,69,59,46,40,14,12,336
340141606,65,61,53,62,46,48,4,13,352
340141607,18,38,55,47,35,26,1,15,235
340141608,48,60,76,73,42,36,13,21,369
340141609,39,57,73,49,31,26,10,7,292
340141610,32,51,85,54,36,22,15,8,303
340141611,27,57,56,61,25,18,4,5,253
340141612,15,46,64,46,32,13,4,8,228
340141613,22,53,50,50,32,17,8,7,239
340141614,14,46,53,37,26,15,1,3,195
340141615,22,35,46,43,43,25,6,16,236
340141616,37,55,69,46,38,32,7,19,303
340141617,25,49,54,51,45,28,8,11,271
340141618,15,25,33,31,25,27,9,11,176
340141619,22,41,42,39,30,18,8,15,215
340141620,30,39,52,47,36,26,11,10,251
340141621,35,52,70,59,46,32,19,17,330
340141622,27,49,63,85,46,45,19,18,352
340141623,24,65,52,53,36,29,10,7,276
340141624,17,38,48,43,27,27,7,6,213
340141625,34,33,41,29,30,23,7,15,212
340141626,27,32,55,44,33,19,5,11,226
340141627,20,31,30,37,34,28,12,10,202
340141628,25,43,40,41,20,21,6,10,206
340141701,15,29,51,35,23,15,6,5,179
340141702,16,32,45,47,30,23,3,8,204
340141703,26,39,41,46,36,24,10,18,240
340141704,18,43,45,42,42,24,18,16,248
340141705,28,41,70,76,72,39,24,29,379
340141706,18,49,54,56,35,34,12,27,285
340141707,16,17,23,37,23,20,3,8,147
340141708,24,32,41,56,42,33,12,19,259
340141709,17,31,43,50,33,42,5,9,230
340141710,16,27,34,37,41,19,12,20,206
340141711,12,21,53,57,50,31,12,11,247
340141712,23,29,60,62,34,25,5,19,257
340141713,21,18,24,21,13,11,2,1,111
340141714,16,45,52,53,45,33,13,7,264
340141715,6,29,50,46,32,17,4,5,189
340141716,36,38,52,58,55,42,14,33,328
340141717,34,35,37,47,41,35,8,15,252
340141801,3,1,3,1,1,0,0,0,9
340141802,3,1,1,1,0,0,0,0,6
340141901,14,4,5,3,2,3,0,1,32
340141902,3,0,0,0,0,0,0,1,4
340142001,12,4,6,7,4,1,1,2,37
340142002,19,25,26,40,35,41,24,32,242
340142003,5,5,1,3,1,1,1,1,18
340142004,30,37,51,61,23,31,11,16,260
340142005,5,5,2,5,4,2,0,1,24
340142006,49,49,55,65,42,31,14,22,327
340142007,20,6,6,5,4,1,1,3,46
340142008,1,1,2,0,1,0,0,0,5
340142009,4,3,5,0,2,2,1,0,17
340142010,1,0,0,0,0,1,0,0,2
340142011,8,2,5,3,4,2,0,3,27
340142012,14,17,25,28,17,10,4,6,121
340142013,27,35,50,81,40,32,4,9,278
340142014,17,33,41,48,35,24,7,13,218
340142015,34,49,59,68,42,32,18,28,330
340142016,14,19,47,52,47,29,19,26,253
340142017,27,36,43,40,25,22,16,16,225
340142018,15,23,36,44,27,17,9,13,184
340142019,14,25,29,32,31,37,13,32,213
340142020,17,23,40,31,31,23,8,9,182
340142021,0,0,0,0,0,0,0,0,0
340142022,1,0,0,0,0,0,0,0,1
340142023,34,42,58,60,41,33,22,32,322
340142024,33,37,58,52,22,24,10,9,245
340142025,58,52,62,54,47,24,4,8,309
340142026,25,39,49,54,38,25,6,24,260
340142027,27,43,63,63,50,29,19,24,318
340142101,24,16,39,41,26,23,8,7,184
340142102,23,36,45,47,34,15,3,13,216
340142103,37,53,62,56,39,21,2,4,274
340142104,62,72,73,54,30,26,10,5,332
340142105,32,36,40,20,15,9,0,5,157
340142106,79,47,31,18,16,3,3,4,201
340142107,96,67,39,26,8,6,2,2,246
340142108,65,73,44,20,11,9,5,2,229
340142109,66,60,42,21,21,8,4,1,223
340142110,53,62,36,30,9,8,2,4,204
340142111,33,54,48,40,23,19,5,6,228
340142112,46,44,23,24,14,9,2,2,164
340142113,35,52,34,46,26,12,2,5,212
340142114,43,66,49,34,27,13,7,4,243
340142115,48,72,74,89,49,41,14,19,406
340142116,45,70,75,69,54,41,8,29,391
340142117,40,49,59,59,34,28,7,13,289
340142118,19,42,51,52,23,31,5,2,225
340142119,36,40,44,51,34,37,11,15,268
340142201,18,32,40,52,33,22,15,7,219
340142202,29,44,65,66,42,28,15,11,300
340142203,13,22,45,40,21,20,6,10,177
340142204,28,54,65,78,41,26,19,19,330
340142205,18,61,73,100,49,40,22,17,380
340142206,40,77,72,67,39,33,24,25,377
340142207,30,63,56,64,45,46,26,28,358
340142208,34,61,67,63,50,31,21,42,369
340142209,36,47,62,56,50,64,14,19,348
340142210,28,47,57,66,62,44,30,41,375
340142211,20,37,52,54,56,52,17,35,323
340142212,37,45,65,81,49,62,16,21,376
340142213,27,54,65,71,48,34,25,28,352
340142214,29,67,49,73,59,40,16,30,363
340142215,20,35,41,37,25,28,11,24,221
340142216,31,48,72,59,43,45,9,12,319
340142217,32,40,44,43,35,27,14,30,265
340142218,23,42,44,38,37,40,13,25,262
340142219,27,51,74,80,53,28,18,22,353
340142220,19,35,34,43,35,16,13,5,200
340142221,22,23,27,44,27,19,9,11,182
340142222,15,3,2,1,3,3,1,2,30
340210101,2,1,2,2,0,0,0,0,7
340210102,9,2,4,5,1,1,2,2,26
340210201,25,20,23,20,12,14,6,17,137
340210202,9,4,7,6,6,6,4,5,47
340210203,3,3,0,1,1,1,0,0,9
340210204,0,2,3,0,1,0,0,0,6
340210205,1,2,1,1,0,0,0,0,5
340210206,15,7,12,6,3,4,2,1,50
340210207,3,2,1,2,1,1,0,0,10
340210208,15,6,15,15,6,10,5,8,80
340210209,11,9,7,3,1,1,1,1,34
340210210,14,7,2,6,6,3,5,4,47
340210211,28,51,33,31,22,10,3,10,188
340210212,29,38,43,35,26,9,9,14,203
340210213,35,54,48,41,40,21,16,25,280
340210214,31,45,44,55,42,34,13,38,302
340210215,31,34,24,27,17,8,5,5,151
340210301,24,17,8,10,5,1,1,6,72
340210302,23,13,21,17,14,22,7,12,129
340210303,22,11,12,9,5,2,1,5,67
340210304,35,26,30,29,29,17,7,12,185
340210305,23,27,24,30,23,13,8,16,164
340210306,20,13,8,7,7,7,5,9,76
340210307,28,23,36,22,22,17,17,31,196
340210401,3,1,0,3,2,1,1,0,11
340210402,13,20,7,11,7,4,2,9,73
340210403,37,42,40,40,33,25,15,26,258
340210501,1,2,1,1,0,0,0,0,5
340210502,28,32,22,15,13,4,3,10,127
340210601,5,5,9,9,7,4,4,7,50
340210602,32,25,22,23,11,10,7,4,134
340210603,38,40,48,32,21,12,4,10,205
340210604,39,47,56,42,26,20,7,10,247
340210701,4,6,1,2,4,0,0,1,18
340210702,7,3,2,2,0,0,0,0,14
340210703,10,14,9,8,4,4,0,0,49
340210704,11,7,6,2,1,1,0,0,28
340210705,2,2,2,0,0,1,0,0,7
340210706,59,63,66,62,29,27,10,11,327
340210707,30,35,43,47,33,26,8,14,236
340210708,20,19,28,26,37,26,8,12,176
340210709,21,11,23,19,7,10,2,9,102
340280101,30,25,26,26,20,16,13,11,167
340280102,11,15,30,28,26,19,12,13,154
340280103,35,45,39,53,36,30,15,18,271
340280104,49,47,36,42,23,23,5,18,243
340280105,36,43,50,55,43,22,9,19,277
340280106,29,28,43,42,21,26,8,15,212
340280107,14,22,36,26,24,31,18,34,205
340280108,28,28,39,15,16,21,5,11,163
340280109,37,30,48,35,31,19,18,46,264
340280110,8,25,22,24,15,17,11,18,140
340280111,16,12,20,20,13,16,12,9,118
340280112,18,26,35,19,27,18,5,21,169
340280113,28,40,46,53,22,28,7,24,248
340280114,32,24,36,37,29,17,4,12,191
340280115,13,17,29,34,23,30,7,27,180
340280201,17,17,39,36,30,37,18,39,233
340280301,24,8,13,13,12,13,5,11,99
340280302,7,3,7,2,3,1,2,4,29
340350101,49,47,45,39,27,13,9,18,247
340350102,16,13,11,9,2,2,2,4,59
340350103,25,26,25,31,18,16,5,8,154
340350104,15,6,3,2,2,1,0,0,29
340350105,15,12,7,5,2,3,0,3,47
340350106,25,25,21,19,14,16,12,25,157
340350107,1,2,0,1,1,1,0,0,6
340350108,16,14,26,37,32,28,14,33,200
340350201,33,27,21,27,17,24,4,26,179
340350202,24,14,8,10,6,8,0,1,71
340350203,57,31,13,22,17,10,3,4,157
340350204,25,13,12,16,12,9,2,2,91
340350205,8,5,4,2,1,3,0,1,24
340350206,24,28,18,8,6,6,1,3,94
340350207,1,0,1,1,1,0,1,0,5
340350301,21,30,31,28,24,28,13,31,206
340350302,7,4,9,1,3,0,1,0,25
340350303,28,31,10,9,12,10,4,6,110
340350304,9,0,1,1,0,0,0,0,11
340350401,4,5,2,2,0,0,0,1,14
340350402,52,42,28,31,41,20,18,37,269
340350403,18,14,12,9,6,1,1,3,64
340350404,9,3,2,6,1,2,0,3,26
340350405,22,32,35,33,31,9,11,12,185
340350406,19,20,22,16,12,10,9,8,116
340350501,87,80,82,67,52,39,16,32,455
340350502,12,6,3,4,2,1,0,1,29
340350503,2,0,0,0,0,0,0,0,2
340350601,19,24,12,17,10,7,7,10,106
340350602,33,41,23,20,13,12,10,14,166
340350603,55,29,26,14,6,7,6,12,155
340350604,35,25,31,27,30,13,5,14,180
340350605,21,22,33,33,22,6,2,4,143
340350606,31,30,35,23,13,14,7,12,165
340350607,28,36,35,31,31,13,6,18,198
340350608,34,33,30,42,18,3,3,8,171
340350609,21,18,21,24,17,20,11,10,142
340350610,16,18,18,24,17,11,6,9,119
340350611,34,66,58,47,47,16,12,13,293
340350612,46,55,47,43,43,32,16,19,301
340350613,39,46,47,33,19,17,6,10,217
340350614,19,20,26,28,20,10,0,2,125
340350615,16,16,32,32,12,11,9,14,142
340350701,17,13,17,17,15,10,6,16,111
340350702,38,39,19,15,12,15,7,12,157
340350703,52,32,21,26,13,9,7,13,173
340350704,55,66,73,47,37,25,7,6,316
340350705,25,56,48,53,37,7,2,8,236
340350706,32,33,34,28,11,11,4,2,155
340350707,30,48,44,39,22,25,3,9,220
340350801,14,20,32,16,23,7,7,4,123
340350802,42,48,49,22,25,24,8,13,231
340350803,21,31,39,44,34,17,10,14,210
340350804,52,52,37,49,23,14,10,9,246
340350805,58,42,58,43,33,13,14,20,281
340350806,37,40,34,25,19,14,1,6,176
340350901,23,35,39,38,14,8,6,5,168
340350902,25,46,48,33,23,16,2,7,200
340350903,51,64,52,49,23,21,6,6,272
340350904,40,69,52,34,16,13,4,6,234
340350905,32,39,31,34,16,8,6,3,169
340350906,44,61,74,51,31,24,8,17,310
340350907,30,38,32,32,40,13,6,15,206
340350908,47,63,50,38,25,16,5,6,250
340350909,43,56,47,57,41,19,13,17,293
340350910,23,29,26,28,25,11,7,6,155
340350911,27,30,34,30,24,18,4,13,180
340351001,24,34,23,37,26,22,3,5,174
340351002,39,60,54,50,42,25,10,15,295
340351003,48,45,49,27,17,20,3,6,215
340351004,51,57,60,58,42,32,10,13,323
340351005,40,41,54,29,20,10,6,3,203
340351006,36,34,42,31,18,21,6,9,197
340351007,30,27,35,29,15,10,6,4,156
340351101,20,7,10,9,5,12,2,7,72
340351102,6,6,2,2,5,4,1,3,29
340351103,36,29,37,27,37,27,4,26,223
340351104,37,32,29,32,19,21,2,12,184
340351105,24,29,40,27,20,8,8,10,166
340351201,48,67,63,44,38,24,14,11,309
340351202,45,73,61,65,32,25,13,9,323
340351203,58,54,55,44,25,19,3,7,265
340351204,28,35,39,37,19,11,1,8,178
340351205,51,53,66,53,27,13,5,10,278
340351206,25,41,44,42,25,10,6,7,200
340351207,30,43,47,47,45,21,20,31,284
340351208,31,34,30,28,15,17,5,6,166
340351209,17,24,37,18,21,17,8,11,153
340351210,20,16,15,11,13,11,4,7,97
340351301,3,4,7,6,7,7,3,6,43
340351302,9,8,8,1,0,0,0,0,26
340351303,4,5,3,6,2,0,2,2,24
340351401,15,16,14,3,5,1,0,2,56
340351402,15,6,7,7,2,4,1,4,46
340351403,7,9,7,2,1,2,1,4,33
340351501,0,1,0,1,0,0,0,0,2
340351502,12,18,14,10,9,13,3,4,83
340351503,21,20,19,14,7,13,2,8,104
340351601,10,15,15,19,5,10,6,8,88
340351701,16,6,6,1,3,1,1,2,36
340351702,6,3,3,2,2,2,0,1,19
340351703,2,2,1,2,1,0,0,0,8
340351704,8,3,4,0,2,0,1,0,18
340351801,19,29,16,24,7,17,8,14,134
340351802,16,19,23,21,13,12,0,17,121
340351803,14,5,3,6,5,5,3,8,49
340351804,16,11,4,4,4,4,3,3,49
340351805,17,21,25,22,16,16,5,7,129
340351806,21,40,40,34,19,12,1,8,175
340351807,17,40,22,21,29,19,4,3,155
340351808,34,55,44,26,23,27,4,9,222
340351809,11,13,22,15,14,34,8,16,133
340351810,22,25,29,15,15,12,9,7,134
340351811,12,19,18,16,19,19,8,12,123
340351812,11,19,18,15,13,16,2,1,95
340351901,10,15,2,5,3,5,0,2,42
340351902,11,11,7,2,5,3,0,4,43
340351903,27,16,18,12,12,23,1,0,109
340351904,27,27,38,31,20,17,6,13,179
340351905,39,37,51,39,24,20,4,7,221
340351906,44,38,48,35,32,17,12,18,244
340351907,11,14,24,18,13,14,8,19,121
340351908,37,36,32,26,31,15,6,19,202
340351909,10,9,7,9,4,3,3,4,49
340352001,12,20,11,6,5,6,2,2,64
340352002,31,15,17,14,11,8,6,3,105
340352003,13,13,4,2,3,5,3,5,48
340352101,11,7,5,1,5,5,1,0,35
340352102,4,1,1,3,1,1,0,0,11
340352103,14,18,15,9,4,0,0,1,61
340420101,9,5,6,5,7,6,0,1,39
340420102,26,27,24,25,26,19,12,9,168
340420103,5,10,13,11,10,9,2,4,64
340420104,22,37,27,20,15,15,5,16,157
340420105,39,39,27,21,23,21,6,15,191
340420106,11,17,17,14,23,10,8,10,110
340420107,21,14,30,18,16,13,5,8,125
340420108,20,36,29,26,19,5,4,4,143
340420109,34,48,82,52,45,32,10,27,330
340420110,32,42,45,58,41,24,9,14,265
340420111,54,60,71,61,44,21,9,10,330
340420112,15,18,11,21,12,10,2,8,97
340420201,3,1,3,1,3,0,3,0,14
340420202,12,5,14,13,16,10,4,6,80
340420203,12,3,7,3,4,5,2,1,37
340420204,40,37,62,44,37,21,11,23,275
340420205,41,31,47,51,36,16,8,11,241
340420301,17,10,18,15,13,8,4,7,92
340420302,3,3,4,1,1,0,0,1,13
340420303,32,28,27,13,19,21,8,17,165
340420304,6,5,5,3,2,2,0,2,25
340420305,68,52,52,51,38,28,19,24,332
340420306,39,53,51,48,30,21,9,11,262
340420307,16,13,30,30,18,18,12,13,150
340420401,22,38,26,16,16,14,4,8,144
340420402,7,1,3,3,1,1,0,0,16
340420403,7,1,3,1,1,0,0,0,13
340420501,14,15,19,31,27,19,11,31,167
340420502,7,4,3,3,3,1,0,3,24
340420503,5,2,1,1,0,1,0,0,10
340420504,38,32,54,45,33,19,13,11,245
340420505,37,44,48,47,35,17,6,19,253
340420506,46,24,46,39,27,16,9,10,217
340490101,18,24,48,45,35,42,15,18,245
340490102,45,55,74,62,56,46,14,22,374
340490103,41,52,44,59,33,20,7,20,276
340490104,37,48,43,41,22,18,4,11,224
340490105,15,25,31,17,36,35,6,15,180
340490106,33,55,64,55,37,36,9,15,304
340490107,28,41,43,48,32,28,2,7,229
340490108,38,47,51,46,33,26,7,9,257
340490109,49,81,78,74,43,40,9,16,390
340490110,43,53,48,43,36,16,11,12,262
340490111,46,59,42,46,32,19,4,7,255
340490112,35,43,38,38,21,17,4,3,199
340490113,29,38,51,36,35,16,7,23,235
340490114,54,53,61,67,58,42,27,42,404
340490115,23,36,50,71,51,39,16,40,326
340490116,39,51,40,40,30,25,9,15,249
340490117,42,37,69,50,27,19,4,14,262
340490118,23,32,49,44,28,22,10,12,220
340490119,30,63,55,57,53,32,16,22,328
340490120,29,29,57,56,44,29,9,22,275
340490121,35,49,62,50,42,36,11,33,318
340490122,25,50,78,66,53,25,10,16,323
340490123,21,39,60,35,39,18,10,17,239
340490124,20,37,58,45,57,43,19,28,307
340490125,27,35,44,49,43,22,16,24,260
340490126,29,31,27,31,24,17,7,28,194
340490127,19,21,22,19,22,24,12,9,148
340490128,36,47,50,47,33,12,9,3,237
340490201,2,1,0,0,0,0,0,0,3
340490301,7,2,0,3,1,0,0,0,13
340490302,22,16,20,36,21,17,8,8,148
340490303,0,2,11,7,3,2,2,7,34
340490304,7,9,7,5,6,2,1,6,43
340490305,3,11,8,3,7,4,5,2,43
340490306,11,8,9,11,7,6,2,11,65
340490401,8,5,7,8,2,0,2,1,33
340490402,5,4,3,8,4,5,1,1,31
340490403,20,29,30,37,22,15,6,9,168
340490501,4,3,4,1,3,0,1,0,16
340490601,16,28,16,12,9,9,7,4,101
340490602,52,36,43,35,22,17,12,13,230
340490603,37,35,39,29,24,11,10,11,196
340490604,14,17,32,16,10,10,3,2,104
340490605,2,2,1,2,0,1,1,0,9
340490606,9,13,14,11,8,7,2,7,71
340490607,4,3,3,6,0,0,0,0,16
340490608,7,3,1,1,0,0,0,0,12
340490609,10,17,16,16,12,9,4,8,92
340490610,48,49,62,49,47,18,6,24,303
340490611,29,39,37,34,10,7,4,4,164
340490612,20,31,75,49,30,22,12,15,254
340490613,25,38,51,33,15,13,2,11,188
340490614,25,52,45,32,32,12,5,9,212
340490701,52,40,36,39,25,19,12,7,230
340490702,20,13,19,11,22,14,0,2,101
340490703,76,67,80,72,50,35,20,14,414
340490704,26,39,37,19,27,15,4,11,178
340490705,3,8,9,4,3,5,4,3,39
340490706,26,25,37,24,37,10,11,7,177
340490707,5,5,7,10,2,3,0,0,32
340490708,18,24,30,39,26,16,5,5,163
340490709,7,12,13,10,7,5,4,4,62
340490710,25,22,39,37,13,18,5,5,164
340490801,27,52,47,37,28,20,9,16,236
340490802,16,16,20,17,12,3,2,7,93
340490803,20,23,20,21,7,9,7,4,111
340490804,68,85,95,86,79,71,35,50,569
340490805,85,90,122,99,71,67,21,19,574
340490806,46,70,61,60,24,18,4,11,294
340490807,23,30,32,31,15,12,7,10,160
340490808,16,18,42,46,23,20,4,6,175
340490901,13,20,25,15,18,10,6,11,118
340490902,39,46,60,59,44,30,11,17,306
340490903,30,39,33,44,26,22,11,10,215
340490904,2,3,3,0,1,0,0,1,10
340491001,1,2,1,1,1,0,0,0,6
340491002,8,6,8,11,13,3,1,4,54
340491003,34,30,49,48,30,42,14,21,268
340491004,31,41,54,45,44,48,12,29,304
340491005,26,69,58,70,47,37,13,16,336
340491006,34,59,68,85,42,29,13,20,350
340491007,22,47,53,53,37,34,6,11,263
340491008,12,37,53,47,44,27,5,15,240
340491009,28,50,50,50,39,21,10,10,258
340491010,27,40,69,96,60,30,16,15,353
340491011,31,31,34,35,41,18,18,18,226
340491012,44,47,61,47,41,28,16,34,318
340491013,30,31,54,49,29,28,18,25,264
340491014,24,45,40,40,45,21,18,28,261
340491015,18,26,59,41,32,42,8,11,237
340491016,48,61,73,58,47,34,13,7,341
340491017,23,30,34,41,35,25,6,16,210
340491018,25,24,48,44,53,41,16,29,280
340491019,25,30,42,51,55,37,12,24,276
340491020,24,43,57,47,35,32,11,24,273
340491021,34,32,42,42,44,27,13,27,261
340491022,9,17,35,38,15,11,0,2,127
340491023,1,0,0,0,0,0,0,0,1
340491024,4,4,11,7,7,2,1,0,36
340491101,37,58,55,55,32,34,21,4,296
340491102,25,23,32,20,16,14,5,5,140
340491103,50,46,51,44,26,15,6,3,241
340491104,28,35,43,50,29,24,15,15,239
340491105,36,45,37,33,20,8,3,9,191
340491106,52,52,64,49,33,22,11,18,301
340491107,38,42,23,29,16,9,0,5,162
340491108,12,18,34,26,16,6,2,0,114
340491109,47,43,48,49,14,10,4,0,215
340560101,40,56,50,54,49,33,15,16,313
340560102,26,22,24,18,16,15,4,2,127
340560103,41,57,51,50,32,21,7,11,270
340560104,68,67,60,44,37,16,2,6,300
340560105,38,42,33,32,30,20,9,17,221
340560106,51,57,73,41,41,33,9,23,328
340560107,66,76,38,39,21,9,5,6,260
340560108,45,45,44,23,21,7,0,0,185
340560109,46,50,49,53,30,14,5,5,252
340560110,39,39,41,49,30,22,13,6,239
340560111,32,57,75,61,25,28,3,10,291
340560112,45,48,52,54,45,32,12,25,313
340560113,32,46,39,27,29,24,10,17,224
340560114,15,7,10,15,9,4,4,6,70
340560115,22,12,22,27,21,19,7,14,144
340560116,22,58,53,64,39,16,8,8,268
340560117,32,23,41,45,33,16,2,5,197
340560201,0,1,1,1,0,0,0,0,3
340560202,37,25,21,24,27,10,10,15,169
340560203,1,1,0,0,1,1,0,0,4
340560204,5,1,1,1,0,0,1,0,9
340560205,5,4,1,1,2,0,0,1,14
340560301,21,20,13,8,7,3,2,2,76
340560302,5,6,2,3,1,2,0,2,21
340560303,35,31,30,28,11,14,5,13,167
340560304,0,1,0,2,0,0,0,0,3
340560401,4,1,3,2,0,1,0,0,11
340560402,39,39,36,25,21,16,11,17,204
340560403,7,11,17,11,8,8,3,5,70
340560404,4,6,3,2,4,0,0,0,19
340560405,52,49,42,38,21,24,10,19,255
340560406,48,43,56,32,22,13,3,6,223
340560407,31,50,43,32,17,17,4,4,198
340560408,59,71,60,47,44,16,9,8,314
340560409,49,70,48,52,39,18,7,20,303
340560501,39,42,38,28,18,8,7,7,187
340560502,21,24,13,17,12,10,4,10,111
340560503,17,17,14,12,10,6,6,6,88
340560504,26,31,49,37,28,13,4,4,192
340560601,19,19,9,9,11,12,1,6,86
340560602,16,19,11,8,8,2,3,4,71
340560603,16,11,9,13,3,12,4,8,76
340560604,7,10,5,5,1,3,1,3,35
340560605,15,11,17,12,13,7,4,6,85
340560701,52,35,41,31,19,19,6,10,213
340560702,7,9,6,9,7,6,4,3,51
340560703,7,5,5,8,3,0,1,0,29
340560704,3,8,6,2,3,4,0,1,27
340560705,35,33,42,35,26,26,10,21,228
340560706,42,38,41,35,28,18,7,14,223
340560707,46,55,63,53,28,18,9,8,280
340560708,48,62,65,61,38,19,9,16,318
340560709,30,40,38,43,13,9,5,7,185
340560801,4,6,14,7,4,2,7,3,47
340560802,9,9,9,10,9,5,2,5,58
340560803,5,2,1,1,3,3,0,0,15
340560804,5,0,5,6,4,2,2,0,24
340560805,11,6,8,8,7,2,5,4,51
340560901,22,21,7,6,6,3,1,1,67
340560902,8,6,4,4,2,11,2,8,45
340560903,3,7,1,1,1,0,0,2,15
340561001,15,19,15,17,19,17,4,11,117
340561002,8,5,2,4,6,2,2,3,32
340561003,17,14,9,18,18,8,4,5,93
340561004,10,11,7,8,2,6,3,5,52
340561005,10,7,2,5,3,1,0,2,30
340561101,52,32,50,52,30,17,15,20,268
340561102,43,40,54,37,23,25,7,20,249
340561103,49,49,31,37,19,8,5,4,202
340561104,23,26,44,40,33,24,6,12,208
340561105,37,56,54,48,22,25,5,10,257
340561106,18,38,35,33,27,18,1,5,175
340561107,31,44,47,28,22,12,6,8,198
340561108,46,62,55,48,31,16,11,16,285
340561109,31,23,38,38,38,25,8,31,232
340561110,28,43,45,32,32,19,7,13,219
340561111,24,46,32,42,27,18,9,3,201
340561112,23,48,73,52,34,15,7,5,257
340561113,21,45,43,32,24,16,4,7,192
340561114,24,27,24,35,19,16,4,10,159
340561115,27,58,45,27,31,18,4,5,215
340561116,29,25,39,40,36,25,15,25,234
340561117,33,27,48,34,30,27,14,20,233
340561118,24,46,36,47,29,13,5,8,208
340561119,26,44,61,50,39,25,12,18,275
340561120,50,45,37,23,23,8,5,1,192
340561121,27,30,40,39,34,20,8,21,219
340561122,18,22,22,32,21,14,14,17,160
340561123,11,17,19,26,20,15,7,8,123
340561201,3,1,3,1,2,1,0,1,12
340561202,37,18,17,15,14,10,5,8,124
340561203,1,3,2,1,2,0,0,0,9
340561301,12,13,8,8,7,5,2,1,56
340561302,9,10,5,5,3,2,0,0,34
340561401,18,20,12,13,6,4,3,12,88
340561402,50,28,26,20,23,14,9,18,188
340561403,12,9,3,3,7,3,1,0,38
340561404,6,2,4,5,3,0,0,2,22
340561405,3,10,6,6,3,2,3,1,34
340561406,10,13,10,11,2,2,2,3,53
340561407,21,10,10,3,4,5,3,4,60
340561408,25,28,30,34,29,25,10,15,196
340561409,39,43,59,47,50,41,14,23,316
340561501,44,26,32,11,13,17,9,7,159
340561502,10,5,3,5,1,0,1,3,28
340561503,17,15,7,8,5,12,3,4,71
340561504,16,5,3,1,2,0,0,0,27
340561505,4,1,0,2,0,0,0,0,7
340561506,33,29,26,21,20,14,8,10,161
340561507,24,37,38,35,20,10,10,10,184
340561508,45,36,46,43,42,24,8,11,255
340561509,42,49,43,35,32,14,9,12,236
340561510,27,35,62,43,40,20,15,12,254
340561511,33,47,59,39,25,10,9,11,233
340561512,32,55,44,42,29,32,13,19,266
340561513,39,37,36,35,27,15,13,10,212
340561601,18,10,12,6,6,3,5,2,62
340561602,6,3,2,1,1,0,2,1,16
340561603,10,3,1,3,0,2,1,0,20
340561604,15,8,10,6,7,13,2,3,64
340561701,9,7,5,5,1,4,0,1,32
340561702,11,6,5,2,5,5,0,0,34
340561801,13,16,11,10,7,6,3,6,72
340561802,15,12,11,11,4,2,2,4,61
340561803,4,2,4,2,1,1,0,0,14
340630101,34,45,60,55,51,32,21,75,373
340630102,37,60,53,46,48,70,36,106,456
340630201,23,27,43,45,37,29,18,54,276
340630202,34,44,53,65,55,46,33,48,378
340630203,35,33,25,39,29,37,9,34,241
340630204,49,45,55,51,48,34,20,56,358
340630205,27,41,56,59,42,38,19,37,319
340630206,31,34,32,28,26,16,10,15,192
340630207,14,19,25,19,39,28,9,50,203
380070101,27,27,31,35,15,16,6,8,165
380070102,11,9,6,5,3,2,1,2,39
380070103,9,1,4,2,1,0,1,1,19
380070104,8,8,11,6,6,6,4,8,57
380070105,39,37,37,38,29,27,15,17,239
380070106,42,30,34,29,21,20,8,12,196
380070107,61,42,44,54,25,15,8,10,259
380070108,64,55,45,48,39,32,17,25,325
380070109,41,44,49,39,40,28,15,28,284
380070110,37,29,32,30,14,17,4,10,173
380070111,20,18,28,31,34,26,9,17,183
380070201,20,20,8,4,3,4,1,4,64
380070202,17,6,8,4,2,4,0,0,41
380070203,20,9,7,5,1,1,0,1,44
380070204,10,34,53,65,41,32,19,20,274
380070205,10,13,25,38,25,13,5,8,137
380070301,41,7,2,3,0,5,1,1,60
380070302,19,8,10,4,5,1,0,1,48
380070303,31,20,11,12,7,7,2,2,92
380070401,10,9,0,1,0,1,0,1,22
380070402,17,18,8,8,3,8,3,8,73
380070403,21,25,22,27,23,19,4,11,152
380070404,14,18,5,12,4,4,4,1,62
380070405,11,6,4,6,6,1,2,6,42
380070501,27,20,8,7,5,4,4,4,79
380070502,11,6,7,3,2,1,3,3,36
380070503,45,33,19,9,10,8,2,3,129
380070504,31,15,11,5,5,8,2,2,79
380140101,9,14,10,6,6,6,2,0,53
380140102,15,13,10,9,12,10,6,6,81
380140103,13,10,14,30,26,27,8,15,143
380140104,34,12,22,19,11,15,5,9,127
380140105,51,43,44,45,51,38,19,37,328
380140106,19,12,16,9,12,6,3,6,83
380140107,41,57,35,34,27,18,9,9,230
380140108,21,13,10,20,17,4,5,11,101
380140109,33,27,32,28,21,17,7,17,182
380140115,3,2,2,1,1,0,2,1,12
380140116,13,13,23,35,23,19,12,15,153
380140117,14,30,29,35,25,15,13,28,189
380140201,48,26,45,40,28,36,10,20,253
380140202,2,4,6,3,1,2,1,0,19
380140203,37,39,62,50,52,37,24,23,324
380140204,38,31,43,36,26,17,8,22,221
380140205,35,38,43,43,38,39,15,15,266
380140206,3,7,6,21,16,19,4,17,93
380140301,29,22,25,26,13,11,2,4,132
380140302,54,42,41,39,23,39,15,22,275
380140303,30,24,24,16,14,14,10,10,142
380140304,49,40,85,103,88,63,45,74,547
380140305,32,35,67,54,65,47,22,46,368
380140401,76,53,72,73,53,41,29,30,427
380140402,51,35,37,39,46,21,10,19,258
380140403,80,46,55,51,27,15,11,16,301
380140404,73,41,70,59,52,30,16,28,369
380140405,39,44,56,52,40,24,23,25,303
380140406,39,54,62,72,61,39,26,43,396
380140407,46,60,68,67,52,49,17,18,377
380140408,35,34,49,62,56,38,12,25,311
380140409,38,59,82,77,70,36,34,35,431
380140410,40,52,44,59,42,27,14,29,307
380140411,43,48,63,66,43,47,17,15,342
380140412,5,15,16,34,30,23,18,21,162
380140413,26,38,50,65,56,37,20,29,321
380140414,15,13,33,57,56,24,32,34,264
380140501,28,23,45,45,35,18,7,13,214
380140502,38,20,45,28,26,20,5,8,190
380140503,63,34,60,66,63,24,18,12,340
380140504,24,28,12,6,5,3,0,0,78
380140505,9,12,4,1,3,1,0,2,32
380140506,29,9,22,29,23,13,10,7,142
380140507,43,59,77,67,48,23,12,20,349
380140508,73,95,85,72,45,33,8,15,426
380140509,33,47,67,59,44,32,15,18,315
380140510,45,54,54,59,37,16,5,4,274
380140511,56,67,61,63,45,32,14,13,351
380140512,27,35,47,63,39,33,11,14,269
380140513,35,37,53,53,36,35,16,16,281
380140514,15,38,59,58,52,41,23,34,320
380140515,13,34,60,80,44,39,24,41,335
380140516,26,46,49,51,33,17,10,9,241
380140517,10,11,21,30,19,11,6,9,117
380140601,49,57,64,71,29,18,6,11,305
380140602,52,57,44,52,39,26,20,22,312
380140603,73,55,61,46,30,21,4,5,295
380140604,67,68,87,61,48,29,12,22,394
380140605,35,51,70,53,48,33,12,17,319
380140606,66,47,71,48,38,16,13,13,312
380140607,63,44,62,60,27,25,12,14,307
380140608,38,48,65,50,34,27,11,15,288
380140609,15,56,96,99,81,54,21,35,457
380140610,18,29,43,46,38,19,13,15,221
380140611,20,36,42,50,59,40,17,47,311
380140612,19,43,53,48,38,24,19,32,276
380140613,18,31,42,46,40,29,17,28,251
380140614,26,32,48,52,37,34,12,19,260
380140615,44,45,67,76,61,44,25,35,397
380140616,49,55,52,41,34,23,16,18,288
380140617,13,16,50,34,35,25,24,44,241
380140618,15,30,46,51,41,28,25,37,273
380140619,21,27,39,52,47,30,19,31,266
380140701,6,19,28,39,37,22,14,15,180
380140702,6,9,22,18,9,6,3,4,77
380140703,4,8,15,15,4,7,1,3,57
380140704,6,11,13,14,7,3,3,2,59
380140705,9,25,27,34,41,22,14,21,193
380140706,5,22,36,56,33,24,15,14,205
380140707,14,35,46,76,56,19,7,8,261
380140708,13,46,57,73,51,42,12,28,322
380140709,13,41,62,68,48,31,18,27,308
380140710,16,32,73,83,69,45,30,29,377
380140711,17,39,58,78,71,70,44,82,459
380140712,25,40,63,78,79,67,37,59,448
380140713,37,47,75,77,57,40,22,26,381
380140714,20,23,37,52,42,18,10,14,216
380140715,5,27,53,57,28,16,12,13,211
380140716,22,28,69,93,60,49,13,24,358
380140717,13,13,23,33,37,27,12,11,169
380140718,3,4,18,21,17,21,4,17,105
380210101,8,8,3,0,0,2,0,0,21
380210102,12,12,2,0,2,2,1,1,32
380210103,34,31,15,19,11,7,5,9,131
380210104,1,2,4,2,0,0,0,0,9
380210105,27,28,25,22,17,12,1,3,135
380210106,22,34,45,28,22,16,1,12,180
380210107,29,36,33,29,23,13,6,10,179
380210108,49,51,58,50,45,31,17,26,327
380210109,18,19,10,11,7,4,1,2,72
380210110,28,25,33,27,16,16,9,12,166
380210201,11,7,6,2,8,3,7,3,47
380210202,30,12,5,4,0,1,2,0,54
380210203,1,2,0,0,0,1,0,0,4
380210204,3,0,0,0,1,0,1,0,5
380210301,3,3,2,2,2,2,0,0,14
380210302,6,6,0,1,3,2,0,0,18
380210303,16,14,8,8,7,8,1,2,64
380210304,7,5,4,3,3,2,1,0,25
380210305,10,3,10,9,3,1,3,0,39
380210306,3,2,2,3,1,0,1,0,12
380210307,34,34,57,55,43,30,22,20,295
380210401,2,0,2,0,0,0,0,0,4
380210402,28,16,10,14,12,8,4,8,100
380210403,6,2,0,0,3,0,0,1,12
380210404,23,15,15,6,4,5,2,3,73
380210405,40,32,33,51,38,32,6,21,253
380210406,27,36,34,57,35,17,5,6,217
380210407,4,4,14,14,6,2,1,0,45
380210408,10,16,19,19,10,12,2,4,92
380210409,62,73,88,82,55,34,12,18,424
380210410,29,30,52,58,30,21,11,15,246
380210411,39,45,54,46,43,24,12,19,282
380210412,34,62,55,67,38,32,9,10,307
380210413,30,31,64,64,34,36,17,24,300
380210414,28,43,47,43,24,28,5,4,222
380210415,47,38,67,54,41,22,7,12,288
380210416,24,24,25,28,12,9,8,10,140
380210417,22,54,47,70,53,28,7,11,292
380210418,23,16,37,22,10,13,4,3,128
380210419,13,16,16,21,13,8,0,4,91
380210501,38,54,60,71,32,14,5,8,282
380210502,39,58,70,60,41,15,9,7,299
380210503,62,103,74,69,33,31,9,9,390
380210504,52,85,99,93,55,37,12,12,445
380210505,36,45,63,54,30,27,11,10,276
380210506,39,41,46,27,14,12,11,5,195
380210507,49,61,49,54,43,27,12,10,305
380210508,32,39,53,56,19,22,10,19,250
380210509,31,36,41,47,29,34,13,23,254
380210510,28,60,92,93,65,45,24,32,439
380210511,39,42,45,65,23,18,7,9,248
380210512,51,74,75,57,39,17,6,7,326
380210513,53,64,72,82,48,31,11,13,374
380210514,63,72,86,76,48,34,17,18,414
380210515,19,29,52,57,41,24,15,10,247
380210516,26,42,74,83,40,15,3,8,291
380210517,36,61,55,63,42,13,4,2,276
380210518,24,43,42,35,30,14,12,12,212
380210519,16,27,33,53,31,38,11,20,229
380210520,43,56,85,105,45,16,3,1,354
380210521,40,69,72,67,43,24,11,11,337
380210522,23,41,53,57,44,25,12,21,276
380210523,21,34,50,54,53,46,9,19,286
380210524,44,92,85,80,57,28,5,7,398
380210525,43,51,50,49,12,8,0,2,215
380210526,13,23,35,33,19,21,10,15,169
380210527,17,29,35,72,35,8,2,2,200
380210601,70,56,54,42,22,14,6,11,275
380210602,18,31,41,44,28,25,16,16,219
380210603,36,56,84,77,69,35,17,12,386
380210604,24,41,59,51,56,42,24,33,330
380210605,48,49,41,11,11,1,4,1,166
380210606,14,15,20,12,4,0,0,1,66
380210607,72,87,52,35,8,1,0,1,256
380210608,25,41,44,43,21,30,12,27,243
380210609,42,58,37,29,12,4,1,0,183
380210610,92,81,40,29,10,4,0,1,257
380210611,44,40,36,43,39,32,7,15,256
380210612,53,42,33,21,9,1,1,0,160
380210613,85,50,27,31,8,5,1,1,208
380210614,21,38,43,55,31,26,19,21,254
380210615,86,79,43,29,9,6,0,0,252
380210616,71,67,56,27,16,11,3,2,253
380210617,16,30,45,35,34,39,14,27,240
380210618,12,23,26,55,58,44,26,29,273
380210619,16,28,50,55,44,35,15,16,259
380210620,27,20,35,34,24,12,9,17,178
380210621,44,39,45,48,32,12,11,12,243
380210701,33,57,76,71,45,28,10,10,330
380210702,22,52,40,31,32,14,8,5,204
380210703,10,10,12,16,4,9,3,3,67
380210704,36,44,55,43,29,32,11,17,267
380210705,69,91,74,65,46,17,5,9,376
380210706,57,46,39,20,11,2,0,1,176
380210707,91,113,59,52,21,4,3,4,347
380210708,19,44,45,44,24,6,3,1,186
380210709,58,72,40,35,20,8,2,0,235
380210710,70,84,43,33,14,4,2,0,250
380210711,27,38,45,65,25,27,16,19,262
380210712,55,77,56,46,29,5,4,1,273
380210713,40,63,35,45,21,13,2,1,220
380210714,62,81,68,45,29,9,5,1,300
380210715,82,104,90,70,33,17,2,1,399
380210716,72,99,102,93,44,21,5,3,439
380210717,43,82,85,83,30,15,13,14,365
380210718,30,59,30,37,39,10,5,5,215
380210719,46,47,55,57,43,18,8,20,294
380210720,39,56,53,57,19,10,3,8,245
380210721,27,54,46,34,23,2,3,1,190
380210801,48,53,41,37,22,4,7,7,219
380210802,65,80,57,46,34,23,6,6,317
380210803,46,40,32,26,13,7,2,3,169
380210804,22,34,46,48,21,22,8,8,209
380210805,64,59,52,49,32,16,7,13,292
380210806,57,76,74,60,43,27,8,19,364
380210807,46,89,85,71,41,32,14,16,394
380210808,54,94,97,86,37,28,14,21,431
380210809,50,62,60,46,36,17,8,18,297
380210810,23,31,52,54,31,29,9,5,234
380210811,42,45,56,45,35,14,9,8,254
380210812,78,87,82,55,46,29,11,9,397
380210813,34,64,41,32,21,15,13,9,229
380210814,81,47,51,46,41,28,7,3,304
380210815,23,44,38,38,25,22,8,19,217
380210816,54,61,81,73,69,35,17,26,416
380210817,56,50,52,43,33,26,7,16,283
380210818,34,39,51,74,51,31,12,16,308
380210819,34,55,57,56,32,30,10,19,293
380210820,6,25,26,32,20,17,12,5,143
380210821,25,47,57,49,26,29,14,14,261
380210822,37,49,49,58,29,22,14,27,285
380210823,42,47,42,36,28,32,12,12,251
380210824,42,39,39,52,28,20,6,12,238
380210825,47,55,44,39,20,26,2,3,236
380210826,54,49,44,46,32,21,3,12,261
380210827,74,47,43,37,17,8,4,3,233
380210901,108,103,82,53,27,17,5,10,405
380210902,55,46,46,40,18,11,0,3,219
380210903,29,52,41,44,21,8,1,2,198
380210904,27,33,24,24,19,10,1,2,140
380210905,72,75,83,58,43,22,7,15,375
380210906,96,68,47,45,29,12,7,7,311
380210907,72,74,81,51,28,16,8,12,342
380210908,67,75,51,40,35,12,13,10,303
380210909,47,57,64,35,20,10,4,8,245
380210910,100,82,67,59,31,23,12,13,387
380210911,93,101,89,94,45,35,12,13,482
380210912,61,78,90,83,54,30,7,18,421
380210913,53,77,77,65,39,25,10,11,357
380210914,27,61,57,44,37,22,13,10,271
380210915,23,47,73,53,34,34,21,35,320
380210916,31,58,79,72,58,50,24,36,408
380210917,45,46,61,66,51,34,11,14,328
380210918,69,81,99,74,46,28,11,9,417
380210919,25,35,34,26,17,18,5,4,164
380210920,29,69,66,56,34,23,4,5,286
380210921,15,41,44,43,32,19,11,11,216
380210922,54,49,64,46,29,21,9,13,285
380210923,19,22,25,22,16,13,4,6,127
380211001,68,66,82,59,33,22,11,9,350
380211002,34,65,73,60,44,29,16,27,348
380211003,28,49,55,60,45,30,10,10,287
380211004,26,44,40,59,34,22,8,10,243
380211005,43,54,65,69,49,41,13,25,359
380211006,35,50,56,47,43,27,6,20,284
380211007,51,64,62,67,41,31,9,27,352
380211008,74,72,62,47,29,23,5,12,324
380211009,88,100,82,60,33,23,8,8,402
380211010,54,72,56,55,31,26,7,11,312
380211011,35,64,43,36,29,13,3,0,223
380211012,37,50,74,44,26,22,9,8,270
380211013,52,64,63,46,28,21,8,10,292
380211014,35,37,55,69,73,46,18,14,347
380211101,26,64,61,51,43,35,12,28,320
380211102,20,42,72,64,48,21,9,8,284
380211103,37,44,58,62,51,27,22,15,316
380211104,45,49,57,42,39,15,14,12,273
380211105,33,74,80,62,38,31,12,19,349
380211106,26,44,47,48,32,24,6,12,239
380211107,20,54,62,44,36,20,12,13,261
380211108,67,85,82,72,57,35,15,21,434
380211109,14,21,25,26,23,22,14,10,155
380211110,67,112,80,62,44,14,9,4,392
380211111,29,47,56,53,50,31,12,16,294
380211112,39,52,54,46,15,20,6,5,237
380211113,44,64,59,61,36,18,8,4,294
380211114,58,50,55,44,29,18,11,7,272
380211115,34,45,48,43,33,15,7,7,232
380211116,41,72,56,59,38,15,4,4,289
380211117,38,54,60,50,40,32,11,12,297
380211118,23,20,26,25,16,18,7,5,140
380211201,33,41,56,74,35,24,5,15,283
380211202,54,88,75,62,38,17,13,12,359
380211203,37,55,81,66,57,52,24,31,403
380211204,28,47,59,66,35,32,4,23,294
380211205,18,40,41,41,34,24,22,27,247
380211206,42,46,62,71,49,37,23,24,354
380211207,28,60,79,82,44,34,16,24,367
380211208,26,40,47,39,23,21,5,8,209
380211209,32,55,67,66,43,26,7,15,311
380211210,36,48,64,60,46,27,16,13,310
380211211,53,57,36,47,29,25,11,17,275
380211212,27,45,61,64,38,26,7,11,279
380211213,30,25,42,54,24,27,6,5,213
380211214,46,62,80,95,67,35,17,16,418
380211215,33,46,63,69,39,25,8,10,293
380211216,24,40,42,46,18,17,8,13,208
380211217,27,41,53,51,42,21,10,9,254
380211218,23,33,39,42,43,33,10,17,240
380211219,25,64,73,99,59,20,7,2,349
380211220,22,40,53,72,39,51,30,34,341
380211221,21,57,66,100,53,30,11,10,348
380211301,30,59,107,86,59,20,8,16,385
380211302,4,2,2,1,4,0,0,1,14
380211303,10,8,2,5,8,6,2,2,43
380211304,13,24,35,54,39,33,18,8,224
380211305,33,43,53,66,52,28,16,14,305
380211306,26,32,63,50,40,16,3,7,237
380211307,38,42,84,101,78,33,22,10,408
380211308,22,32,80,74,60,40,27,31,366
380211309,18,37,59,67,38,45,17,29,310
380211310,16,39,52,56,43,32,17,24,279
380211311,11,31,68,58,53,46,14,38,319
380211312,28,49,58,61,57,37,18,15,323
380211313,45,56,69,74,63,37,19,20,383
380211314,20,30,41,47,35,26,19,14,232
380211315,25,42,70,68,53,33,11,19,321
380211316,20,39,67,64,50,19,12,12,283
380211317,15,48,69,67,40,24,13,18,294
380211318,15,35,38,45,39,17,8,7,204
380211319,13,37,48,59,51,29,19,27,283
380211320,13,32,40,61,40,14,12,13,225
380211321,9,34,44,35,32,23,7,12,196
380211322,16,27,60,72,47,28,9,17,276
380211401,19,34,51,88,60,18,6,9,285
380211402,18,30,58,73,73,40,10,24,326
380211403,18,43,71,74,61,30,12,15,324
380211404,16,32,51,78,53,46,20,19,315
380211405,14,39,65,63,71,51,18,26,347
380211406,23,37,72,66,59,40,23,40,360
380211407,41,62,62,77,68,57,25,38,430
380211408,26,62,63,65,57,55,36,40,404
380211409,26,49,64,78,64,44,20,32,377
380211410,17,14,39,47,42,26,12,18,215
380211411,20,26,35,47,50,35,9,18,240
380211412,30,46,65,56,44,37,15,23,316
380211413,21,22,29,32,31,33,17,35,220
380211414,33,64,69,65,57,61,24,42,415
380211415,24,52,63,82,46,42,31,35,375
380211416,19,23,45,45,50,35,14,24,255
380211417,38,65,81,87,66,54,20,50,461
380211418,20,32,55,50,60,51,20,27,315
380211419,17,25,43,53,53,37,26,31,285
380211501,37,43,79,107,57,33,16,15,387
380211502,16,31,55,38,20,14,5,3,182
380211503,5,7,15,30,18,4,1,2,82
380211504,13,20,36,31,18,8,5,5,136
380211505,11,25,50,45,36,15,5,6,193
380211506,17,31,50,57,31,19,5,16,226
380211507,15,41,46,71,43,24,5,12,257
380211508,21,34,72,77,34,28,5,13,284
380211509,13,27,42,43,31,16,10,11,193
380211510,30,42,61,87,45,29,8,10,312
380211511,53,70,78,81,53,31,9,8,383
380211512,24,35,52,68,39,41,11,19,289
380211513,20,33,49,49,38,13,6,7,215
380211514,12,27,68,94,47,25,7,5,285
380211515,16,51,63,63,29,8,4,2,236
380211516,18,9,23,22,6,5,6,1,90
380211517,41,30,46,30,25,7,3,3,185
380211518,52,53,120,102,50,31,17,4,429
380211519,60,36,51,24,8,4,1,1,185
380211520,7,11,17,3,1,0,0,1,40
380280101,21,13,11,11,9,6,5,11,87
380280102,25,12,4,10,8,4,1,5,69
380280103,12,13,16,9,12,7,3,8,80
380280201,34,2,8,4,15,6,6,0,75
380280202,14,4,9,2,14,9,3,3,58
380280203,49,8,12,0,25,11,11,1,117
380280204,16,2,3,1,8,4,5,1,40
380280205,9,4,5,2,10,9,0,0,39
380280301,36,23,21,16,23,23,4,5,151
380280302,36,32,28,0,0,4,0,0,100
380280303,26,17,22,22,17,16,7,7,134
380280401,60,37,17,15,10,9,1,4,153
380280402,36,15,11,4,8,9,0,6,89
380280403,25,44,36,40,31,22,8,15,221
380280404,51,39,31,34,16,20,1,3,195
380280405,27,31,36,37,32,20,3,4,190
380280406,51,49,40,26,18,13,7,9,213
380280407,32,43,48,42,27,20,15,19,246
380280408,45,30,40,22,14,8,6,8,173
380280409,15,29,25,24,27,18,9,10,157
380280410,17,38,62,54,35,27,24,21,278
380280411,26,60,54,63,34,26,10,17,290
380280412,24,30,24,31,13,9,4,11,146
380280413,18,23,68,66,28,22,15,12,252
380280414,25,20,41,23,19,9,2,6,145
380280415,28,44,48,48,26,11,5,5,215
380280501,11,9,6,3,3,0,0,1,33
380280502,34,21,12,10,8,5,1,12,103
380280503,60,20,21,31,23,8,4,6,173
380280504,23,12,20,32,33,22,9,25,176
380280505,20,20,26,36,35,19,19,13,188
380280601,22,7,4,4,0,1,0,2,40
380280602,33,21,17,19,8,11,4,3,116
380350101,43,37,55,45,32,26,24,21,283
380350102,8,7,9,13,6,6,7,10,66
380350103,1,0,1,0,0,0,1,0,3
380350104,3,1,2,2,2,0,0,0,10
380350105,31,57,54,52,45,39,15,22,315
380350106,33,51,56,75,54,41,29,30,369
380350107,25,31,55,38,39,28,19,34,269
380350108,40,42,44,39,39,22,13,23,262
380350109,22,29,45,48,50,31,21,33,279
380350110,33,27,26,43,23,21,15,26,214
380350111,30,16,33,49,34,36,17,33,248
380350112,25,37,45,28,24,19,8,10,196
380350113,33,41,31,37,23,24,13,9,211
380350114,19,25,22,21,28,22,24,30,191
380350115,5,5,12,18,12,19,14,30,115
380350201,2,0,0,0,0,0,0,0,2
380350202,0,0,1,0,1,0,0,0,2
380350203,0,0,0,0,0,0,0,0,0
380350204,21,43,49,40,20,12,8,12,205
380350205,37,50,43,36,30,14,3,6,219
380350206,21,14,7,7,3,3,1,0,56
380350207,22,10,9,5,7,2,0,1,56
380350208,10,16,13,6,4,4,1,4,58
380350209,25,22,12,9,10,3,3,1,85
380350210,29,46,46,54,31,27,13,20,266
380350211,51,76,55,60,41,41,17,37,378
380350212,37,41,43,40,30,29,12,5,237
380350213,24,43,41,37,22,9,5,2,183
380350214,24,35,40,40,24,12,6,17,198
380350215,32,46,38,43,26,10,6,5,206
380350216,19,26,40,31,28,10,4,7,165
380350217,23,27,46,69,44,36,16,11,272
380350301,17,14,3,5,2,0,0,0,41
380350302,2,3,3,2,4,1,2,1,18
380350303,1,1,2,5,2,3,1,1,16
380350304,4,2,3,0,3,2,0,0,14
380350305,6,4,2,1,1,0,0,0,14
380350306,6,19,49,49,32,25,6,7,193
380350401,34,15,21,24,17,10,3,4,128
380350403,14,14,13,17,12,10,5,6,91
380350404,26,32,48,34,36,27,15,25,243
380350405,0,0,0,0,0,0,0,0,0
380350406,0,0,0,0,0,0,0,0,0
380350407,23,32,46,50,40,34,16,25,266
380350408,25,54,70,79,64,45,22,35,394
380350409,50,45,72,68,45,31,7,20,338
380350410,53,59,67,87,42,27,10,17,362
380350411,32,44,45,51,38,21,12,11,254
380350412,40,48,63,76,51,35,15,34,362
380350413,36,27,47,49,46,29,19,42,295
380350414,24,35,69,56,41,30,16,27,298
380350415,4,19,35,73,44,18,8,1,202
380350416,28,34,67,86,57,43,18,21,354
380350501,38,79,88,89,45,25,16,5,385
380350502,13,51,61,60,46,34,14,14,293
380350503,9,51,51,60,43,33,19,30,296
380350504,21,43,65,71,44,29,18,41,332
380350505,18,33,57,57,43,23,10,12,253
380350506,13,30,55,35,34,31,18,16,232
380350507,59,83,77,69,37,16,13,9,363
380350508,26,43,52,33,26,13,6,6,205
380350509,49,36,33,29,11,8,1,6,173
380350510,77,74,63,57,38,16,15,12,352
380350511,40,49,35,34,17,13,5,3,196
380350512,46,35,36,25,19,8,1,1,171
380350513,53,52,53,41,35,10,5,5,254
380350514,54,75,61,59,35,16,8,6,314
380350515,46,69,86,71,53,29,15,18,387
380350516,17,50,86,128,104,42,10,12,449
380350517,39,61,38,30,27,7,4,6,212
380350601,19,27,64,64,58,55,27,28,342
380350602,43,59,55,63,60,39,19,16,354
380350603,34,53,64,56,45,40,17,28,337
380350604,45,53,86,52,53,40,23,29,381
380350605,33,41,53,54,39,23,5,24,272
380350606,40,53,60,72,57,48,11,20,361
380350607,30,49,56,56,38,20,12,17,278
380350608,17,46,49,53,33,22,12,14,246
380350609,20,20,39,42,31,40,5,12,209
380350610,33,59,68,60,53,29,20,29,351
380350611,20,32,46,59,53,27,20,10,267
380350612,24,48,47,45,37,33,19,29,282
380350613,16,35,59,91,67,37,13,13,331
380350614,16,30,58,81,67,41,25,30,348
380350615,14,22,41,77,64,38,18,20,294
380350616,17,29,52,92,80,46,15,24,355
380350617,26,42,90,119,65,43,13,15,413
380350618,48,51,47,55,48,52,22,22,345
380350619,22,38,34,45,27,24,11,9,210
380420101,23,17,8,5,3,3,1,3,63
380420102,5,2,1,0,0,0,1,1,10
380420103,4,5,0,2,1,1,1,0,14
380420104,38,24,22,29,20,17,4,8,162
380420105,20,18,18,16,18,10,6,4,110
380420201,12,10,16,13,7,3,1,4,66
380420202,12,4,3,6,6,4,5,5,45
380420203,2,0,1,0,0,0,0,0,3
380420204,24,9,12,8,3,6,2,9,73
380420205,17,41,41,39,39,28,16,17,238
380420206,11,21,19,30,15,14,6,11,127
380420207,6,15,25,28,22,15,6,7,124
380420208,19,33,57,78,56,49,19,23,334
380420301,18,13,15,15,14,13,3,9,100
380420302,9,5,2,7,2,6,1,7,39
380420401,48,54,62,70,58,46,18,32,388
380420402,33,57,78,75,48,35,8,12,346
380420403,43,44,69,57,46,27,17,22,325
380420404,44,46,61,65,53,35,25,25,354
380420405,21,34,40,45,38,32,18,15,243
380420406,29,48,43,44,18,36,9,9,236
380420407,57,58,66,77,55,39,16,18,386
380420408,42,58,72,77,42,25,11,17,344
380420409,16,27,48,69,47,28,13,15,263
380420410,24,24,49,65,38,28,11,22,261
380420411,14,36,80,76,49,35,10,14,314
380420412,18,20,30,25,16,21,7,5,142
380420413,21,20,46,51,43,30,10,14,235
380420414,39,45,60,80,51,36,26,37,374
380420501,43,56,61,71,37,29,17,36,350
380420502,43,38,34,55,45,24,22,26,287
380420503,36,34,56,57,36,32,15,30,296
380420504,33,42,50,43,47,25,17,14,271
380420505,32,29,38,43,41,37,15,28,263
380420506,25,52,64,52,32,38,25,27,315
380420507,53,38,56,45,39,15,6,13,265
380420508,32,38,45,55,29,20,7,13,239
380420509,54,79,61,63,43,28,12,14,354
380420510,45,51,54,41,33,23,8,11,266
380420511,27,32,41,44,43,20,11,12,230
380420512,33,72,89,61,52,29,21,17,374
380420513,32,47,41,43,37,25,13,15,253
380420601,14,39,42,62,37,26,8,8,236
380420602,71,63,71,54,30,12,13,8,322
380420603,39,43,62,59,25,19,10,16,273
380420604,32,64,59,66,41,23,14,12,311
380420605,24,65,53,31,33,14,5,8,233
380420606,35,60,45,46,25,16,4,3,234
380420607,22,58,75,69,49,46,22,32,373
380420608,24,53,59,57,33,18,15,8,267
380420609,27,67,65,87,60,39,25,34,404
380420610,16,39,55,84,66,47,20,26,353
380420611,14,49,43,38,33,35,2,17,231
380420612,13,31,45,44,25,25,9,18,210
380420613,27,49,58,48,34,41,14,25,296
380490101,5,6,2,3,3,0,0,0,19
380490102,23,13,5,6,2,5,1,3,58
380490103,3,3,1,2,2,1,1,0,13
380490104,7,6,4,4,2,1,2,1,27
380490105,7,10,6,5,9,3,4,6,50
380490106,14,16,17,13,16,6,4,4,90
380490201,11,12,8,3,0,0,2,2,38
380490202,22,13,3,6,1,0,1,0,46
380490301,21,8,6,9,8,5,2,7,66
380490302,25,21,14,4,13,6,2,6,91
380490303,13,9,8,10,2,5,2,6,55
380560101,7,4,2,0,2,0,0,0,15
380560102,31,22,23,25,24,16,6,6,153
380560103,22,13,8,6,9,3,2,2,65
380560104,34,33,34,35,30,21,4,12,203
380560105,32,36,33,27,21,13,6,15,183
380560201,33,22,21,25,16,16,4,7,144
380560202,42,34,44,46,22,15,5,8,216
380560203,13,8,12,8,5,9,0,0,55
380560204,11,15,29,26,25,21,15,14,156
380560301,1,5,1,0,0,0,0,0,7
380560302,3,1,1,0,0,0,1,0,6
380560303,10,7,1,3,0,1,2,0,24
380560304,6,2,1,3,0,0,0,0,12
380630101,12,6,1,1,0,2,1,0,23
380630102,29,30,23,13,5,4,1,0,105
380630103,58,39,57,45,32,18,12,27,288
380630104,64,40,32,40,36,32,13,35,292
380630106,37,27,39,45,46,24,12,35,265
380630107,17,19,16,31,18,25,10,32,168
380630108,5,6,9,11,9,7,1,1,49
380630109,15,20,29,37,23,15,10,20,169
380630110,29,31,44,52,40,22,14,21,253
380630111,21,30,38,38,32,19,13,20,211
380630112,3,0,4,9,3,2,0,3,24
380630119,21,34,51,57,37,57,21,58,336
380630124,49,95,120,84,48,29,12,12,449
380630201,15,6,3,6,5,2,2,1,40
380630202,25,14,22,13,11,8,1,6,100
380630203,29,19,22,34,19,22,6,5,156
380630204,17,5,20,24,14,7,9,10,106
380630205,6,3,5,9,9,6,3,2,43
380630206,51,63,78,67,57,23,13,13,365
380630207,47,70,65,66,39,36,14,22,359
380630208,22,26,42,61,41,18,14,12,236
380630209,10,13,22,15,10,11,5,10,96
380630301,21,13,18,18,14,15,12,15,126
380630302,11,13,4,8,10,6,3,4,59
380630303,51,19,17,28,23,15,5,16,174
380630401,33,53,66,85,40,27,10,25,339
380630402,30,45,43,56,37,15,5,12,243
380630403,36,70,57,39,26,18,10,12,268
380630404,55,60,55,68,45,36,19,19,357
380630405,54,75,61,61,53,38,15,14,371
380630406,18,40,57,52,61,35,16,37,316
380630407,51,75,67,65,54,26,8,12,358
380630408,22,43,38,41,15,17,7,13,196
380630409,52,61,54,44,31,31,8,9,290
380630410,44,46,55,38,35,21,8,16,263
380630411,35,58,43,35,27,7,9,11,225
380630412,26,45,45,41,29,23,12,12,233
380630413,44,71,59,69,55,37,24,17,376
380630414,34,48,52,59,55,35,15,29,327
380630415,49,70,79,67,52,36,26,23,402
380630416,47,66,49,29,20,8,7,6,232
380630417,59,55,50,36,21,13,3,4,241
380630418,34,43,49,52,40,26,8,27,279
380630419,45,52,48,45,34,18,14,8,264
380630420,43,42,56,57,38,32,21,26,315
380630421,34,42,51,47,41,21,11,17,264
380630501,26,57,58,56,43,41,10,25,316
380630502,31,56,53,75,52,38,17,27,349
380630503,30,38,40,53,39,28,15,19,262
380630504,61,70,44,34,28,7,4,2,250
380630505,69,69,53,44,20,10,2,0,267
380630506,40,32,37,29,13,12,2,2,167
380630507,53,84,52,47,20,9,5,5,275
380630508,44,65,68,53,29,24,7,10,300
380630509,22,25,42,38,40,38,18,28,251
380630510,22,51,38,52,46,28,11,22,270
380630511,34,46,53,78,67,51,23,48,400
380630512,38,48,66,38,35,14,3,9,251
380630513,39,52,42,31,14,9,5,6,198
380630514,42,71,67,51,31,13,7,3,285
380630515,42,63,62,64,38,18,16,12,315
380630516,46,63,62,62,37,22,12,9,313
380630517,17,41,44,42,33,19,7,6,209
380630518,18,37,41,42,27,23,10,13,211
380630519,36,33,50,49,41,13,5,9,236
380630520,20,22,28,45,32,26,14,19,206
380630601,25,26,63,72,51,25,13,12,287
380630602,39,58,63,60,27,35,12,10,304
380630603,0,0,0,0,0,0,0,0,0
380630604,3,7,6,7,1,1,0,0,25
380630605,29,43,46,35,13,4,1,0,171
380630606,12,21,40,10,8,4,2,0,97
380630607,18,41,85,76,47,44,13,11,335
380630608,0,0,0,0,0,0,0,0,0
380630609,11,21,43,39,18,9,6,4,151
380630610,12,13,19,16,15,17,2,3,97
380630611,22,33,50,61,27,21,12,2,228
380630612,35,29,61,36,24,11,10,4,210
380630613,21,55,77,102,54,39,7,13,368
380630614,16,44,57,73,47,22,10,10,279
380630615,20,44,68,71,54,42,6,13,318
380630616,21,38,52,79,48,24,18,14,294
380630617,8,29,46,64,58,21,7,11,244
380630618,15,26,39,59,43,22,12,10,226
380700101,76,44,38,32,22,11,9,7,239
380700102,6,7,0,0,0,0,0,0,13
380700105,35,42,53,56,46,34,20,29,315
380700106,45,46,63,71,53,32,25,32,367
380700107,12,20,23,21,12,18,8,5,119
380700201,21,8,7,2,4,2,1,0,45
380700202,62,28,21,21,15,9,6,7,169
380700203,43,25,26,22,18,11,8,11,164
380700204,45,59,75,69,68,38,18,39,411
380700205,31,21,26,21,34,20,8,21,182
380700206,21,22,39,31,24,19,10,11,177
380700207,16,15,18,30,17,10,9,7,122
380700301,15,4,2,2,3,0,0,1,27
380700302,6,4,0,1,0,1,0,1,13
380700303,4,3,2,0,3,1,0,0,13
380700401,5,4,4,3,2,3,1,1,23
380700402,13,6,3,6,4,4,2,0,38
380700403,46,31,39,38,38,21,12,40,265
380700404,31,32,59,51,47,35,21,31,307
380700501,28,16,35,34,25,31,17,32,218
380700502,26,5,16,16,11,11,4,7,96
380700503,12,3,1,1,1,0,0,0,18
380700504,25,22,20,24,19,9,7,10,136
380700505,5,4,2,9,12,2,3,7,44
380700506,41,49,75,63,45,41,20,23,357
380700507,25,43,45,59,38,29,16,27,282
380700508,4,6,23,27,27,15,16,34,152
380700601,13,9,4,5,0,0,2,2,35
380700602,5,6,6,2,2,1,0,0,22
380770101,13,18,9,9,9,7,3,8,76
380770102,13,15,9,4,2,1,2,6,52
380770103,25,10,12,5,6,11,4,8,81
380770201,26,8,8,3,4,2,0,3,54
380770202,15,16,12,4,7,7,7,14,82
380770203,19,14,12,8,4,5,0,3,65
380770204,22,13,11,12,8,4,2,6,78
380770301,58,26,6,17,8,8,7,12,142
380770302,33,13,13,8,2,1,1,1,72
380770303,26,22,11,6,4,8,1,2,80
380770304,8,6,14,15,13,2,4,2,64
380840101,11,19,13,12,6,9,4,8,82
380840102,13,11,7,7,5,3,0,6,52
380840201,21,24,7,11,5,5,3,4,80
380840202,25,10,6,6,4,8,1,6,66
380840301,13,13,1,3,1,2,4,7,44
380840302,20,19,20,26,13,14,10,15,137
380840303,50,23,27,18,16,18,13,40,205
380840401,11,3,9,10,3,3,0,3,42
380840402,4,4,0,1,0,0,0,0,9
380840403,11,8,5,6,7,2,2,3,44
380840501,3,1,2,3,3,0,1,1,14
380840502,11,9,6,5,12,21,4,11,79
380940101,1,3,1,2,1,0,1,1,10
380940102,59,37,26,25,22,8,11,5,193
380940103,53,37,32,33,17,17,6,11,206
380940104,25,22,18,34,25,13,6,11,154
380940201,15,6,3,2,1,1,1,1,30
380940202,11,8,2,2,1,0,0,0,24
380940203,6,2,2,0,0,1,0,0,11
380940301,9,9,2,4,0,0,1,0,25
380940302,15,8,10,5,2,1,0,0,41
380940401,23,19,14,11,3,6,1,4,81
380940402,45,39,39,48,30,27,10,17,255
380940403,28,18,20,24,10,7,6,4,117
380940404,35,33,39,32,25,9,7,7,187
380940405,57,58,56,65,31,21,12,15,315
380940406,46,58,33,41,22,17,5,5,227
380940407,27,31,33,34,18,18,8,9,178
380940408,21,20,39,43,19,17,9,7,175
380940501,35,41,29,33,22,14,14,10,198
380940502,9,5,7,9,3,2,4,3,42
380940503,34,29,30,23,21,14,5,6,162
380940504,41,28,38,37,14,26,9,17,210
380940505,26,28,27,33,17,14,5,10,160
380940506,17,31,45,45,18,14,7,3,180
380940507,21,38,38,34,13,11,6,1,162
380940601,4,3,4,1,1,5,0,0,18
380940602,6,6,3,2,1,1,1,0,20
380940603,2,8,3,1,2,0,0,0,16
380980101,7,10,7,13,7,7,9,5,65
380980102,20,8,4,4,1,1,0,1,39
380980201,0,5,3,1,1,0,0,1,11
380980202,6,2,2,1,0,1,1,2,15
380980203,52,34,16,11,11,12,5,7,148
380980204,22,25,30,25,16,7,5,13,143
380980205,3,9,13,17,12,5,1,2,62
380980301,14,11,9,5,6,2,1,1,49
380980302,11,11,4,2,0,1,1,1,31
380980303,17,4,4,1,2,1,1,1,31
380980401,8,4,5,3,2,2,2,4,30
380980402,10,19,7,10,3,8,6,6,69
380980403,15,16,3,8,5,8,4,7,66
380980404,32,21,20,17,13,12,5,6,126
380980405,60,47,55,44,31,28,18,20,303
380980501,19,9,7,7,10,5,1,6,64
380980502,9,9,5,5,1,1,1,1,32
381050101,7,3,1,0,2,0,0,0,13
381050102,27,10,8,13,5,7,4,3,77
381050103,25,24,16,15,10,8,6,11,115
381050201,19,6,3,1,0,1,0,0,30
381050202,20,16,13,13,5,5,2,5,79
381050203,9,1,0,2,0,0,0,0,12
381050204,15,24,16,10,9,5,4,1,84
381050205,54,33,28,33,11,8,3,9,179
381050301,28,11,7,9,6,4,0,0,65
381050302,10,7,2,0,1,2,1,1,24
381050303,8,5,2,1,1,2,0,1,20
381050401,4,2,2,1,0,7,0,1,17
381050402,12,13,7,10,4,7,1,8,62
381120101,15,31,8,12,9,5,5,7,92
381120102,49,40,45,43,21,15,12,13,238
381120103,42,48,58,43,27,19,10,13,260
381120104,56,52,64,46,37,29,13,13,310
381120105,58,37,35,32,32,16,4,4,218
381120106,32,43,46,49,35,20,11,6,242
381120107,22,47,49,43,33,24,7,14,239
381120108,34,47,40,52,38,21,14,22,268
381120109,52,46,37,52,36,29,8,21,281
381120110,50,46,65,57,38,22,13,25,316
381120111,30,38,51,46,45,28,7,19,264
381120112,44,49,48,35,30,30,10,15,261
381120113,42,27,36,36,55,32,10,27,265
381120114,53,50,39,35,22,15,7,0,221
381120115,30,35,47,43,23,23,11,19,231
381120116,40,54,46,40,25,18,4,1,228
381120117,25,27,39,42,44,28,25,22,252
381120201,14,17,6,8,2,4,3,4,58
381120202,29,15,21,14,23,19,6,6,133
381120203,16,11,3,8,1,2,1,6,48
381120204,14,7,11,7,5,3,3,2,52
381120205,14,26,57,61,48,23,13,17,259
381120206,9,11,3,8,13,3,1,3,51
381120301,13,12,6,3,1,3,1,1,40
381120302,46,37,23,8,12,8,4,9,147
381120303,35,24,17,16,10,5,1,8,116
381120304,16,10,9,7,4,5,1,2,54
381120401,8,6,1,0,1,1,1,1,19
381120402,16,8,6,6,4,4,1,4,49
381120501,23,18,5,12,6,1,0,3,68
381120502,36,25,17,10,9,5,6,6,114
381120503,13,10,7,6,5,6,3,1,51
381120601,13,16,3,3,1,2,1,2,41
381120602,15,10,10,4,5,3,1,3,51
381120603,5,11,6,1,2,1,1,0,27
381120604,12,9,10,8,10,5,3,4,61
420070101,52,49,36,48,24,4,2,0,215
420070102,31,38,31,29,11,2,2,2,146
420070103,3,2,1,1,1,0,0,0,8
420070104,8,4,6,2,0,0,0,0,20
420070105,3,2,1,1,0,0,0,0,7
420070106,5,6,1,0,1,0,0,0,13
420070107,2,3,2,1,0,0,0,0,8
420070108,5,4,7,3,4,0,0,0,23
420070109,6,2,3,3,1,1,0,0,16
420070110,31,51,40,38,18,8,1,1,188
420070201,26,33,25,27,13,7,2,1,134
420070202,46,47,31,18,13,4,2,0,161
420070203,5,7,4,4,1,0,0,1,22
420070204,11,6,8,7,3,0,1,1,37
420070205,3,3,1,1,0,0,0,0,8
420070206,1,0,0,4,1,0,0,0,6
420070207,43,51,50,46,16,7,2,3,218
420070208,31,42,39,34,18,7,4,1,176
420070301,17,31,23,14,10,1,3,1,100
420070302,7,8,3,4,0,1,0,0,23
420070303,3,0,1,1,0,0,0,0,5
420070401,66,75,67,34,19,5,5,1,272
420070402,82,83,48,38,15,2,1,0,269
420070403,58,56,32,21,6,3,1,0,177
420070404,36,59,36,28,8,4,0,0,171
420070405,31,47,45,34,14,1,1,0,173
420070406,53,77,41,46,14,10,5,1,247
420070407,6,5,1,4,1,0,0,0,17
420070408,5,1,1,1,1,0,0,0,9
420070409,23,44,58,77,33,11,3,2,251
420070410,2,1,0,0,0,1,0,0,4
420070411,5,1,2,0,2,0,0,0,10
420070412,0,0,0,0,0,0,0,0,0
420070413,32,36,31,47,20,8,6,3,183
420070501,24,33,34,26,9,6,0,2,134
420070502,0,2,1,2,0,0,0,0,5
420070503,0,1,0,1,0,0,0,0,2
420070504,1,2,2,2,0,0,0,0,7
420070505,3,6,1,4,1,0,0,0,15
420070506,0,0,1,0,0,0,0,1,2
420070507,1,0,3,0,0,0,0,0,4
420070508,24,28,19,19,7,1,2,0,100
420140101,3,6,2,1,1,0,0,0,13
420140102,5,4,4,2,0,0,0,0,15
420140103,6,10,3,4,0,0,0,0,23
420140201,38,36,45,42,28,15,2,3,209
420140202,1,4,2,0,0,0,0,0,7
420140203,27,13,6,1,0,1,0,0,48
420140204,0,0,0,0,0,0,0,0,0
420140205,8,7,4,8,1,2,1,1,32
420140206,5,1,0,2,0,0,0,0,8
420140207,0,0,0,0,0,1,0,0,1
420140208,0,0,0,0,0,0,0,0,0
420140209,4,1,3,0,1,0,0,0,9
420140210,46,61,52,41,22,7,5,1,235
420140211,6,22,24,50,26,8,5,0,141
420210101,16,8,14,5,2,1,0,0,46
420210102,6,4,2,1,0,0,0,0,13
420210103,9,3,4,2,3,0,0,0,21
420210104,3,2,2,2,0,0,0,0,9
420210105,12,22,15,27,21,5,4,7,113
420210106,14,6,1,8,2,0,2,0,33
420210107,7,7,9,4,0,0,1,0,28
420210108,8,6,3,0,1,1,0,0,19
420210109,4,6,1,0,0,0,0,0,11
420210110,9,9,8,4,4,2,0,1,37
420210111,29,48,54,69,34,19,11,8,272
420210112,4,18,33,72,74,41,20,14,276
420210113,12,13,32,42,72,40,15,17,243
420210114,32,27,64,35,13,4,1,1,177
420210115,0,0,0,0,0,0,0,0,0
420210116,0,0,0,0,0,0,0,0,0
420210117,18,15,23,25,15,10,4,9,119
420210118,32,37,44,50,22,8,6,2,201
420210201,19,28,24,31,17,1,3,1,124
420210202,2,6,4,7,0,0,0,0,19
420210203,0,2,1,0,0,0,0,0,3
420210204,2,4,2,3,3,0,0,0,14
420210205,2,7,2,4,1,2,0,0,18
420210206,8,11,5,3,0,0,0,0,27
420210207,4,2,2,2,1,0,0,1,12
420210208,6,2,2,4,0,0,0,0,14
420210209,45,48,46,35,25,25,9,3,236
420210210,25,30,29,40,17,8,1,5,155
420210301,10,14,30,77,52,39,10,8,240
420210302,1,26,42,67,62,39,9,7,253
420210303,44,57,67,62,22,15,3,5,275
420210304,43,45,57,56,30,14,5,8,258
420210305,44,64,54,49,29,13,5,7,265
420210306,22,33,44,59,51,26,24,29,288
420210307,19,37,56,65,37,21,9,7,251
420210308,38,41,58,55,36,11,7,10,256
420210309,38,65,49,44,30,6,8,1,241
420210310,54,72,67,54,28,14,1,2,292
420210311,28,59,72,85,60,20,12,13,349
420210312,31,51,70,102,61,29,9,9,362
420210401,33,50,49,35,30,11,7,8,223
420210402,38,57,54,46,14,6,3,7,225
420210403,37,47,37,43,18,14,3,1,200
420210404,27,69,55,46,22,6,6,4,235
420210405,36,58,43,42,18,7,5,1,210
420210406,50,63,63,51,22,2,1,3,255
420210407,100,119,77,54,15,9,4,0,378
420210408,55,76,60,44,21,5,0,2,263
420210409,4,2,3,4,2,1,0,0,16
420210410,38,44,33,17,7,0,1,1,141
420210411,57,71,22,12,4,1,1,1,169
420210412,86,61,30,18,8,0,0,0,203
420210413,106,108,39,18,8,4,1,0,284
420210414,96,105,54,39,11,5,2,2,314
420210415,53,64,50,27,10,1,2,2,209
420210416,40,75,34,21,12,2,0,0,184
420210417,46,88,41,31,8,1,1,1,217
420210418,37,54,46,52,13,2,0,0,204
420210419,18,60,38,51,16,4,0,1,188
420210420,27,45,67,75,29,12,2,0,257
420210421,20,50,28,41,21,5,1,0,166
420210501,25,34,29,60,42,19,13,9,231
420210502,54,67,71,72,47,26,18,11,366
420210503,65,70,66,68,38,27,7,8,349
420210504,59,71,63,32,24,4,1,3,257
420210505,41,81,70,55,24,12,8,9,300
420210506,94,122,74,68,23,9,1,1,392
420210507,90,116,75,56,28,4,2,1,372
420210508,1,1,0,0,0,0,0,0,2
420210509,50,61,42,35,12,8,1,1,210
420210510,51,74,57,45,38,20,6,3,294
420210511,33,41,45,48,24,33,13,8,245
420210512,23,38,42,49,37,32,19,33,273
420210513,39,56,49,52,27,13,2,5,243
420210514,39,72,39,31,12,9,1,4,207
420210515,108,114,53,39,14,5,3,3,339
420210516,115,131,103,53,22,7,2,1,434
420210601,40,32,46,44,27,17,1,2,209
420210602,41,45,39,41,23,18,7,1,215
420210603,101,105,62,35,19,4,2,3,331
420210604,123,109,53,28,11,0,1,0,325
420210605,59,68,36,14,8,1,0,0,186
420210606,81,57,23,15,1,1,0,0,178
420210607,79,77,43,23,12,2,0,0,236
420210608,51,61,20,9,5,3,0,0,149
420210609,85,52,20,3,2,1,0,0,163
420210610,0,0,0,0,1,0,0,1,2
420210611,81,73,28,16,5,2,0,1,206
420210612,95,64,20,9,1,2,0,0,191
420210613,141,77,43,18,7,4,0,1,291
420210614,116,87,47,34,6,5,1,0,296
420210615,103,54,21,14,1,0,0,0,193
420210616,74,51,26,12,3,1,0,0,167
420210701,57,76,33,14,8,2,0,0,190
420210702,53,47,38,15,8,1,0,0,162
420210703,118,99,34,23,2,1,1,0,278
420210704,119,91,40,16,4,3,2,0,275
420210705,123,103,36,26,11,1,1,0,301
420210706,84,64,30,19,2,2,1,0,202
420210707,75,80,44,26,15,2,1,1,244
420210708,66,107,45,37,11,3,0,0,269
420210709,55,74,27,27,11,4,0,1,199
420210710,35,58,36,31,11,4,2,1,178
420210711,28,42,29,36,13,2,1,1,152
420210712,40,50,62,35,13,5,2,6,213
420210713,55,65,52,33,20,10,4,2,241
420210714,82,83,59,45,15,5,0,2,291
420210715,53,103,86,54,20,2,1,0,319
420210716,29,71,42,29,12,3,1,0,187
420210717,57,72,53,23,8,2,2,1,218
420210718,33,53,40,33,12,7,2,3,183
420210719,59,61,58,67,27,17,4,5,298
420210720,40,58,49,48,31,18,15,6,265
420210721,38,65,47,56,33,21,10,7,277
420210722,43,60,64,51,46,19,8,5,296
420210723,28,58,66,61,25,11,1,4,254
420210724,27,40,37,44,29,8,0,0,185
420210725,24,45,20,35,16,3,1,0,144
420210801,68,62,20,14,4,1,0,1,170
420210802,77,65,25,15,9,1,1,0,193
420210803,102,60,18,7,6,0,0,0,193
420210804,84,73,52,19,8,3,2,0,241
420210805,128,90,53,24,4,4,0,0,303
420210806,77,71,59,26,9,4,2,2,250
420210807,82,87,46,25,14,3,1,1,259
420210808,96,113,58,45,15,9,1,2,339
420210809,64,80,54,38,11,5,2,0,254
420210810,60,76,81,33,29,10,3,3,295
420210811,60,66,34,21,14,5,1,0,201
420210812,56,57,39,18,13,4,0,2,189
420210813,81,74,24,16,6,4,0,0,205
420210814,86,70,53,32,15,4,1,0,261
420210815,54,69,62,51,26,9,1,5,277
420210816,51,70,81,48,27,12,7,5,301
420210817,26,46,56,40,21,13,6,4,212
420210818,32,42,37,50,27,7,7,7,209
420210819,25,45,45,44,24,10,6,9,208
420210820,21,31,44,54,35,14,4,3,206
420210821,28,62,60,80,43,14,7,5,299
420210822,18,37,47,45,18,11,4,4,184
420210823,20,33,41,34,16,2,2,1,149
420210824,45,40,58,50,11,2,1,0,207
420210901,74,40,20,3,1,0,0,0,138
420210902,67,136,48,33,11,4,2,0,301
420210903,80,137,73,48,12,1,0,1,352
420210904,88,95,76,48,18,8,3,0,336
420210905,24,45,62,71,55,41,17,7,322
420210906,17,18,31,21,13,16,7,13,136
420210907,67,88,85,46,29,6,10,0,331
420210908,64,100,98,75,25,15,7,2,386
420210909,56,61,43,17,13,4,0,3,197
420210910,44,78,47,27,7,1,2,1,207
420210911,52,71,51,45,14,4,3,0,240
420210912,50,82,83,72,43,25,3,9,367
420210913,71,60,78,37,15,1,1,0,263
420210914,44,40,34,30,19,6,1,1,175
420210915,39,60,46,44,17,9,3,1,219
420210916,44,70,60,65,39,21,9,14,322
420210917,17,29,32,67,27,18,7,2,199
420211001,25,61,80,78,37,18,13,17,329
420211002,35,67,71,60,52,32,9,11,337
420211003,13,32,40,57,34,13,6,1,196
420211004,23,64,63,78,39,20,6,1,294
420211005,23,65,60,52,58,18,7,7,290
420211006,18,44,62,73,44,21,6,4,272
420280101,24,32,32,23,20,11,5,1,148
420280102,8,6,2,1,2,1,0,0,20
420280103,21,14,9,6,4,0,0,0,54
420280104,12,7,4,3,1,1,0,0,28
420280105,29,37,23,28,18,13,3,0,151
420280201,75,81,81,62,22,13,2,1,337
420280202,15,28,17,24,11,6,0,0,101
420280203,53,52,46,24,9,9,0,0,193
420280301,51,74,53,48,28,11,4,6,275
420280302,44,54,46,34,16,10,5,6,215
420280303,46,41,63,85,47,28,14,9,333
420280304,52,60,43,47,18,14,6,9,249
420280305,50,56,41,35,19,11,4,5,221
420280401,11,11,4,3,6,1,0,0,36
420280402,10,8,4,3,3,0,0,0,28
420350101,24,18,10,11,10,3,1,1,78
420350102,0,0,0,1,0,0,0,0,1
420350103,3,3,1,1,0,0,0,0,8
420350104,2,5,2,3,1,0,0,0,13
420350105,3,8,0,3,2,1,0,0,17
420350106,4,2,1,1,1,0,0,0,9
420350201,26,25,31,32,15,12,0,2,143
420350202,22,19,14,12,6,4,1,0,78
420350301,1,1,0,1,0,0,0,0,3
420350302,0,6,2,2,0,0,0,0,10
420350303,1,2,5,0,0,0,0,0,8
420350304,3,2,0,0,0,0,0,0,5
420350305,1,0,1,0,0,0,0,1,3
420350306,19,42,41,53,22,6,4,2,189
420350307,2,3,1,1,0,1,0,0,8
420350308,4,7,4,5,2,0,0,0,22
420350309,12,44,33,37,13,5,3,2,149
420350310,45,52,81,69,34,24,6,6,317
420350401,33,42,31,37,24,4,2,5,178
420350402,35,34,37,32,19,13,1,1,172
420350403,52,74,65,54,16,1,0,1,263
420350404,37,43,48,43,13,6,4,0,194
420350405,58,86,47,47,13,6,2,0,259
420350406,56,60,33,22,7,2,0,0,180
420350407,74,71,43,20,4,3,0,0,215
420350408,47,57,28,16,4,3,0,1,156
420350409,36,52,43,27,13,8,2,1,182
420350410,45,50,31,21,6,6,0,1,160
420350411,18,53,32,18,14,2,3,1,141
420350412,63,86,59,31,15,4,2,3,263
420350413,55,62,44,46,12,11,1,6,237
420350501,21,19,10,16,8,0,1,0,75
420350502,7,7,4,4,4,0,0,0,26
420350503,10,4,2,0,1,1,0,0,18
420350504,5,4,2,4,0,0,1,0,16
420350505,17,21,18,18,9,3,2,1,89
420350601,50,55,41,40,18,5,2,6,217
420350602,53,72,27,29,22,2,2,0,207
420350603,6,3,3,1,1,0,0,0,14
420350604,4,10,3,2,1,0,0,0,20
420350605,6,5,4,5,2,1,0,0,23
420350606,2,2,4,3,4,0,0,0,15
420350607,3,3,3,3,0,1,0,0,13
420350608,15,16,14,11,2,1,0,1,60
420350609,37,60,50,36,21,8,3,2,217
420350610,41,55,26,28,8,3,2,1,164
420350701,30,32,20,25,3,1,0,2,113
420350702,3,1,2,2,0,0,0,0,8
420350703,0,4,2,1,0,0,0,0,7
420350704,3,4,6,3,1,0,0,0,17
420350705,3,3,5,3,2,0,0,0,16
420420101,0,2,0,0,0,0,0,0,2
420420102,1,0,0,0,0,0,0,0,1
420420103,0,0,0,1,0,0,0,0,1
420420104,2,0,0,0,0,0,0,0,2
420420105,0,0,0,0,0,0,0,0,0
420420106,0,0,1,0,1,0,0,0,2
420420107,3,3,1,0,0,0,0,0,7
420420201,39,30,23,30,13,4,2,2,143
420420202,23,16,9,3,2,2,0,0,55
420420301,24,24,18,28,7,6,4,2,113
420420302,8,4,1,1,0,0,0,0,14
420420303,2,0,1,0,0,0,0,0,3
420420304,0,0,0,0,0,0,0,0,0
420420305,0,0,1,0,0,0,0,0,1
420420306,5,2,0,1,1,0,0,0,9
420420307,2,1,0,0,0,0,0,0,3
420420308,1,3,0,0,0,0,0,0,4
420490101,38,43,30,30,9,9,3,8,170
420490102,25,55,61,71,32,14,4,2,264
420490103,47,33,28,27,14,6,4,2,161
420490104,4,6,1,0,0,0,0,0,11
420490105,16,14,12,6,4,2,0,0,54
420490106,18,9,6,3,1,1,0,0,38
420490107,40,33,38,22,13,9,2,1,158
420490108,12,16,21,16,8,8,4,6,91
420560101,55,72,42,37,24,4,2,5,241
420560102,13,10,5,4,1,2,1,0,36
420560201,11,15,8,10,4,0,3,2,53
420560202,2,6,6,1,1,0,0,0,16
420560301,29,43,23,24,6,5,1,0,131
420560302,25,17,4,5,6,0,0,1,58
420560303,55,74,70,50,25,14,3,4,295
420560304,30,33,23,8,5,3,1,3,106
420560401,24,15,24,18,11,3,5,2,102
420560402,4,13,4,5,4,1,0,2,33
420560501,102,85,67,33,11,1,1,1,301
420560502,81,104,55,36,18,6,1,0,301
420560503,46,53,42,27,23,3,2,1,197
420560504,54,52,34,27,12,5,3,0,187
420560505,7,9,5,5,0,1,0,0,27
420560506,30,31,28,22,6,5,0,2,124
420560507,9,6,5,3,2,0,0,0,25
420560508,5,5,3,0,1,0,0,0,14
420560509,2,8,2,3,1,0,0,1,17
420560510,4,9,8,5,0,1,0,0,27
420560511,32,45,41,54,33,12,4,4,225
420560512,23,30,29,29,12,6,1,3,133
420560513,15,38,25,30,14,3,2,5,132
420560514,46,68,38,26,15,5,0,2,200
420560515,52,62,87,56,30,22,9,8,326
420560516,31,39,37,53,43,22,13,7,245
420560517,32,34,31,31,18,9,7,6,168
420560601,45,81,47,36,23,6,3,2,243
420560602,7,5,3,4,0,2,0,0,21
420630101,19,13,22,20,5,13,0,1,93
420630102,20,22,33,23,13,3,2,2,118
420630103,28,31,30,17,11,6,3,0,126
420630104,1,0,0,0,0,0,0,0,1
420630105,3,3,0,1,0,0,0,0,7
420630106,2,7,6,10,0,4,2,0,31
420630107,27,21,25,14,6,1,4,0,98
420700101,54,60,35,24,12,1,0,0,186
420700102,5,2,0,0,0,0,0,0,7
420700103,21,27,19,11,8,2,0,1,89
420700104,51,39,24,16,14,2,2,0,148
420700105,39,56,37,30,13,3,3,2,183
420700106,40,56,42,24,12,1,0,0,175
420700201,91,94,69,65,28,6,1,0,354
420700202,13,14,5,6,7,2,0,0,47
420700203,0,0,0,1,0,0,0,0,1
420700301,1,1,1,4,1,2,0,0,10
420700302,11,8,3,6,0,0,0,0,28
420700401,52,49,33,31,8,4,1,1,179
420700402,11,13,10,7,4,6,0,0,51
420700501,86,112,63,49,24,6,3,0,343
420700502,81,106,51,29,11,5,0,0,283
420700503,77,73,41,27,10,2,0,0,230
420700504,7,31,18,28,19,50,12,43,208
420700505,34,47,26,30,6,4,0,0,147
420700506,11,11,6,7,2,0,0,0,37
420700507,64,74,57,54,21,8,1,3,282
420700508,54,64,43,30,19,4,0,0,214
420770101,25,27,30,15,8,2,2,0,109
420770102,3,0,0,0,0,0,0,0,3
420770103,1,2,0,3,0,0,0,0,6
420770104,1,3,0,0,0,1,0,0,5
420770105,4,2,0,4,0,0,0,0,10
420770106,5,1,2,0,0,0,0,0,8
420770107,10,5,4,1,1,0,0,0,21
420770108,12,12,9,5,2,1,0,0,41
420770201,46,67,34,27,14,4,4,2,198
420770202,37,49,52,34,10,1,1,0,184
420770203,46,40,29,19,6,4,2,0,146
420770204,5,6,4,0,2,0,0,0,17
420770205,4,6,0,1,0,0,0,0,11
420770206,3,5,3,4,1,0,1,0,17
420770207,11,9,5,0,0,0,0,0,25
420770208,8,3,2,1,0,1,0,0,15
420770209,2,2,1,0,0,0,0,0,5
420770210,39,63,27,21,12,0,1,0,163
420770211,38,59,21,24,9,2,1,0,154
420770212,33,34,39,17,10,4,3,1,141
420770301,62,84,47,33,9,4,2,0,241
420770302,54,53,32,20,5,3,0,2,169
420770303,4,5,0,0,0,0,0,0,9
420770304,11,5,3,3,0,1,1,1,25
420770305,7,10,4,1,0,1,0,0,23
420770306,16,20,16,15,8,2,3,0,80
420770307,31,41,27,27,3,3,0,1,133
420770401,66,93,73,37,19,7,3,0,298
420770402,52,54,39,35,21,6,1,1,209
420770403,2,3,2,0,0,0,0,0,7
420770404,4,3,1,2,1,0,0,0,11
420770405,1,2,0,1,0,0,0,0,4
420770406,3,3,2,1,2,1,0,1,13
420770407,1,0,2,0,0,0,0,0,3
420770408,2,1,0,1,1,0,0,0,5
420770409,63,53,37,30,19,4,2,0,208
420770410,52,55,46,23,8,5,2,0,191
420840101,16,14,21,10,4,1,2,0,68
420840102,25,11,8,1,0,0,0,0,45
420840201,10,4,2,0,0,0,0,0,16
420840202,14,10,1,1,2,0,0,0,28
420840203,5,5,1,0,0,1,0,0,12
420840204,0,0,0,0,0,0,0,0,0
420840205,3,0,0,0,0,0,0,0,3
420840206,1,0,2,0,0,1,1,1,6
420840207,2,1,0,1,0,0,0,0,4
420910101,8,4,5,6,4,0,0,0,27
420910102,10,11,11,2,4,2,0,0,40
420910103,17,8,6,1,0,0,0,0,32
420910104,9,7,1,0,3,1,0,0,21
420910105,15,13,12,15,9,3,2,0,69
420980101,34,47,41,33,16,11,5,6,193
420980102,16,33,35,25,10,7,2,2,130
420980103,27,33,30,34,25,12,5,6,172
420980104,12,15,37,36,27,13,2,1,143
420980105,29,33,34,30,15,10,6,2,159
420980106,37,33,32,20,7,5,1,0,135
420980107,43,44,30,27,14,4,3,1,166
420980108,41,34,29,27,12,5,1,2,151
420980109,53,61,41,37,11,9,3,1,216
420980110,38,45,44,33,17,7,2,4,190
420980111,33,46,37,38,15,13,5,3,190
420980112,4,7,3,3,2,5,0,0,24
420980113,23,6,4,3,1,1,1,0,39
420980114,6,9,4,1,0,0,0,0,20
420980201,50,46,41,32,27,14,3,4,217
420980202,8,9,3,4,2,0,0,0,26
420980301,36,27,50,36,21,8,6,6,190
420980302,26,23,10,1,5,1,1,0,67
420980303,41,48,41,41,20,6,2,4,203
420980401,15,25,21,12,14,4,2,2,95
420980402,47,28,13,7,2,0,1,0,98
421050101,15,25,34,24,11,4,1,2,116
421050102,1,0,0,0,1,0,0,0,2
421050103,21,9,7,2,1,1,0,0,41
421050201,4,3,5,0,1,1,0,1,15
421050202,12,6,5,4,0,2,0,0,29
421050203,19,11,6,6,6,2,0,1,51
421050204,6,2,1,4,0,0,0,0,13
421050205,3,3,1,2,0,0,0,0,9
421050206,42,46,40,42,22,4,5,6,207
421050207,34,39,44,35,19,5,0,1,177
421050301,44,72,45,62,27,11,3,1,265
421050302,45,57,47,26,11,3,3,2,194
421050303,53,51,55,36,16,9,3,2,225
421050304,74,71,44,30,8,5,1,1,234
421050305,55,90,40,26,6,7,0,0,224
421050306,80,58,39,18,4,2,1,1,203
421050307,56,59,20,10,7,3,0,0,155
421050308,66,83,32,23,7,2,1,1,215
421050309,72,73,35,17,8,2,3,0,210
421050310,96,77,36,14,3,3,1,2,232
421050311,53,63,42,31,7,11,3,2,212
421050312,87,78,43,25,7,3,0,0,243
421050313,71,65,26,20,10,0,0,0,192
421050314,55,51,25,17,3,4,1,0,156
421050401,43,72,84,77,32,7,3,0,318
421050402,31,58,75,63,41,24,14,13,319
421050403,20,52,53,59,49,20,10,19,282
421050404,47,46,64,77,41,39,17,18,349
421050405,62,86,62,51,23,12,3,7,306
421050406,71,116,77,69,40,12,7,3,395
421050407,0,4,10,11,3,3,0,1,32
421050408,48,69,53,33,12,5,1,1,222
421050409,80,88,49,31,6,5,1,0,260
421050410,71,82,25,14,11,4,0,0,207
421050411,69,73,31,25,10,4,0,0,212
421050412,54,60,35,31,13,4,1,1,199
421050413,61,73,42,22,7,3,0,0,208
421050414,69,89,36,23,11,6,1,0,235
421050415,59,62,36,18,8,1,1,0,185
421050416,73,40,25,12,4,0,0,0,154
421050417,72,59,45,11,3,1,0,1,192
421050418,62,59,39,18,9,3,0,0,190
421050419,31,45,37,33,23,8,4,6,187
421050501,23,39,27,26,10,3,1,2,131
421050502,3,7,0,1,0,0,0,0,11
421050503,11,13,8,9,4,3,0,2,50
421050504,4,2,2,5,1,1,0,0,15
421050601,21,23,24,17,10,2,1,1,99
421050602,11,5,7,8,3,1,0,0,35
421050701,61,77,59,46,26,13,4,4,290
421050702,53,69,35,28,10,5,3,2,205
421050703,68,106,57,37,17,0,2,2,289
421050704,80,83,49,22,11,4,0,0,249
421050705,80,96,73,46,17,8,1,0,321
421050706,24,60,63,60,37,16,9,7,276
421050707,25,19,28,20,6,6,2,2,108
421050708,23,43,34,41,29,22,6,10,208
421050709,71,83,60,50,21,13,1,2,301
421050710,75,84,41,32,18,3,1,1,255
421050711,75,90,62,36,17,2,1,1,284
421050712,72,88,67,45,24,11,8,5,320
421050713,44,57,57,53,34,20,6,9,280
421050714,36,52,66,50,33,12,13,6,268
421050715,36,49,48,46,18,13,6,9,225
421050716,37,69,55,40,19,7,2,3,232
421050717,45,100,91,63,23,7,1,2,332
421050718,20,31,44,42,31,25,9,14,216
421050801,41,50,72,117,82,46,9,11,428
421050802,18,30,39,51,26,9,3,2,178
421050803,16,34,49,74,29,19,5,3,229
421050804,27,76,85,74,49,33,13,9,366
421050805,37,84,70,50,41,17,8,9,316
421050806,3,12,42,69,75,25,9,9,244
421050807,70,78,71,63,56,31,9,10,388
421050808,56,53,50,45,18,3,2,2,229
421050901,27,34,64,50,29,17,5,13,239
421050902,9,15,22,21,26,12,4,5,114
421050903,1,2,19,21,29,19,7,5,103
421050904,1,15,36,67,53,32,16,6,226
421050905,15,39,50,49,52,18,11,15,249
421050906,14,32,47,61,43,23,11,7,238
421051001,50,52,77,72,35,8,2,2,298
421051002,42,75,69,84,20,8,2,2,302
421051003,129,99,51,31,16,5,2,0,333
421051004,45,69,35,41,15,6,3,3,217
421051005,62,93,64,50,18,10,4,8,309
421051006,63,72,50,22,9,6,3,1,226
421051007,18,29,41,28,32,16,8,9,181
421051008,47,56,45,34,11,8,3,2,206
421051009,43,45,36,27,11,5,0,1,168
421051010,80,71,49,26,8,6,2,0,242
421051011,64,81,50,26,15,12,2,4,254
421051012,62,91,69,62,29,19,8,8,348
421120101,24,19,14,22,17,8,2,2,108
421120102,37,39,23,23,12,5,3,7,149
421120201,15,6,1,1,2,0,0,0,25
421120301,36,40,51,40,25,13,7,8,220
421120302,37,43,44,36,13,6,2,4,185
421120303,54,66,63,45,22,16,5,1,272
421120304,17,13,15,10,5,5,0,0,65
421120305,60,62,70,57,29,19,4,9,310
421120306,29,45,52,83,46,34,18,14,321
421120307,38,61,50,49,22,11,7,5,243
421120308,11,27,53,90,53,30,10,12,286
421120309,7,14,38,64,31,14,6,7,181
421120310,12,7,13,9,3,1,0,0,45
421120311,4,2,2,1,1,0,0,0,10
421120312,58,82,54,51,23,11,5,12,296
421120313,12,1,0,1,1,1,0,0,16
421120314,6,2,0,1,0,0,0,0,9
421120315,3,5,4,1,2,1,0,2,18
421120316,3,1,2,1,1,0,0,1,9
421120317,1,0,0,0,0,0,0,0,1
421120318,0,2,0,1,0,0,0,0,3
421120319,4,0,0,1,0,0,0,0,5
421120320,3,1,1,0,0,0,0,0,5
421120321,2,1,0,0,0,0,1,0,4
421120322,2,0,1,0,1,0,0,0,4
421190101,57,64,51,22,11,2,2,3,212
421190102,0,2,0,1,0,0,0,0,3
421190103,1,4,1,2,0,0,1,0,9
421190104,5,3,1,1,2,1,0,1,14
421190201,58,57,15,21,8,0,0,0,159
421190202,23,32,16,14,9,12,4,3,113
421190203,84,94,65,29,17,3,3,0,295
421190204,39,74,57,39,21,7,5,4,246
421190205,5,8,3,4,2,1,0,0,23
421190206,6,5,1,4,2,0,0,0,18
421190207,1,2,1,1,0,0,0,0,5
421190208,3,5,1,1,1,1,0,0,12
421190209,1,4,2,1,0,0,1,1,10
421190210,1,7,0,2,0,0,0,0,10
421190211,34,44,43,33,13,8,4,1,180
421190212,38,52,50,67,47,22,3,8,287
421190301,76,58,45,42,17,10,5,1,254
421190302,83,97,47,33,20,8,1,1,290
421190303,5,5,4,0,1,0,0,0,15
421190304,2,0,0,1,0,0,0,0,3
421190305,3,9,3,0,1,0,0,0,16
421190306,2,6,6,0,2,0,0,0,16
421190307,3,5,3,4,5,0,0,0,20
421190308,8,5,3,6,1,1,0,0,24
421190309,0,1,0,0,0,0,0,0,1
421190310,0,1,1,1,0,0,0,0,3
421190311,66,84,50,43,20,10,2,1,276
421190312,67,80,49,32,17,7,2,2,256
421190401,74,73,49,48,26,4,2,7,283
421190402,8,9,3,3,4,5,2,1,35
421190403,2,4,8,5,3,1,0,0,23
421190404,6,1,6,1,0,1,0,0,15
421190405,6,2,3,0,2,0,0,0,13
421260101,44,52,54,37,20,19,6,2,234
421260102,50,72,40,44,22,11,1,1,241
421260103,55,67,51,49,19,4,4,3,252
421260104,1,2,1,3,0,1,0,0,8
421260105,1,2,7,3,4,0,0,0,17
421260106,5,2,1,2,0,0,0,0,10
421260107,5,2,3,5,3,1,1,0,20
421260108,16,12,8,5,2,2,2,0,47
421260109,5,4,1,3,3,0,1,0,17
421260110,9,6,4,3,1,0,0,0,23
421260111,28,32,39,44,28,14,8,4,197
421260112,22,28,31,23,18,5,5,3,135
421260201,60,64,48,49,25,16,7,4,273
421260202,33,31,31,27,25,5,4,0,156
421260203,25,33,33,26,10,5,1,1,134
421260204,2,2,0,0,0,1,1,0,6
421260205,13,28,24,17,10,14,2,1,109
421260206,3,2,2,1,0,0,0,0,8
421260207,10,16,20,21,9,7,1,1,85
421260208,42,39,20,29,10,6,4,0,150
421260301,1,2,2,0,2,1,0,0,8
421260302,8,3,1,4,2,2,0,0,20
421260303,1,5,0,1,1,0,0,0,8
421260304,4,2,0,1,0,0,0,0,7
421260401,33,34,25,43,14,12,3,1,165
421260402,3,1,0,3,1,1,1,2,12
421260403,5,1,3,2,0,1,0,0,12
421260404,6,5,2,0,1,0,0,0,14
421260405,5,8,8,4,3,1,2,1,32
421260406,6,3,3,4,0,0,0,0,16
421260407,29,25,32,39,21,12,5,7,170
421260501,47,34,31,23,11,5,4,4,159
421260502,15,19,15,12,2,6,0,1,70
421260503,13,13,2,4,2,1,0,0,35
421260504,4,2,3,1,1,0,0,0,11
421260505,3,1,2,1,1,0,0,0,8
421260506,10,11,14,14,12,7,3,1,72
421260507,0,3,0,1,0,0,0,0,4
421260508,1,2,0,1,0,0,0,0,4
421260509,33,61,52,21,8,1,5,0,181
421260510,45,44,43,54,18,15,4,4,227
421260511,41,37,21,28,5,5,2,1,140
421330101,28,20,16,23,5,7,1,2,102
421330102,3,2,2,1,0,0,0,0,8
421330103,3,5,3,1,1,0,0,0,13
421330201,63,72,50,47,28,9,4,6,279
421330202,50,49,29,15,6,2,1,0,152
421330203,59,68,46,35,24,6,1,3,242
421330204,62,57,33,28,11,7,1,0,199
421330205,78,98,45,30,15,2,1,0,269
421330206,6,3,6,2,1,1,0,0,19
421330207,29,44,66,98,39,34,14,10,334
421330208,0,0,0,0,0,0,0,0,0
421330209,2,0,0,0,0,0,0,0,2
421330210,1,0,0,0,0,0,0,0,1
421330211,25,47,34,24,21,16,5,8,180
421330212,16,22,26,22,12,8,4,5,115
421330213,10,22,28,28,11,8,2,2,111
421330214,50,65,41,28,9,5,0,2,200
421330215,47,67,39,35,13,6,3,2,212
421330216,26,42,53,46,25,11,7,4,214
421330301,26,25,18,15,6,5,2,1,98
421330302,2,3,4,3,1,0,0,0,13
421330401,11,13,11,13,3,3,2,1,57
421330402,3,5,5,4,0,1,0,0,18
421330403,1,4,1,3,1,0,1,0,11
421330501,37,44,31,40,15,2,3,3,175
421330502,61,51,33,26,15,1,1,1,189
421330503,50,64,36,32,15,4,0,4,205
421330504,46,37,40,28,15,11,3,1,181
421330505,27,45,42,36,18,6,2,5,181
421330506,5,3,1,0,0,0,0,0,9
421330507,5,9,6,1,1,1,1,0,24
421330508,52,76,60,59,20,13,3,0,283
421330509,31,33,32,21,16,10,0,5,148
421330510,20,29,46,49,28,12,9,3,196
421330601,34,40,32,37,22,12,4,4,185
421330602,57,78,47,37,16,4,1,2,242
421330603,3,2,0,0,1,0,0,0,6
421330604,7,11,7,12,7,3,1,1,49
421330605,3,3,1,1,0,0,0,0,8
421330701,53,78,38,45,19,5,3,3,244
421330702,46,73,42,36,16,8,0,0,221
421330703,0,4,3,1,2,2,0,3,15
421330704,8,5,7,10,5,4,0,0,39
421330705,3,2,1,3,2,0,0,0,11
421330706,0,4,1,1,1,0,0,0,7
421330707,1,1,0,2,0,0,0,1,5
421400101,6,3,3,0,1,0,0,0,13
421400102,16,10,4,2,1,0,0,0,33
421400103,10,5,1,1,0,0,0,0,17
421400104,2,0,0,0,0,0,0,0,2
421400201,35,43,38,35,26,6,8,5,196
421400202,28,37,34,43,27,16,7,7,199
421400203,29,29,38,28,16,16,11,11,178
421400204,24,37,54,51,38,15,8,7,234
421400205,23,44,50,26,19,5,3,4,174
421400206,32,57,33,37,28,19,3,3,212
421400207,13,31,38,45,24,14,10,7,182
421400208,58,41,40,28,10,4,3,0,184
421400209,32,40,51,43,17,11,5,4,203
421400210,59,63,50,32,19,14,5,1,243
421400211,30,66,72,63,40,23,10,8,312
421400212,41,32,45,32,26,10,6,3,195
421400213,7,7,6,13,12,4,4,1,54
421400214,3,3,14,20,10,6,0,0,56
421400215,26,41,24,33,12,3,0,1,140
421400216,34,42,40,34,14,2,0,0,166
421400217,20,33,36,40,16,8,0,0,153
421400218,24,27,44,37,11,1,0,0,144
421400219,18,34,39,30,16,0,1,1,139
421400220,33,25,12,6,3,1,0,0,80
421400221,15,8,6,5,1,0,0,0,35
421400222,20,32,42,39,21,11,6,4,175
421400223,21,12,12,7,3,1,1,1,58
421400301,0,0,1,0,0,0,0,0,1
421400302,21,17,11,5,0,0,0,0,54
421400303,2,0,1,1,0,0,0,0,4
421470101,47,49,31,18,9,11,1,0,166
421470102,0,1,0,1,0,0,0,0,2
421470103,2,0,1,0,0,0,0,0,3
421470104,0,4,5,0,1,1,0,0,11
421470105,2,4,1,0,0,0,0,0,7
421470106,6,4,3,2,0,0,0,1,16
421470107,4,2,4,3,0,1,0,0,14
421470108,0,4,5,3,3,0,0,0,15
421470109,35,51,43,34,20,4,7,2,196
421470201,27,54,58,27,30,16,9,3,224
421470202,49,53,28,32,8,1,1,1,173
421470203,3,3,0,5,0,1,0,2,14
421470204,0,0,0,1,0,0,0,0,1
421470205,1,3,2,1,0,0,0,0,7
421470206,3,5,2,1,1,0,0,0,12
421470207,3,2,1,1,0,0,0,0,7
421470208,6,2,1,0,0,0,0,0,9
421470209,5,2,3,2,2,1,0,1,16
421470210,4,8,10,7,1,2,0,0,32
421470211,3,2,1,3,0,0,0,0,9
421470212,1,1,2,2,0,0,0,0,6
421470213,1,1,0,1,0,0,0,0,3
421470214,39,62,47,52,19,10,2,2,233
421470215,52,78,55,60,27,11,5,3,291
421470216,50,64,43,34,19,5,0,0,215
421470301,41,38,24,27,15,9,7,1,162
421470302,2,1,1,1,3,0,0,0,8
421540101,12,17,17,13,6,4,1,0,70
421540102,10,15,8,3,1,1,1,0,39
421540103,24,14,5,3,0,0,0,0,46
421540201,39,35,28,28,14,3,1,0,148
421540202,41,23,15,4,4,1,0,0,88
421540301,52,69,44,41,21,10,5,0,242
421540302,20,15,9,4,5,0,0,0,53
421540401,17,9,6,5,0,1,0,0,38
421540402,8,10,5,1,0,0,0,0,24
421540403,21,11,12,6,0,4,2,0,56
421540404,11,6,9,1,1,0,0,1,29
421540501,17,26,22,14,9,1,0,1,90
421540502,78,84,50,31,19,9,0,2,273
421540503,69,73,41,27,14,8,2,2,236
421540504,52,50,38,34,19,10,7,2,212
421540505,80,83,59,41,12,5,0,6,286
421540506,66,65,38,21,15,0,2,0,207
421540507,81,62,51,26,6,5,2,2,235
421540508,35,54,47,44,26,3,4,0,213
421540509,21,45,67,57,27,9,3,4,233
421540510,56,62,33,33,9,6,1,1,201
421540511,53,61,53,34,13,6,1,3,224
421540512,47,35,76,67,43,14,4,9,295
421540513,33,40,62,69,51,16,12,11,294
421540514,33,53,46,49,19,4,7,4,215
421540515,51,69,65,31,28,12,5,3,264
421540516,22,43,67,58,39,20,8,4,261
421540517,11,16,36,87,49,24,10,8,241
421540601,30,41,20,16,4,1,2,1,115
421540602,4,5,2,2,0,0,0,0,13
421540701,11,2,9,4,1,1,0,0,28
421540702,12,14,3,6,0,0,0,1,36
460070101,40,46,61,65,43,38,8,14,315
460070102,43,54,49,49,31,20,7,5,258
460070103,67,84,67,55,51,35,9,18,386
460070104,31,39,56,62,45,27,23,23,306
460070105,42,71,58,60,36,28,11,11,317
460070106,20,17,16,16,16,4,1,7,97
460070107,45,31,50,55,30,27,9,12,259
460070108,53,57,60,72,34,36,18,15,345
460070109,32,36,33,46,34,17,9,15,222
460070110,31,34,33,24,31,18,7,12,190
460070111,38,42,82,66,64,41,14,16,363
460070112,42,51,87,110,71,34,18,11,424
460070201,55,64,64,45,44,23,9,13,317
460070202,19,19,20,19,13,10,6,5,111
460070203,5,6,3,1,1,0,0,0,16
460070204,29,21,25,36,20,19,11,22,183
460140101,48,34,21,25,19,8,14,11,180
460140102,6,10,5,1,3,1,0,2,28
460140103,87,101,86,93,54,38,12,16,487
460140104,29,41,51,44,22,12,3,7,209
460140105,25,25,49,55,33,34,10,8,239
460140106,41,48,66,96,46,35,16,15,363
460140107,26,31,58,67,54,51,27,34,348
460140108,32,32,60,41,28,27,9,8,237
460140109,65,58,106,108,76,55,15,27,510
460140110,47,59,94,125,79,57,42,19,522
460140111,58,52,74,103,44,23,11,4,369
460140201,6,13,3,1,2,1,2,0,28
460140202,29,31,11,10,5,9,1,7,103
460140301,13,11,8,4,5,2,1,1,45
460140302,13,8,18,18,13,6,3,4,83
460140401,38,55,55,57,47,14,10,11,287
460140402,36,62,57,49,40,23,3,5,275
460140403,36,56,56,49,30,17,2,1,247
460140404,50,68,94,86,48,24,10,14,394
460140405,21,39,53,54,44,30,5,11,257
460140406,38,37,62,69,45,31,8,10,300
460140407,37,34,60,42,35,17,11,14,250
460140408,46,87,79,84,40,29,5,3,373
460140409,30,55,54,51,37,32,9,10,278
460140410,57,71,56,38,19,14,2,1,258
460140411,60,81,87,81,61,32,22,10,434
460140412,45,60,58,42,28,25,17,11,286
460140413,56,54,50,73,50,30,12,16,341
460140414,26,51,35,43,34,22,6,4,221
460140415,30,37,52,60,29,21,3,3,235
460140416,45,41,62,55,42,27,3,5,280
460140417,29,44,43,54,24,24,5,8,231
460140418,45,40,45,40,27,25,5,3,230
460140501,30,39,66,41,33,20,6,4,239
460140502,29,38,62,65,28,18,7,8,255
460140503,31,27,55,64,35,24,12,11,259
460140504,34,47,87,99,71,59,15,19,431
460140505,40,61,63,64,45,30,8,21,332
460140506,12,30,35,33,42,25,12,17,206
460140507,33,50,82,78,58,50,24,22,397
460140508,39,54,89,93,70,40,20,22,427
460140509,33,60,86,92,66,46,15,19,417
460140510,23,50,75,77,53,42,15,11,346
460140511,29,25,43,59,40,39,7,29,271
460140512,28,23,43,50,43,45,19,27,278
460140513,18,39,38,64,62,36,18,27,302
460140514,33,37,63,75,61,38,21,26,354
460140515,38,39,62,72,51,47,22,32,363
460140516,33,49,61,66,56,40,23,33,361
460140517,56,69,81,75,58,42,16,26,423
460140518,51,93,77,65,45,23,19,16,389
460140519,52,64,70,59,38,18,8,7,316
460140601,55,93,89,69,40,21,16,4,387
460140602,69,71,63,33,30,11,5,4,286
460140603,48,67,46,26,11,8,1,2,209
460140604,65,70,56,37,26,14,3,1,272
460140605,103,85,49,39,19,10,1,2,308
460140606,90,79,55,24,14,5,0,2,269
460140607,80,90,58,27,14,6,1,0,276
460140608,74,66,38,33,14,9,4,1,239
460140609,65,54,54,36,12,12,5,3,241
460140610,99,103,49,32,20,17,2,5,327
460140611,70,79,59,36,25,8,3,2,282
460140701,11,20,17,17,15,11,4,4,99
460140702,46,74,86,104,79,49,21,28,487
460140703,63,77,80,100,81,43,16,11,471
460140704,38,55,86,85,57,42,16,10,389
460140705,67,59,83,85,67,44,12,15,432
460140706,18,29,54,53,49,43,8,19,273
460140707,29,29,52,66,36,29,13,14,268
460140708,29,47,76,60,53,38,14,16,333
460140709,26,47,57,53,42,29,12,9,275
460140710,35,71,78,84,53,21,5,5,352
460140711,56,48,37,49,43,18,12,17,280
460140712,22,48,46,87,66,35,12,13,329
460140713,43,34,56,68,59,36,24,42,362
460140714,48,59,77,95,62,47,13,24,425
460140715,27,46,48,58,38,38,15,13,283
460140716,42,41,48,53,48,16,3,7,258
460140717,17,18,27,26,10,10,2,3,113
460140718,22,29,37,34,33,13,4,5,177
460140801,85,75,77,58,51,19,5,3,373
460140802,48,64,69,59,36,23,12,3,314
460140803,94,79,95,60,47,28,9,9,421
460140804,127,114,71,59,32,20,7,6,436
460140805,70,80,68,53,34,18,10,7,340
460140806,81,106,87,63,57,24,17,10,445
460140807,38,69,71,81,48,27,18,28,380
460140808,30,63,64,44,29,18,8,6,262
460140809,61,73,78,52,49,31,14,18,376
460140810,77,94,103,85,48,30,5,11,453
460140811,52,77,90,84,60,28,12,14,417
460140812,45,52,60,52,40,21,12,20,302
460140813,102,96,55,37,29,9,3,3,334
460140814,79,81,102,78,47,30,12,15,444
460140901,36,40,60,97,61,17,7,12,330
460140902,86,70,61,48,27,23,3,2,320
460140903,37,39,39,50,26,17,6,4,218
460140904,26,38,50,50,43,14,7,6,234
460140905,25,24,53,60,31,18,7,2,220
460140906,41,57,89,100,74,53,9,8,431
460140907,33,66,78,94,54,31,12,6,374
460140908,43,64,94,107,56,30,10,4,408
460140909,34,45,87,92,49,19,16,13,355
460140910,26,67,136,147,97,39,18,23,553
460140911,17,14,7,6,2,5,1,3,55
460140912,72,85,69,76,48,38,11,13,412
460140913,58,70,44,44,33,16,7,6,278
460140914,40,77,75,112,72,35,9,10,430
460140915,33,68,75,93,75,52,19,9,424
460140916,24,47,72,79,70,31,10,19,352
460140917,33,47,95,102,74,31,25,37,444
460140918,6,32,90,82,55,42,15,16,338
460140919,45,61,92,97,67,36,12,11,421
460140920,26,56,91,79,60,30,9,6,357
460140921,40,50,87,71,39,19,13,7,326
460140922,22,42,84,91,59,30,8,9,345
460141001,45,70,58,58,41,31,12,12,327
460141002,20,22,42,31,24,17,5,7,168
460141003,55,52,48,53,24,22,9,22,285
460141004,35,25,29,35,34,23,10,17,208
460141005,38,47,76,112,75,61,12,23,444
460141006,41,59,65,80,58,55,13,23,394
460141007,29,38,59,43,37,20,5,11,242
460141008,51,73,85,63,40,39,16,20,387
460141009,20,40,51,36,36,28,8,9,228
460141010,46,47,42,56,38,23,13,11,276
460141011,23,34,52,55,36,20,13,18,251
460141012,39,75,95,135,114,72,30,43,603
460141013,56,56,71,61,48,43,28,47,410
460141014,44,68,83,65,50,33,23,28,394
460141015,21,36,45,45,37,24,13,20,241
460141016,35,54,54,54,52,33,20,32,334
460141017,29,79,113,129,90,79,45,42,606
460141018,35,44,53,81,40,26,7,9,295
460141101,43,48,86,53,62,61,10,27,390
460141102,51,63,86,63,53,32,15,25,388
460141103,20,33,28,47,37,26,10,17,218
460141104,34,48,70,62,54,35,23,27,353
460141105,58,70,87,100,56,59,29,37,496
460141106,52,70,75,65,50,44,14,14,384
460141107,58,63,55,55,40,21,5,11,308
460141108,54,72,98,66,46,35,10,22,403
460141109,99,103,80,63,42,14,6,8,415
460141110,74,59,94,81,66,45,13,45,477
460141111,54,76,109,80,48,26,16,19,428
460141112,73,83,73,61,38,28,6,9,371
460141113,74,103,87,53,32,13,4,4,370
460141114,103,115,59,54,32,23,11,25,422
460141115,94,117,91,82,53,29,9,7,482
460210101,32,37,44,41,26,21,15,7,223
460210102,43,68,59,48,40,40,13,12,323
460210103,24,25,27,8,10,0,1,0,95
460210104,47,50,29,12,13,9,1,0,161
460210105,28,29,24,19,12,10,5,4,131
460210106,37,26,19,23,14,5,2,0,126
460210201,29,32,21,21,9,11,3,2,128
460210202,46,35,24,14,12,3,3,4,141
460280101,27,31,32,29,20,6,4,6,155
460280102,39,73,66,48,37,19,11,5,298
460280103,46,45,66,56,34,19,13,8,287
460280104,35,24,23,29,23,14,3,3,154
460280105,50,40,54,51,22,21,9,7,254
460280106,28,22,24,16,19,14,8,13,144
460280107,12,20,40,49,27,23,3,11,185
460280108,31,35,40,44,23,16,4,7,200
460280109,19,21,29,20,16,14,7,8,134
460280201,23,19,27,17,11,6,1,6,110
460280202,39,49,75,58,39,41,14,23,338
460280203,31,20,33,25,17,19,6,14,165
460280204,21,34,34,28,29,19,14,14,193
460350101,67,75,78,77,36,21,15,5,374
460350102,76,71,57,40,32,4,8,5,293
460350103,81,81,114,119,57,39,17,20,528
460350104,64,88,106,102,67,59,15,28,529
460350105,54,50,50,38,17,12,6,5,232
460350106,52,63,77,57,27,18,12,16,322
460350107,82,67,78,76,45,21,3,6,378
460350108,48,75,87,69,59,35,25,31,429
460350109,52,55,74,88,63,26,12,9,379
460350201,56,71,61,64,45,36,9,23,365
460350202,48,40,30,26,17,10,5,5,181
460350203,14,10,3,9,3,3,2,4,48
460420101,88,101,111,83,70,43,13,25,534
460420102,45,54,48,32,19,9,3,7,217
460420103,54,70,57,39,32,12,8,5,277
460420104,50,78,50,36,24,14,5,9,266
460420105,68,54,45,30,18,4,2,3,224
460420106,92,117,115,68,28,20,8,9,457
460420107,72,76,55,44,22,11,6,1,287
460420108,53,61,61,60,30,22,3,11,301
460420109,48,78,92,71,46,32,11,23,401
460420110,74,97,92,77,70,31,11,15,467
460420111,49,56,50,59,38,27,10,7,296
460420112,19,37,55,87,54,35,20,19,326
460420113,33,86,130,169,118,64,21,34,655
460420114,62,63,94,79,46,20,11,5,380
460420115,48,53,83,51,40,24,12,4,315
460420116,40,61,57,73,52,33,18,23,357
460420117,49,55,55,50,32,21,12,9,283
460420118,32,49,67,59,47,53,8,24,339
460420119,25,48,62,51,31,14,3,2,236
460420120,71,92,127,130,92,51,20,17,600
460420121,43,71,72,84,48,30,6,6,360
460420122,17,23,52,90,44,21,12,17,276
460420123,23,61,108,81,55,22,8,8,366
460420201,43,56,66,69,60,40,23,35,392
460420202,69,65,75,63,69,47,22,29,439
460420203,29,39,41,45,29,12,7,14,216
460420204,51,56,70,74,44,39,20,16,370
460420205,33,26,37,33,25,11,3,25,193
460420206,46,33,22,25,22,29,9,11,197
460420301,64,75,110,112,80,60,25,36,562
460420302,71,76,119,92,87,70,22,45,582
460420303,28,54,59,42,32,14,7,11,247
460420304,34,44,44,52,28,25,11,11,249
460420305,58,43,25,34,19,12,3,11,205
460420306,61,70,106,92,81,66,31,46,553
460420401,59,60,69,59,43,38,21,17,366
460420402,49,66,54,56,41,46,34,36,382
460420403,37,23,18,19,8,11,5,6,127
460490101,50,67,91,72,60,33,9,11,393
460490102,47,53,62,54,54,16,6,11,303
460490103,42,33,30,42,22,9,7,4,189
460490104,14,3,6,12,2,0,0,1,38
460490201,42,58,48,31,29,17,7,12,244
460490202,41,52,46,44,31,24,8,9,255
460490203,9,12,9,9,8,5,2,4,58
460490204,51,30,26,16,14,8,5,4,154
460490205,11,21,9,13,9,7,3,4,77
460560101,57,50,72,55,46,19,13,14,326
460560102,51,45,52,26,31,30,9,16,260
460560103,31,15,14,16,5,3,3,9,96
460560104,39,30,37,27,16,18,6,12,185
460630101,53,61,63,54,28,24,10,11,304
460630102,71,76,71,83,58,39,8,17,423
460630103,51,64,68,56,35,28,4,18,324
460630104,56,52,57,53,29,15,4,4,270
460630105,30,37,34,36,25,14,8,12,196
460630106,73,49,44,29,29,14,7,13,258
460630201,54,51,40,46,24,18,7,18,258
460630202,6,9,3,4,3,0,0,1,26
460630203,25,13,12,16,8,7,4,5,90
460700101,44,53,80,72,48,37,13,12,359
460700102,71,49,44,30,30,25,11,23,283
460700103,14,20,16,20,14,7,4,8,103
460700201,33,40,52,55,36,29,6,14,265
460700202,10,7,3,1,2,1,0,3,27
460700203,20,20,14,13,9,3,4,3,86
460770101,37,27,38,46,25,23,8,10,214
460770102,2,1,1,1,0,0,0,0,5
460770103,8,3,0,0,1,0,1,0,13
460770104,41,42,51,54,27,18,7,12,252
460840101,43,43,63,44,25,23,7,5,253
460840102,40,40,33,24,23,17,5,16,198
460840103,55,53,41,29,27,11,12,17,245
460840104,31,51,39,37,26,23,4,16,227
460840201,39,48,58,60,22,14,7,8,256
460840202,32,43,41,42,31,10,5,6,210
460840203,16,18,11,6,10,1,3,2,67
460840204,19,18,12,7,7,4,0,2,69
460840205,45,57,44,45,21,13,4,4,233
460840206,39,66,83,71,34,21,13,11,338
460910101,25,13,8,8,6,4,3,1,68
460910102,29,15,20,17,10,12,5,15,123
460910201,58,54,64,76,54,29,16,24,375
460910202,32,36,35,22,17,16,4,6,168
460910203,18,29,23,22,16,8,6,10,132
460910204,49,59,70,79,83,45,20,26,431
460980101,49,70,81,76,42,31,13,17,379
460980102,51,36,64,52,42,20,9,9,283
460980103,3,1,1,2,2,1,1,0,11
460980104,29,14,9,7,9,6,0,4,78
460980105,5,4,1,0,4,0,1,0,15
461050101,32,36,59,49,24,21,13,14,248
461050102,30,19,45,36,19,25,18,15,207
461050103,28,26,22,17,14,12,7,6,132
461050104,17,12,14,4,5,0,1,3,56
461120101,87,90,71,67,57,29,11,11,423
461120102,32,50,51,59,43,31,11,13,290
461120103,59,42,64,51,40,17,8,11,292
461120104,44,85,94,86,43,32,12,6,402
461120105,44,48,54,63,33,16,5,14,277
461120106,56,50,69,69,52,28,17,15,356
461120107,56,81,61,46,36,20,8,6,314
461120108,42,77,59,76,47,40,13,20,374
461120109,20,32,77,79,62,36,16,17,339
461120201,35,40,29,34,26,18,11,7,200
461120202,66,61,52,38,32,23,9,18,299
461120203,14,9,3,4,6,5,1,3,45
461120301,33,48,29,27,17,13,7,8,182
461120302,22,29,20,20,12,13,3,12,131
461190101,36,31,26,35,13,13,10,13,177
461190102,58,40,54,62,40,26,13,14,307
461190103,67,68,60,49,52,19,10,23,348
461190104,23,21,16,27,11,12,3,8,121
461190201,31,20,25,19,14,13,4,8,134
461260101,34,39,50,52,41,43,13,22,294
461260102,12,6,4,3,2,2,0,0,29
461260103,55,58,64,41,36,19,14,12,299
500070101,78,92,77,54,25,15,1,2,344
500070102,71,65,49,37,32,13,1,5,273
500070103,104,98,64,29,15,2,0,1,313
500070104,79,91,50,20,3,1,1,0,245
500070105,83,110,37,26,9,0,0,1,266
500070106,66,86,67,26,17,6,0,0,268
500070107,61,68,42,22,13,5,0,1,212
500070108,79,70,44,26,10,6,2,2,239
500070109,51,58,36,31,17,5,3,1,202
500070110,34,33,17,19,3,3,0,0,109
500070111,55,48,28,11,6,2,2,0,152
500070112,65,56,23,10,4,1,1,0,160
500070113,60,40,19,6,6,0,0,0,131
500070114,44,48,36,18,13,3,0,1,163
500070115,75,63,29,16,6,0,1,2,192
500070116,36,37,23,10,5,1,1,0,113
500070117,68,51,24,13,3,2,0,1,162
500070201,74,83,86,67,35,17,2,1,365
500070202,47,59,55,42,29,8,9,1,250
500070203,55,76,83,67,39,20,4,5,349
500070204,56,69,61,45,30,18,4,4,287
500070205,35,60,43,45,37,13,1,5,239
500070206,63,93,76,67,32,17,3,3,354
500070207,36,59,55,50,21,9,3,0,233
500070208,54,55,35,33,18,9,2,3,209
500070209,85,74,59,48,27,8,3,0,304
500070210,63,70,46,41,27,4,1,3,255
500070211,47,99,69,58,29,12,4,3,321
500070212,35,33,35,25,14,11,4,0,157
500070213,84,81,65,55,16,6,2,2,311
500070214,85,59,51,52,18,4,0,1,270
500070215,30,54,36,37,13,3,2,3,178
500070301,82,70,39,32,22,8,3,2,258
500070302,90,75,58,43,28,11,4,2,311
500070303,102,93,50,31,12,10,2,2,302
500070304,88,57,49,23,7,3,1,2,230
500070305,52,38,19,9,3,5,0,0,126
500070306,57,32,11,9,4,1,0,0,114
500070307,32,33,15,9,3,4,0,0,96
500070308,48,41,22,6,4,3,0,0,124
500070309,69,31,21,9,3,0,0,0,133
500070310,56,45,36,21,8,2,1,0,169
500070311,48,56,33,24,7,6,2,0,176
500070312,59,40,32,21,5,4,1,0,162
500070313,57,60,25,14,8,1,1,0,166
500070314,86,43,13,5,0,2,0,0,149
500070315,79,74,31,21,3,0,1,0,209
500070316,49,48,33,15,5,4,1,1,156
500070317,51,30,11,3,1,0,0,0,96
500070401,80,61,48,20,13,3,1,1,227
500070402,77,65,31,18,4,1,0,0,196
500070403,66,33,15,7,0,0,0,0,121
500070404,84,57,27,7,4,2,0,0,181
500070405,52,33,19,15,2,0,2,1,124
500070406,28,19,7,3,2,1,0,0,60
500070407,89,60,13,8,6,1,0,0,177
500070408,90,52,18,4,3,0,0,0,167
500070409,83,69,24,12,2,1,0,0,191
500070410,71,54,14,3,2,2,0,0,146
500070411,73,51,27,12,1,1,0,0,165
500070412,85,78,30,22,5,4,1,1,226
500070501,66,81,44,35,19,7,1,0,253
500070502,79,77,41,38,18,4,0,3,260
500070503,79,93,49,33,10,4,1,2,271
500070504,59,57,22,16,6,2,1,0,163
500070505,60,60,34,26,15,4,1,1,201
500070506,73,96,57,45,22,3,1,2,299
500070507,50,51,26,23,10,2,1,1,164
500070508,66,68,47,52,23,6,1,2,265
500070509,51,100,56,32,15,7,2,2,265
500070510,69,76,62,46,18,9,1,3,284
500070511,96,68,31,18,14,9,1,1,238
500070512,31,39,21,15,15,2,0,0,123
500070601,43,61,44,32,18,12,1,1,212
500070602,63,58,48,34,13,7,1,1,225
500070603,47,78,50,32,21,11,0,0,239
500070604,34,78,38,32,23,6,1,3,215
500070605,41,63,38,25,13,7,1,1,189
500070606,62,127,91,84,37,12,5,4,422
500070607,76,79,59,53,18,9,2,1,297
500070608,71,104,80,59,22,9,2,2,349
500070609,58,59,36,25,13,5,2,0,198
500070610,107,94,61,49,22,9,0,1,343
500070611,35,49,18,21,8,5,2,0,138
500070701,32,61,50,30,23,11,3,2,212
500070702,78,81,76,57,33,15,2,4,346
500070703,55,65,59,38,27,7,1,2,254
500070704,43,77,36,40,23,13,0,1,233
500070705,70,65,43,40,19,6,4,1,248
500070706,80,95,57,40,26,3,0,4,305
500070707,40,65,59,40,24,3,3,0,234
500070708,41,54,24,29,17,2,4,2,173
500070709,32,54,40,28,10,5,0,0,169
500070710,63,88,58,52,17,12,5,2,297
500070711,110,88,77,48,22,4,2,3,354
500070801,32,48,32,30,16,4,1,1,164
500070802,28,49,29,30,11,6,0,0,153
500070803,76,90,80,64,27,16,4,1,358
500070804,32,29,18,16,10,3,0,0,108
500070805,39,57,28,25,16,4,3,1,173
500070806,91,79,40,23,10,6,1,1,251
500070807,59,70,40,23,9,8,2,1,212
500070808,24,56,30,19,11,5,2,0,147
500070809,43,48,36,34,20,5,1,1,188
500070810,85,76,46,38,12,5,2,0,264
500070811,47,53,24,11,6,1,0,0,142
500070901,51,75,43,35,9,7,2,1,223
500070902,38,56,45,29,15,6,0,1,190
500070903,58,53,38,26,14,6,3,1,199
500070904,91,85,44,42,14,3,2,1,282
500070905,93,91,55,37,11,6,0,2,295
500070906,85,82,42,29,13,13,3,2,269
500070907,70,82,50,23,21,8,0,2,256
500070908,60,64,43,29,19,3,2,1,221
500070909,9,28,15,14,9,6,1,0,82
500070910,80,76,48,33,16,5,2,3,263
500070911,45,74,46,22,22,3,4,1,217
500070912,50,50,20,9,11,4,1,1,146
500071001,28,55,67,84,58,28,5,1,326
500071002,29,71,58,47,21,11,3,2,242
500071003,43,52,57,58,43,19,4,1,277
500071004,31,50,86,66,49,51,25,23,381
500071005,57,58,59,51,41,29,26,14,335
500071006,34,61,78,96,77,36,18,13,413
500071007,73,70,42,35,17,2,1,1,241
500071008,34,44,50,53,51,29,12,20,293
500071009,33,50,69,59,51,36,18,9,325
500071010,31,52,64,62,44,31,20,28,332
500071011,16,31,41,33,24,25,10,8,188
500071012,91,65,43,30,13,8,0,0,250
500071013,0,0,0,0,1,0,0,0,1
500071014,16,41,64,47,36,26,13,16,259
500071015,16,21,25,35,27,14,5,13,156
500071016,13,16,26,20,15,19,4,6,119
500071017,47,79,73,63,30,12,5,2,311
500071018,0,0,0,0,0,0,0,0,0
500071019,36,72,68,99,53,18,3,2,351
500071020,37,57,62,47,26,22,6,2,259
500071021,13,40,47,56,45,25,7,16,249
500071022,10,15,23,22,21,16,6,9,122
500071101,33,58,47,39,23,9,1,0,210
500071102,63,101,52,48,32,10,2,1,309
500071103,50,69,62,51,22,7,3,1,265
500071104,66,83,61,54,18,10,1,1,294
500071105,70,98,66,38,25,10,2,1,310
500071106,74,101,74,64,37,7,2,3,362
500071107,42,77,49,50,23,7,5,4,257
500071108,96,104,75,60,29,8,2,1,375
500071109,33,69,51,47,18,10,2,0,230
500071110,49,85,50,56,30,12,4,1,287
500071111,33,46,42,25,23,13,3,1,186
500071112,34,43,35,38,14,8,1,1,174
500071113,41,50,38,31,9,7,3,0,179
500071201,70,50,19,9,3,1,0,0,152
500071202,26,38,11,11,3,0,1,0,90
500071203,83,51,18,4,3,0,0,0,159
500071204,53,36,16,5,4,0,1,0,115
500071205,50,47,24,10,5,1,1,0,138
500071206,76,62,32,18,4,2,0,1,195
500071207,54,45,15,13,6,2,0,0,135
500071208,89,66,25,10,2,0,0,0,192
500071209,103,86,27,19,7,2,0,0,244
500071210,86,60,38,32,13,2,0,2,233
500071301,38,74,79,86,59,37,15,15,403
500071302,38,57,53,51,42,32,13,11,297
500071303,7,28,50,68,50,38,19,25,285
500071304,37,50,65,71,46,35,12,9,325
500071305,28,51,38,50,22,15,5,8,217
500071306,10,38,33,52,56,28,14,11,242
500071307,42,56,66,67,53,27,13,23,347
500071308,29,41,54,70,50,22,10,15,291
500071309,26,50,53,80,53,44,15,12,333
500071310,0,0,0,0,0,0,0,0,0
500071311,14,11,9,6,5,4,0,1,50
500140101,43,27,18,16,7,6,0,1,118
500140201,30,14,8,1,2,3,1,0,59
500140301,8,6,5,7,3,3,2,1,35
500140302,11,18,19,21,12,9,2,3,95
500140303,21,21,12,12,5,5,3,3,82
500140304,42,70,50,39,39,21,11,6,278
500140305,13,15,19,9,7,1,0,2,66
500140401,29,44,30,37,22,19,3,4,188
500140402,18,30,29,11,18,5,1,3,115
500140403,4,1,0,2,0,1,0,0,8
500140404,39,60,65,55,33,16,7,6,281
500140405,58,77,50,71,35,21,6,11,329
500140406,55,85,68,63,34,19,10,5,339
500140407,3,1,1,3,1,0,0,1,10
500140408,93,86,74,64,29,20,10,3,379
500140409,80,69,62,58,24,32,5,8,338
500140410,67,76,60,55,32,14,7,9,320
500140411,25,42,47,30,16,19,6,3,188
500140412,30,41,24,27,11,14,4,0,151
500140501,49,80,63,67,40,20,11,5,335
500140502,28,51,49,44,27,15,13,9,236
500140503,33,54,45,40,17,12,4,1,206
500140504,41,67,46,45,29,17,6,8,259
500140505,41,53,47,31,25,17,7,4,225
500140506,23,33,34,39,20,15,7,9,180
500140601,33,78,64,75,48,20,11,6,335
500140602,40,49,51,45,32,13,5,6,241
500140603,56,68,49,41,19,10,0,1,244
500140604,84,100,47,42,14,12,4,0,303
500140605,74,74,40,33,19,6,0,2,248
500140606,42,87,41,41,21,14,3,2,251
500140607,45,63,52,49,23,10,3,0,245
500140608,54,54,38,32,12,8,1,0,199
500140609,43,75,73,65,31,16,4,5,312
500140610,73,73,61,43,13,7,1,0,271
500140611,57,93,96,59,46,14,4,4,373
500140612,53,97,60,61,38,19,5,10,343
500140613,62,74,52,49,27,9,5,3,281
500140614,22,46,45,30,16,13,6,3,181
500140615,73,94,87,98,54,30,9,13,458
500140616,53,84,78,69,41,17,6,3,351
500140617,30,64,70,53,24,5,6,1,253
500140701,55,76,76,72,66,39,18,20,422
500140702,42,57,72,61,56,20,8,14,330
500140703,66,106,97,93,55,26,17,12,472
500140704,27,46,26,20,17,11,3,6,156
500140705,61,94,75,65,42,26,6,10,379
500140706,43,66,51,49,24,10,2,3,248
500140707,51,71,65,65,38,6,3,1,300
500140708,39,77,60,68,46,22,6,7,325
500140709,48,105,65,70,26,9,3,1,327
500140710,83,135,66,49,24,12,4,2,375
500140711,66,87,48,39,15,7,3,1,266
500140712,86,84,48,43,8,4,2,1,276
500140713,51,66,48,37,17,6,1,4,230
500140714,54,68,43,44,34,14,5,6,268
500140715,37,61,64,73,37,16,10,3,301
500140716,43,63,95,103,41,16,2,1,364
500210101,28,59,43,40,24,8,4,2,208
500210102,39,77,57,62,33,7,1,2,278
500210103,14,13,19,27,18,6,3,6,106
500210104,48,95,67,55,25,15,4,5,314
500210105,44,49,50,59,42,18,7,2,271
500210106,20,44,49,60,49,34,11,14,281
500210107,43,86,121,154,93,81,30,48,656
500210108,35,69,68,57,60,20,6,2,317
500210109,34,84,70,52,30,9,2,3,284
500210110,33,77,50,53,25,3,3,0,244
500210111,38,58,77,91,58,37,11,9,379
500210112,25,45,36,52,26,14,4,3,205
500210113,46,77,70,59,35,10,3,0,300
500210114,34,59,47,57,27,12,5,1,242
500210115,29,41,54,95,53,45,25,30,372
500210116,29,38,52,59,62,34,11,21,306
500210117,16,48,27,32,14,10,5,0,152
500210118,29,42,34,34,26,10,9,2,186
500210119,12,25,25,31,19,11,3,2,128
500210201,42,54,53,48,31,20,12,8,268
500210202,35,51,48,39,31,18,9,9,240
500210203,20,39,39,37,24,26,16,16,217
500210204,34,49,63,80,46,21,25,30,348
500210205,26,46,43,36,41,31,11,15,249
500210206,31,59,45,45,38,24,9,8,259
500210207,41,68,64,62,40,24,12,7,318
500210208,47,63,73,43,25,11,3,2,267
500210209,53,82,62,59,29,7,2,1,295
500210210,41,73,36,33,26,6,2,1,218
500210211,44,66,52,46,21,13,0,2,244
500210212,58,102,64,55,34,20,3,1,337
500210213,53,76,49,41,23,18,2,7,269
500210214,31,52,44,36,25,16,8,3,215
500210215,62,81,59,56,42,18,10,5,333
500210216,51,84,61,77,31,17,11,14,346
500210217,41,73,52,58,44,20,8,19,315
500210218,9,16,12,9,9,1,0,10,66
500210219,20,23,13,16,20,10,9,8,119
500210301,76,93,54,58,23,6,2,1,313
500210302,42,55,31,20,12,1,0,1,162
500210303,52,46,36,18,8,7,1,2,170
500210304,68,81,59,68,23,9,4,4,316
500210305,41,48,47,24,10,6,3,0,179
500210306,67,87,48,30,15,5,0,0,252
500210307,37,55,42,23,13,9,3,1,183
500210308,65,101,64,73,30,13,9,6,361
500210309,51,81,65,66,31,20,2,8,324
500210310,51,72,49,38,22,11,1,6,250
500210311,65,86,70,55,25,11,0,2,314
500210312,60,55,36,34,10,5,2,1,203
500210313,59,58,51,26,7,2,0,0,203
500210314,70,65,50,29,10,4,2,4,234
500210315,41,45,31,25,19,4,2,2,169
500210316,57,45,35,28,13,2,2,0,182
500210317,45,71,54,23,12,10,1,1,217
500210401,30,31,49,69,44,31,18,18,290
500210402,34,51,50,52,23,18,6,2,236
500210403,44,77,56,52,35,17,8,8,297
500210404,74,86,58,58,27,15,3,1,322
500210405,32,60,38,32,14,5,4,1,186
500210406,43,58,40,43,31,10,2,3,230
500210407,30,42,49,47,32,21,4,4,229
500210408,23,32,51,77,46,20,9,12,270
500210409,40,81,52,69,39,13,5,8,307
500210410,48,67,50,26,13,3,2,2,211
500210411,54,85,58,60,52,25,7,18,359
500210412,62,92,77,60,41,18,8,8,366
500210413,26,48,54,64,22,18,4,3,239
500210414,23,50,62,66,52,42,15,24,334
500210415,11,29,35,41,31,17,2,9,175
500210416,46,44,35,34,26,6,3,0,194
500210417,26,52,44,45,34,16,7,10,234
500210418,44,67,59,64,42,28,8,15,327
500210419,13,33,19,20,21,11,8,2,127
500210420,22,27,36,31,30,12,9,2,169
500210501,28,47,37,19,10,7,3,1,152
500210502,26,52,34,47,33,14,6,9,221
500210503,18,60,55,59,39,15,6,8,260
500210504,3,10,8,6,5,3,1,5,41
500210505,27,42,51,68,51,13,2,3,257
500210506,50,108,66,35,29,11,4,1,304
500210507,38,86,65,50,32,13,6,2,292
500210508,45,90,86,108,62,15,7,0,413
500210509,46,82,90,84,41,14,3,4,364
500210510,37,77,54,48,34,12,6,3,271
500210511,38,68,55,45,19,11,6,3,245
500210512,29,51,74,70,35,10,8,3,280
500210513,32,55,62,54,25,9,2,2,241
500210601,68,90,82,65,38,19,7,5,374
500210602,24,74,53,65,30,12,2,0,260
500210603,30,56,58,73,34,14,4,6,275
500210604,26,75,84,61,42,17,6,1,312
500210605,33,85,90,65,46,17,7,3,346
500210606,24,82,86,71,39,22,7,3,334
500210607,29,79,88,63,30,18,7,4,318
500210608,39,92,79,98,49,31,6,6,400
500210609,21,47,48,39,28,7,1,4,195
500210610,36,49,59,40,25,10,2,0,221
500210611,33,53,61,47,42,21,7,6,270
500210612,25,62,48,57,44,22,7,4,269
500210613,23,46,78,96,64,36,11,11,365
500210701,62,77,59,31,19,11,6,3,268
500210702,50,95,65,68,21,11,2,4,316
500210703,62,76,73,71,31,19,4,2,338
500210704,46,77,57,49,30,7,3,2,271
500210705,54,88,50,40,33,8,3,3,279
500210706,47,87,84,66,30,11,3,2,330
500210707,40,78,43,40,19,6,3,2,231
500210708,28,48,59,65,35,18,12,6,271
500210709,45,61,50,53,30,22,9,13,283
500210710,24,31,40,40,18,5,3,0,161
500210801,20,31,44,51,46,43,13,25,273
500210802,18,23,34,48,41,27,18,24,233
500210803,28,30,49,49,41,77,10,22,306
500210804,10,12,17,29,19,13,1,10,111
500210805,22,27,44,45,29,32,6,7,212
500210806,16,46,61,70,66,29,13,26,327
500210807,25,55,72,80,71,39,19,22,383
500210808,27,40,58,75,62,19,8,8,297
500210809,24,35,44,49,22,16,8,3,201
500210810,32,56,60,61,37,16,5,2,269
500210811,29,59,74,98,71,23,13,13,380
500210812,14,20,30,46,36,35,7,15,203
500210813,24,26,27,22,10,26,5,3,143
500210901,30,47,45,25,27,9,1,2,186
500210902,64,97,66,40,16,12,4,1,300
500210903,71,70,41,22,9,8,2,0,223
500210904,73,60,61,40,15,10,1,3,263
500210905,69,84,54,57,31,14,4,2,315
500210906,62,79,68,33,21,13,3,3,282
500210907,48,61,50,40,30,12,4,5,250
500210908,23,51,31,33,5,5,1,2,151
500210909,43,63,51,60,23,17,2,8,267
500210910,50,72,59,59,29,12,6,3,290
500210911,61,91,54,73,25,10,2,4,320
500210912,52,72,46,41,30,6,9,0,256
500210913,46,62,50,43,21,10,8,6,246
500210914,37,60,30,34,21,3,0,2,187
500210915,155,96,51,23,5,2,0,0,332
500210916,28,53,43,33,27,14,3,1,202
500210917,27,38,38,40,17,13,3,3,179
500211001,37,72,49,56,25,15,4,2,260
500211002,55,86,81,49,32,8,3,3,317
500211003,40,54,39,39,25,5,3,3,208
500211004,72,78,62,55,23,7,7,4,308
500211005,32,48,25,37,16,7,3,3,171
500211006,58,86,73,67,37,18,12,6,357
500211007,79,106,84,66,34,20,2,2,393
500211008,59,95,48,46,22,12,2,0,284
500211009,52,78,61,52,33,13,3,1,293
500211010,34,50,46,33,21,17,10,3,214
500211011,39,45,38,29,15,8,2,3,179
500211012,28,48,36,29,14,8,3,4,170
500211101,53,62,30,32,15,7,1,3,203
500211102,13,12,13,3,4,0,1,0,46
500211103,47,41,24,25,10,6,0,2,155
500211104,46,72,41,20,8,10,0,3,200
500211105,50,42,22,12,15,4,1,1,147
500211106,73,76,51,35,18,5,3,1,262
500211107,60,73,39,25,14,5,1,1,218
500211108,76,70,33,14,5,4,1,0,203
500211109,68,81,35,41,18,7,3,3,256
500211110,63,71,37,33,20,7,1,0,232
500211111,25,55,37,27,21,13,1,1,180
500211112,51,65,40,29,15,7,0,1,208
500211201,24,36,38,28,11,7,2,2,148
500211202,47,86,68,48,38,19,4,7,317
500211203,15,43,35,36,22,7,8,1,167
500211204,26,58,53,38,28,14,2,7,226
500211205,24,65,74,72,52,25,10,8,330
500211206,13,32,48,41,38,36,11,20,239
500211207,13,28,48,56,39,57,25,31,297
500211208,11,22,42,60,39,28,14,17,233
500211209,29,53,56,67,40,13,4,7,269
500211210,36,60,42,51,33,10,5,3,240
500211211,38,79,66,52,24,13,3,4,279
500211301,24,54,43,41,30,5,1,0,198
500211302,30,44,44,33,14,5,2,4,176
500211303,53,118,74,79,40,12,2,4,382
500211304,51,92,57,62,40,10,2,5,319
500211305,44,114,62,59,28,11,8,5,331
500211306,40,84,48,35,16,8,1,1,233
500211307,26,69,82,95,47,16,8,4,347
500211308,23,48,48,63,35,12,2,3,234
500211309,26,73,63,84,49,16,2,1,314
500211310,46,80,36,55,30,16,1,0,264
500211311,43,106,75,58,31,16,0,5,334
500211312,28,62,62,66,28,13,7,6,272
500211313,72,86,69,101,53,14,3,1,399
500211314,24,40,41,57,35,13,5,15,230
500211315,44,53,52,40,20,12,1,1,223
500211401,4,16,9,26,20,25,13,14,127
500211402,20,33,56,49,30,22,10,14,234
500211403,20,57,69,89,62,21,14,15,347
500211404,14,40,45,57,42,28,8,4,238
500211405,25,51,56,75,59,22,9,18,315
500211406,28,61,59,79,43,30,13,17,330
500211407,28,57,70,83,58,31,21,20,368
500211408,22,25,45,69,40,20,8,13,242
500211409,16,48,60,85,44,30,9,11,303
500211410,14,38,42,110,56,25,5,3,293
500211501,97,119,81,66,29,14,9,1,416
500211502,95,92,52,36,20,3,1,2,301
500211503,32,40,18,20,7,7,0,1,125
500211504,53,51,36,23,12,10,2,1,188
500211505,54,60,31,23,16,5,2,2,193
500211506,52,68,37,23,8,1,2,1,192
500211507,79,97,50,41,21,7,1,2,298
500211508,48,43,38,25,14,5,0,0,173
500211509,28,53,39,24,10,8,2,0,164
500211601,32,60,83,73,72,52,22,31,425
500211602,17,63,79,98,46,40,23,30,396
500211603,18,46,50,47,29,25,8,11,234
500211604,37,68,56,73,52,40,25,25,376
500211605,22,47,44,69,40,33,12,22,289
500211606,28,59,68,80,66,39,22,27,389
500211607,33,63,66,76,41,37,11,21,348
500211608,30,57,58,82,49,24,13,15,328
500211609,12,52,31,47,23,17,6,17,205
500211610,19,29,26,34,24,25,5,10,172
500280101,29,34,26,16,16,9,1,2,133
500280102,36,48,50,36,20,12,5,1,208
500280103,37,63,53,39,23,7,5,7,234
500280104,26,36,41,35,24,9,4,2,177
500280105,39,74,51,38,27,7,1,4,241
500280106,79,91,63,54,35,15,6,2,345
500280107,52,78,48,37,17,8,0,2,242
500280108,49,88,46,33,30,11,3,5,265
500280109,51,61,40,32,26,8,4,3,225
500280110,62,73,69,46,35,13,2,0,300
500280111,68,98,67,51,36,15,5,5,345
500280112,43,37,43,24,12,8,5,3,175
500280201,52,81,51,50,24,11,1,1,271
500280202,36,64,62,46,23,11,4,1,247
500280203,47,56,50,40,26,20,10,7,256
500280204,29,42,43,35,17,11,3,1,181
500280205,65,74,53,51,34,28,4,3,312
500280206,68,81,66,69,39,14,4,1,342
500280207,55,65,40,37,16,18,2,2,235
500280208,38,59,40,39,13,10,3,3,205
500280209,55,70,67,50,29,13,4,4,292
500280210,36,46,56,30,24,9,4,2,207
500280211,47,83,69,47,25,17,3,4,295
500280212,71,101,71,44,25,6,1,3,322
500280213,40,44,40,21,15,20,2,2,184
500280214,28,46,37,29,26,7,7,5,185
500280301,25,44,86,79,50,46,11,10,351
500280302,42,50,61,84,52,37,16,10,352
500280303,14,31,41,33,39,26,17,25,226
500280304,15,41,58,74,62,56,24,35,365
500280305,19,35,64,59,57,34,16,19,303
500280306,24,31,61,83,51,35,20,31,336
500280307,40,62,58,60,50,37,18,8,333
500280308,54,85,69,70,45,18,6,7,354
500280309,42,74,60,54,25,18,6,10,289
500280310,77,84,91,96,53,30,17,20,468
500280311,48,78,76,56,46,15,7,8,334
500280312,40,89,78,76,38,32,8,5,366
500280313,48,75,86,104,55,35,12,22,437
500280314,58,88,81,76,46,33,23,17,422
500280315,69,77,101,85,76,37,18,29,492
500280316,15,29,48,48,42,29,19,24,254
500280317,30,74,70,60,37,16,7,7,301
500280401,24,51,43,43,29,13,2,8,213
500280402,15,44,52,40,35,24,8,3,221
500280403,37,94,84,111,65,28,18,8,445
500280404,30,46,61,54,24,17,6,6,244
500280405,26,52,66,55,26,14,4,4,247
500280406,35,59,49,61,32,23,6,11,276
500280407,17,52,62,57,42,25,8,8,271
500280408,7,29,35,67,48,39,16,20,261
500280409,41,59,67,72,57,45,14,7,362
500280410,17,17,35,59,46,40,18,17,249
500280411,17,34,63,65,53,42,22,25,321
500280412,17,39,35,54,54,31,19,19,268
500280413,19,33,73,87,71,49,29,24,385
500280414,19,45,50,53,66,41,15,23,312
500280415,44,72,55,77,43,22,9,4,326
500280501,12,14,28,37,27,23,10,12,163
500280502,29,64,66,67,50,38,15,19,348
500280503,32,52,58,62,56,41,17,23,341
500280504,18,45,50,48,35,28,9,15,248
500280505,15,18,25,38,28,25,12,14,175
500280506,23,49,46,62,40,23,11,12,266
500280507,64,104,102,125,75,40,14,19,543
500280508,47,70,86,116,83,44,18,28,492
500280509,30,60,68,75,53,38,12,9,345
500280510,36,69,78,74,47,36,15,15,370
500280511,35,82,80,99,82,32,13,12,435
500280512,24,45,36,43,22,7,4,4,185
500280513,35,58,42,69,62,27,9,20,322
500280514,29,36,78,73,50,20,18,15,319
500280515,27,35,33,46,39,18,9,5,212
500280516,39,80,95,100,78,48,19,28,487
500280517,49,89,102,116,74,68,35,22,555
500280518,26,17,21,37,28,12,7,11,159
500280519,24,36,57,65,39,33,16,14,284
500280520,21,27,39,41,29,13,4,12,186
500280601,18,32,62,57,32,26,10,8,245
500280602,15,36,33,66,25,9,5,6,195
500280603,39,33,34,46,24,14,10,3,203
500280604,49,78,80,64,54,25,18,17,385
500280605,18,30,41,65,53,41,13,13,274
500280606,26,83,103,122,59,44,14,19,470
500280607,31,58,63,73,55,35,7,17,339
500280608,25,45,53,64,39,25,14,6,271
500280609,7,16,15,27,16,18,3,4,106
500280610,35,42,53,54,57,42,17,21,321
500280611,30,46,47,55,31,19,16,11,255
500280612,12,14,23,15,22,9,4,3,102
500280613,44,60,62,59,41,22,9,8,305
500280614,49,88,71,62,32,23,13,12,350
500280701,22,37,44,59,29,15,3,5,214
500280702,28,34,47,71,31,7,5,0,223
500280703,18,35,36,72,47,15,9,1,233
500280704,22,44,60,79,71,24,3,3,306
500280705,10,21,22,43,36,20,5,13,170
500280706,23,50,74,77,43,24,8,11,310
500280707,38,58,59,61,47,6,3,4,276
500280708,32,52,63,60,34,17,1,5,264
500280709,27,61,75,76,40,31,7,8,325
500280710,29,50,52,42,20,10,5,5,213
500280711,40,55,65,72,27,7,3,2,271
500280712,28,50,76,95,50,15,3,1,318
500280801,49,72,59,52,29,12,6,3,282
500280802,21,50,43,34,19,6,2,2,177
500280803,35,54,47,34,25,4,1,0,200
500280804,37,63,45,22,19,10,6,3,205
500280805,51,77,63,70,27,12,1,4,305
500280806,46,78,71,48,23,11,5,7,289
500280807,39,72,64,60,27,18,4,2,286
500280808,43,58,62,70,35,19,11,5,303
500280809,35,65,51,61,49,33,5,6,305
500280810,23,44,53,62,35,16,4,2,239
500280811,35,80,71,85,45,26,4,4,350
500280812,45,77,66,63,35,16,4,2,308
500280813,32,60,69,83,48,16,5,8,321
500280814,16,32,36,39,23,10,5,5,166
500280815,35,83,63,61,54,18,4,6,324
500280816,34,62,54,43,28,9,4,1,235
500280817,34,55,48,40,32,12,4,5,230
500280818,11,42,25,33,28,4,2,2,147
500280819,21,47,29,30,20,6,2,1,156
500280820,30,62,41,33,17,8,3,3,197
500280901,55,70,70,46,42,18,10,4,315
500280902,50,65,52,44,18,11,0,3,243
500280903,66,90,55,54,18,16,3,1,303
500280904,36,52,39,28,12,4,6,2,179
500280905,35,67,77,72,37,12,6,6,312
500280906,35,96,70,75,55,16,12,4,363
500280907,32,46,32,29,16,6,2,2,165
500280908,59,108,70,70,34,18,3,3,365
500280909,52,61,63,53,35,9,7,4,284
500280910,61,74,66,80,39,12,5,5,342
500280911,36,44,24,26,13,10,4,2,159
500280912,41,63,72,62,32,13,3,0,286
500280913,18,59,79,89,43,12,4,1,305
500280914,18,48,29,50,24,6,0,0,175
500281001,55,80,67,49,38,15,4,6,314
500281002,21,51,47,39,24,24,11,8,225
500281003,34,43,52,37,20,10,5,9,210
500281004,43,61,69,65,41,29,14,13,335
500281005,38,51,49,34,25,6,0,4,207
500281006,36,59,79,76,39,20,5,7,321
500281007,53,89,65,70,49,27,10,11,374
500281008,72,77,87,69,45,28,10,7,395
500281009,31,68,45,46,39,11,4,2,246
500281010,59,80,70,72,37,15,4,3,340
500281101,18,32,45,37,31,36,12,15,226
500281102,32,46,45,50,42,26,14,7,262
500281103,47,84,71,88,68,34,16,17,425
500281104,29,60,93,84,57,47,19,28,417
500281105,37,62,54,72,53,37,16,16,347
500281106,21,40,46,68,40,32,14,12,273
500281107,23,48,60,73,47,34,12,31,328
500281108,38,65,59,73,49,34,11,11,340
500281109,29,67,67,54,41,29,18,9,314
500281110,40,74,67,62,49,39,20,8,359
500281111,34,45,36,43,26,16,4,8,212
500281112,39,61,62,55,41,21,12,3,294
500281113,31,31,48,34,24,16,4,6,194
500281114,15,26,50,50,52,19,9,8,229
500281115,27,40,64,67,36,30,14,19,297
500281116,30,42,39,47,24,21,5,6,214
500281117,21,59,64,61,41,17,4,4,271
500281118,21,50,40,53,33,24,5,11,237
500281201,35,57,97,132,64,29,8,7,429
500281202,51,54,52,51,41,22,6,10,287
500281203,34,65,60,55,34,20,15,17,300
500281204,26,60,64,61,41,35,12,23,322
500281205,26,77,61,49,36,16,2,3,270
500281206,31,62,70,61,36,12,4,2,278
500281207,25,54,54,50,33,12,2,2,232
500281208,18,40,33,36,38,12,2,1,180
500281209,28,59,58,71,46,15,4,7,288
500281210,26,54,75,84,63,29,15,8,354
500281211,14,30,52,56,41,18,10,13,234
500281212,15,27,45,75,38,21,7,5,233
500281213,17,45,47,59,33,17,4,4,226
500281214,20,46,43,70,41,18,8,4,250
500281215,17,56,62,49,20,18,4,3,229
500281216,45,73,60,71,35,9,9,0,302
500281217,32,80,62,59,36,14,2,1,286
500281218,44,61,50,62,37,10,2,2,268
500281219,40,84,76,89,53,18,10,7,377
500281301,70,69,59,63,36,16,2,3,318
500281302,51,83,68,48,37,17,6,7,317
500281303,63,80,73,69,45,14,9,10,363
500281304,56,73,56,53,49,27,0,4,318
500281305,41,70,45,67,47,19,6,6,301
500281306,31,51,46,32,16,18,3,7,204
500281307,25,46,45,32,15,12,4,1,180
500281308,38,57,61,67,41,22,6,1,293
500281309,23,49,47,33,30,14,6,2,204
500281310,39,71,59,62,36,13,3,3,286
500281311,35,56,48,34,23,14,6,7,223
500281312,39,52,37,27,21,17,5,1,199
500281401,33,56,37,26,23,7,2,0,184
500281402,37,66,45,35,22,5,2,0,212
500281403,56,62,51,26,16,4,1,0,216
500281404,65,100,54,45,32,11,1,0,308
500281405,55,86,67,58,28,14,4,1,313
500281406,33,57,51,56,34,15,2,4,252
500281407,25,67,50,75,31,19,5,8,280
500281408,36,82,77,62,25,13,5,4,304
500281409,45,98,72,46,18,14,1,2,296
500281410,44,87,53,37,24,12,3,0,260
500281411,43,86,43,32,20,6,2,0,232
500281412,46,107,61,57,36,14,5,3,329
500281413,45,64,60,54,35,17,8,5,288
500281414,34,62,52,49,18,8,0,0,223
500281415,14,29,49,70,46,7,2,1,218
500281501,37,60,48,72,57,30,21,13,338
500281502,35,103,109,109,67,43,11,21,498
500281503,13,23,25,42,18,12,6,0,139
500281504,17,38,58,57,54,28,19,7,278
500281505,27,60,74,93,80,45,19,29,427
500281506,30,47,62,105,61,52,23,15,395
500281507,15,46,55,73,61,28,25,12,315
500281508,22,41,50,51,45,34,5,6,254
500281601,57,64,57,50,28,19,3,0,278
500281602,40,49,37,43,17,11,7,1,205
500281603,40,61,40,35,35,9,5,4,229
500281604,66,89,52,39,32,10,3,5,296
500281605,53,86,101,60,44,26,7,3,380
500281606,28,52,34,41,19,4,3,6,187
500281607,25,46,46,36,19,7,0,1,180
500281608,67,92,66,51,46,14,7,3,346
500281609,58,112,91,76,52,17,9,8,423
500281610,50,80,61,44,36,19,3,4,297
500281611,62,80,92,63,35,16,7,2,357
500281701,20,19,39,42,39,14,6,14,193
500281702,39,61,59,54,36,18,10,7,284
500281703,47,80,64,58,58,22,10,6,345
500281704,23,52,48,53,31,15,5,2,229
500281705,37,64,44,44,24,18,2,5,238
500281706,36,85,71,93,53,26,9,3,376
500281707,33,49,94,115,61,37,7,9,405
500281708,45,62,60,54,27,11,6,3,268
500281709,28,31,48,43,23,15,9,6,203
500281710,23,61,64,63,47,19,7,7,291
500281711,9,23,29,28,22,22,1,1,135
500281712,47,72,118,132,62,58,28,24,541
500281713,28,47,44,57,36,21,11,10,254
500281714,26,37,51,43,30,18,11,10,226
500281715,23,43,34,51,40,21,9,23,244
500281716,34,43,55,71,47,35,18,22,325
500281801,17,39,44,79,57,18,6,6,266
500281802,20,50,70,79,55,17,5,7,303
500281803,21,67,75,84,83,43,9,28,410
500281804,26,45,57,75,48,26,15,15,307
500281805,23,71,75,90,58,38,20,12,387
500281806,25,28,51,62,38,18,8,11,241
500281807,33,57,90,99,64,43,11,12,409
500281808,16,36,43,71,33,27,13,8,247
500281809,25,47,67,80,46,24,5,9,303
500281810,26,58,69,74,38,14,5,2,286
500281811,36,44,45,55,42,21,12,4,259
500281812,31,33,33,47,43,17,6,15,225
500281901,21,77,79,92,79,37,9,20,414
500281902,32,47,47,45,37,15,12,8,243
500281903,9,18,35,50,41,25,7,4,189
500281904,18,39,47,67,48,34,20,25,298
500281905,52,84,77,116,88,55,28,29,529
500281906,34,59,67,72,56,28,8,10,334
500281907,22,32,41,34,33,16,8,19,205
500281908,22,46,82,92,54,16,12,2,326
500281909,30,70,75,95,49,28,14,6,367
500281910,36,54,77,62,45,40,9,10,333
500282001,46,95,75,64,45,18,4,7,354
500282002,35,57,57,41,32,13,7,8,250
500282003,29,49,45,33,27,10,3,3,199
500282004,18,41,46,39,14,12,5,4,179
500282005,35,66,46,50,30,18,4,3,252
500282006,45,78,49,58,25,12,6,7,280
500282007,60,64,83,59,30,18,4,4,322
500282008,33,64,32,43,17,9,2,1,201
500282009,62,74,81,83,30,6,2,0,338
500282010,32,57,38,41,31,9,2,3,213
500282011,38,44,43,65,38,10,3,1,242
500350101,24,60,112,123,67,30,7,7,430
500350102,24,55,45,37,34,13,8,14,230
500350103,26,54,50,57,48,17,7,12,271
500350104,23,46,32,60,35,16,6,3,221
500350105,34,57,58,48,37,14,20,8,276
500350201,50,92,70,79,55,17,12,13,388
500350202,28,54,72,77,50,25,9,11,326
500350203,44,99,117,103,73,25,11,5,477
500350204,32,73,51,32,24,12,4,5,233
500350205,21,49,82,77,50,26,11,8,324
500350206,39,41,52,24,20,10,1,0,187
500350207,33,53,60,79,31,25,12,6,299
500350208,26,47,53,51,33,10,6,4,230
500350209,71,118,92,68,32,20,8,6,415
500350210,51,96,72,55,53,21,5,3,356
500350211,24,50,49,57,42,18,7,1,248
500350212,43,68,59,50,31,14,4,2,271
500350213,20,41,59,69,55,7,6,3,260
500350214,27,59,72,94,56,24,6,6,344
500350215,31,61,55,41,30,19,7,5,249
500350216,45,97,98,97,59,41,13,3,453
500350217,15,37,45,74,35,12,4,5,227
500350218,11,39,66,72,62,14,8,5,277
500350301,35,101,112,113,65,37,11,14,488
500350302,40,68,71,71,53,23,10,12,348
500350303,37,93,69,66,43,19,12,12,351
500350401,17,19,22,24,17,11,5,4,119
500350402,23,14,25,21,20,15,7,10,135
500350403,45,80,64,90,57,28,13,13,390
500350404,17,25,31,31,23,15,11,2,155
500350501,50,105,109,109,84,48,16,15,536
500350502,13,20,22,42,18,14,9,6,144
500350503,10,17,15,18,15,10,4,5,94
500350504,40,60,80,86,45,55,12,12,390
500350505,13,12,22,21,20,12,7,5,112
500350506,11,24,22,24,19,8,4,1,113
500350507,20,34,44,51,29,16,7,10,211
500420101,27,32,35,28,29,19,4,4,178
500420102,25,16,8,13,6,1,4,5,78
500420201,18,6,5,5,6,6,2,1,49
500420301,23,6,8,4,5,2,0,0,48
500420302,13,7,2,4,1,2,0,0,29
500420401,15,14,15,7,8,6,1,2,68
500420402,13,20,25,19,20,6,7,4,114
500420403,18,22,27,24,11,10,6,5,123
500420404,31,54,43,64,34,19,2,2,249
500420405,40,60,33,21,14,6,1,2,177
500420406,62,100,100,71,57,37,15,22,464
500420407,36,51,55,57,22,8,11,7,247
500420408,21,63,69,52,46,21,9,7,288
500420409,23,23,33,49,39,21,7,7,202
500420410,32,40,48,41,26,15,3,5,210
500420411,21,33,42,52,39,15,11,6,219
500420412,10,14,27,30,25,9,4,7,126
500490101,0,0,1,1,2,0,0,0,4
500490201,48,60,60,80,75,46,16,21,406
500490202,16,11,9,11,6,13,1,3,70
500490203,18,31,29,37,39,15,9,11,189
500490204,19,53,50,61,64,29,16,11,303
500490205,24,50,51,72,47,39,11,16,310
500490206,18,45,59,75,43,50,16,12,318
500490207,45,51,72,83,75,50,19,23,418
500490208,21,27,36,50,35,42,18,21,250
500490209,22,46,40,52,48,46,20,21,295
500490210,38,45,43,77,63,49,13,9,337
500490211,20,44,53,64,38,25,18,19,281
500490212,26,51,53,85,67,34,16,19,351
500490213,41,55,70,92,64,24,14,22,382
500490214,16,32,48,73,36,30,21,15,271
500490215,18,39,52,63,42,41,22,23,300
500490216,25,46,49,93,77,29,24,42,385
500490217,16,29,37,50,41,35,15,12,235
500490218,22,41,53,64,57,27,11,14,289
500490219,24,58,70,94,84,50,22,32,434
500490220,13,36,41,58,50,40,15,23,276
500490221,23,52,75,87,61,59,21,34,412
500490301,27,26,43,44,51,26,20,18,255
500490302,29,36,51,64,45,28,21,17,291
500490303,22,55,58,70,52,23,19,23,322
500490304,54,75,65,74,61,22,10,5,366
500490305,45,49,55,78,49,33,8,12,329
500490306,28,49,62,70,62,41,24,19,355
500490307,1,5,1,3,3,2,0,2,17
500490308,36,42,50,57,45,25,11,21,287
500490309,48,59,99,75,65,58,10,31,445
500490310,25,48,43,29,25,9,7,2,188
500490311,34,52,38,30,29,10,5,4,202
500490312,39,59,64,53,34,11,2,3,265
500490313,54,63,91,92,62,54,19,37,472
500490314,42,66,82,87,63,38,17,32,427
500490315,53,42,44,59,55,30,22,24,329
500490316,17,31,44,62,43,32,26,36,291
500490317,27,35,50,66,55,32,24,17,306
500490318,28,35,46,41,36,14,11,17,228
500490319,30,48,45,57,39,23,11,16,269
500490320,23,49,58,67,46,16,18,13,290
500490321,31,41,61,61,56,44,12,16,322
500490401,31,51,51,55,38,17,4,7,254
500490402,46,77,73,65,50,23,8,8,350
500490403,54,75,67,79,39,14,5,4,337
500490404,44,89,68,62,38,13,8,4,326
500490405,33,50,54,41,28,6,8,3,223
500490406,36,64,41,43,23,11,4,3,225
500490407,42,76,50,53,41,17,5,6,290
500490408,33,51,57,36,18,7,8,2,212
500490409,66,78,75,61,45,34,14,8,381
500490410,43,66,49,59,30,13,4,10,274
500490411,48,78,81,79,35,15,1,7,344
500490412,34,57,56,49,28,19,5,5,253
500490413,25,31,29,23,19,8,4,7,146
500490414,43,66,69,53,39,18,11,9,308
500490501,3,3,1,0,0,0,0,0,7
500490502,22,23,23,25,27,17,5,5,147
500490503,47,76,94,109,58,32,9,20,445
500490504,39,58,80,80,58,33,10,3,361
500490505,44,71,90,106,66,43,14,34,468
500490506,26,36,34,33,13,7,3,2,154
500490507,31,82,80,78,52,30,11,12,376
500490601,0,0,0,0,0,0,0,0,0
500490602,14,12,4,8,4,2,2,0,46
500490603,11,10,12,11,3,1,3,1,52
500490701,14,32,38,50,29,32,19,11,225
500490702,20,42,41,43,40,27,16,9,238
500490703,25,29,45,53,29,32,12,7,232
500490704,24,66,65,65,58,35,19,17,349
500490705,44,62,58,80,57,33,10,17,361
500490706,27,40,38,46,25,19,9,6,210
500490707,24,35,49,36,32,21,7,9,213
500490708,13,41,48,51,33,16,9,7,218
500490709,32,54,57,57,45,21,9,13,288
500490710,20,32,33,32,23,8,1,4,153
500490711,27,57,55,54,34,25,7,4,263
500490712,32,65,53,38,43,16,4,10,261
500490713,43,58,52,56,24,19,11,5,268
500490714,39,33,38,28,18,14,1,1,172
500490715,42,54,57,65,25,19,5,5,272
500490801,18,54,58,72,43,24,7,8,284
500490802,40,69,86,76,42,24,4,6,347
500490803,33,42,44,36,30,14,12,9,220
500490804,23,50,45,74,57,35,10,10,304
500490805,38,54,68,73,54,47,24,28,386
500490806,34,49,62,42,44,36,14,8,289
500490807,36,60,74,46,47,34,14,21,332
500490808,37,73,78,78,74,38,15,21,414
500490809,20,55,54,70,52,32,24,25,332
500490810,42,63,54,58,35,18,19,15,304
500490811,18,44,67,69,50,37,14,34,333
500490812,25,49,88,109,68,39,19,20,417
500490813,21,40,32,31,16,5,2,5,152
500490814,53,93,62,67,37,18,3,7,340
500490815,28,56,59,79,65,38,11,9,345
500490816,15,32,37,42,27,13,10,13,189
500490817,37,72,60,72,56,23,6,11,337
500490818,21,47,53,37,38,28,15,11,250
500490819,12,38,45,36,41,20,4,6,202
500490820,37,55,40,45,36,17,6,4,240
500490901,64,98,69,85,37,20,5,7,385
500490902,12,30,62,61,37,13,3,2,220
500490903,22,55,37,41,21,12,12,9,209
500490904,20,45,32,46,18,13,9,1,184
500490905,59,80,72,47,36,17,12,16,339
500490906,32,65,71,56,44,27,3,8,306
500490907,39,70,54,58,28,15,5,8,277
500490908,38,47,37,39,26,10,7,3,207
500490909,45,78,59,46,39,15,5,12,299
500490910,38,71,55,47,23,28,7,5,274
500490911,31,79,93,93,44,19,9,1,369
500490912,22,43,40,35,20,9,3,2,174
500490913,30,51,54,46,42,17,7,11,258
500490914,40,79,71,38,36,16,9,4,293
500490915,35,78,53,49,40,19,10,3,287
500490916,23,67,64,62,44,21,17,11,309
500490917,39,44,58,42,22,16,5,6,232
500490918,33,44,51,47,19,20,4,0,218
500490919,33,43,31,34,18,5,3,6,173
500491001,36,76,79,118,89,39,13,12,462
500491002,19,79,71,81,47,19,7,12,335
500491003,21,30,44,56,34,14,5,5,209
500491004,28,38,34,24,18,19,3,2,166
500491005,26,58,53,47,43,21,6,3,257
500491006,15,34,48,40,26,13,3,9,188
500491007,30,66,63,70,47,35,28,17,356
500491008,13,33,40,53,36,7,3,2,187
500491009,17,56,55,48,29,10,3,3,221
500491010,28,66,67,71,27,16,2,7,284
500491011,26,64,51,59,34,12,2,1,249
500491012,24,53,76,66,47,16,8,1,291
500491013,32,56,52,53,21,11,2,4,231
500491101,1,2,1,2,0,1,0,0,7
500491102,2,1,2,10,8,1,1,1,26
500491103,39,49,67,79,51,34,21,16,356
500491104,23,33,30,22,30,8,2,12,160
500491105,21,32,19,42,31,8,0,0,153
500491106,17,46,33,51,32,16,1,3,199
500491107,12,19,19,44,20,4,2,0,120
500491108,14,25,31,62,30,12,0,0,174
500491109,18,36,43,64,23,8,2,2,196
500491110,50,108,67,70,55,25,7,5,387
500491111,38,55,59,53,38,17,7,3,270
500491112,54,102,77,62,60,14,6,6,381
500491113,8,18,23,20,15,12,7,7,110
500491114,22,36,49,42,41,24,9,18,241
500491115,13,37,28,41,22,13,6,15,175
500491116,23,39,64,63,42,25,9,25,290
500491117,31,71,57,74,59,38,22,18,370
500491118,11,28,48,51,43,22,3,4,210
500491119,33,60,68,64,35,35,3,5,303
500491201,15,23,23,41,23,18,13,13,169
500491202,26,41,48,70,42,23,5,6,261
500491203,35,57,72,69,66,47,16,11,373
500491204,19,42,54,53,25,10,1,0,204
500491205,16,73,77,89,32,12,10,1,310
500491206,29,60,55,65,30,11,2,1,253
500491207,35,67,73,89,49,20,4,2,339
500491208,23,42,39,57,29,19,5,2,216
500491209,17,37,31,52,28,15,2,2,184
500491210,13,40,51,68,43,6,1,0,222
500491211,14,30,35,51,28,10,0,1,169
500491212,18,59,66,109,58,19,7,5,341
500491213,24,43,53,52,35,11,7,9,234
500491214,44,74,25,51,25,9,2,2,232
500491215,54,97,71,73,53,26,4,11,389
500491216,49,90,77,50,36,14,7,8,331
500491217,31,54,51,64,25,10,0,0,235
500491301,25,58,45,65,40,23,10,18,284
500491302,40,54,75,96,74,54,34,34,461
500491303,21,26,39,60,40,42,11,28,267
500491304,36,56,56,76,44,34,15,18,335
500491305,14,28,25,40,46,28,13,15,209
500491306,6,19,26,44,35,36,11,19,196
500491307,42,58,72,72,51,36,22,28,381
500491308,38,63,57,74,49,38,21,25,365
500491309,32,62,65,78,56,30,18,16,357
500491310,40,73,65,76,52,39,10,15,370
500491311,35,67,71,70,43,36,16,17,355
500491312,49,78,87,98,59,44,13,10,438
500491313,26,38,38,59,30,28,17,11,247
500491314,21,31,39,30,34,17,10,5,187
500491401,21,39,64,72,44,26,5,1,272
500491402,31,73,99,97,66,33,8,8,415
500491403,25,49,63,68,42,21,5,2,275
500491404,8,23,28,47,23,11,4,1,145
500491405,35,58,65,91,46,31,6,9,341
500491406,37,108,69,69,56,20,5,8,372
500491407,33,70,60,74,47,18,5,6,313
500491408,29,52,72,80,51,18,9,5,316
500491409,25,66,57,58,31,8,8,7,260
500491410,16,47,60,69,66,33,12,14,317
500491411,10,12,37,39,23,14,14,8,157
500491412,23,45,54,73,61,38,14,17,325
500491413,4,28,46,60,69,42,18,27,294
500491414,14,34,29,62,31,12,7,5,194
500560101,34,34,30,38,28,26,20,29,239
500560201,76,47,54,46,32,25,13,7,300
500560301,48,22,45,39,24,22,7,19,226
500560401,14,22,30,32,26,12,9,15,160
500560402,32,39,48,43,29,14,14,11,230
500560403,40,59,52,72,79,31,16,17,366
500560404,46,53,61,80,59,32,16,41,388
500560405,23,37,43,39,28,12,6,3,191
500560406,27,43,53,50,47,29,8,13,270
500560407,56,95,83,87,80,68,20,19,508
500560408,24,44,33,44,24,14,6,3,192
500560409,32,60,58,67,46,28,14,4,309
500560501,23,34,45,70,51,26,17,27,293
500560502,19,13,19,20,24,14,5,7,121
500560503,14,21,48,43,46,20,10,18,220
500560504,31,47,47,52,61,25,18,16,297
500560505,13,12,23,31,23,13,10,15,140
500560506,8,39,33,46,41,19,18,19,223
500560507,14,31,40,62,39,34,16,29,265
500560601,14,16,18,30,15,12,9,7,121
500560602,26,37,55,40,40,23,12,18,251
500560603,44,79,89,65,45,26,9,4,361
500560604,35,62,69,107,57,33,18,16,397
500560605,40,70,88,70,59,34,17,20,398
500560606,29,82,72,84,68,29,14,6,384
500560607,6,14,27,30,25,6,2,4,114
500560608,22,41,60,50,34,17,9,14,247
500560609,33,39,59,60,51,49,21,19,331
500560610,26,35,48,49,35,20,10,16,239
500560611,20,55,51,67,41,22,18,31,305
500560612,21,37,40,46,31,28,9,10,222
500560613,23,31,37,50,44,26,12,13,236
500560614,8,8,12,15,11,11,4,4,73
500560615,42,43,55,54,36,26,21,16,293
500560616,9,15,33,36,40,26,14,11,184
500560701,24,38,30,25,15,26,10,7,175
500630101,29,71,53,57,40,24,8,2,284
500630102,25,32,55,66,34,12,2,3,229
500630103,29,71,85,102,49,28,7,11,382
500630104,33,51,60,77,55,30,9,5,320
500630105,20,37,32,47,25,19,4,3,187
500630106,20,35,24,48,27,11,4,2,171
500630107,52,76,74,81,49,25,4,3,364
500630108,25,31,22,56,34,9,4,1,182
500630109,30,65,69,80,66,28,5,6,349
500630110,17,40,30,48,24,6,3,2,170
500630111,18,35,27,39,21,7,3,1,151
500630112,6,16,23,49,33,5,1,0,133
500630113,23,53,61,83,52,20,9,4,305
500630201,19,48,50,71,35,8,2,2,235
500630202,33,67,66,82,50,17,2,3,320
500630203,51,78,52,61,30,20,5,3,300
500630204,36,54,53,49,29,10,4,4,239
500630205,32,76,41,33,26,17,9,3,237
500630206,31,41,27,35,16,5,3,3,161
500630207,29,40,29,27,25,19,1,3,173
500630208,45,65,57,42,24,6,2,1,242
500630209,20,51,41,43,22,7,5,2,191
500630210,23,43,50,52,30,4,4,3,209
500630211,23,68,84,56,45,35,12,8,331
500630212,38,49,42,57,32,8,2,4,232
500630213,34,63,47,46,30,14,1,4,239
500630214,54,86,50,37,22,8,3,0,260
500630215,51,76,56,50,27,9,1,2,272
500630216,31,37,49,35,27,15,10,10,214
500630217,1,9,5,7,3,3,2,6,36
500630218,26,41,46,51,40,31,18,22,275
500630301,5,3,1,2,2,0,3,1,17
500630302,32,22,36,47,39,22,12,14,224
500630303,6,8,9,19,8,3,2,4,59
500630304,13,37,37,28,21,7,6,3,152
500630305,42,64,58,79,55,31,10,11,350
500630306,26,72,91,81,43,37,11,6,367
500630307,31,55,58,81,51,37,8,14,335
500630308,10,47,49,40,33,29,9,3,220
500630309,20,69,74,67,54,32,9,11,336
500630310,64,96,122,163,108,61,30,38,682
500630311,29,50,57,63,40,31,7,10,287
500630312,23,53,76,117,86,53,25,38,471
500630401,30,24,38,48,45,32,11,21,249
500630402,41,50,66,75,56,54,17,30,389
500630403,31,51,41,70,48,35,11,21,308
500630404,14,15,19,17,18,10,8,1,102
500630405,28,32,49,70,45,37,15,17,293
500630406,35,75,96,112,87,64,28,39,536
500630407,28,53,53,63,35,26,16,9,283
500630408,23,22,32,46,33,33,15,12,216
500630409,35,64,73,71,55,31,16,13,358
500630410,53,55,74,65,55,39,17,18,376
500630411,41,73,89,128,97,59,19,29,535
500630501,34,40,47,56,56,21,18,28,300
500630502,41,43,45,59,40,14,13,6,261
500630503,21,26,24,27,28,27,10,15,178
500630504,21,22,36,44,31,23,9,17,203
500630601,3,4,3,4,7,4,1,4,30
500630602,8,6,8,9,9,3,3,1,47
500630701,0,3,2,0,2,0,0,0,7
500630702,7,6,3,7,3,1,0,1,28
500630703,30,36,30,30,24,15,6,7,178
500630704,18,16,11,10,4,0,5,1,65
500630705,8,12,4,9,3,2,1,1,40
500630706,10,6,3,4,1,1,0,0,25
500630707,15,8,9,9,2,4,4,2,53
500630801,38,62,41,48,45,14,4,2,254
500630802,38,54,50,64,37,21,5,6,275
500630803,43,78,57,58,33,21,4,3,297
500630804,34,113,81,74,36,22,9,5,374
500630805,28,65,44,48,32,25,12,6,260
500630806,11,19,29,34,28,8,4,4,137
500630807,24,47,54,67,30,12,2,1,237
500630808,37,86,67,66,27,17,10,1,311
500630809,28,67,64,71,57,27,11,21,346
500630810,8,25,40,63,25,11,2,1,175
500630811,16,68,47,64,49,23,7,5,279
500630812,30,56,50,116,62,17,2,2,335
500630813,31,50,57,62,41,11,7,1,260
500630814,27,75,69,110,57,24,3,2,367
500630901,29,44,67,68,41,20,7,8,284
500630902,0,0,0,0,0,0,0,0,0
500630903,22,33,33,58,22,15,2,8,193
500630904,29,59,45,61,45,17,9,6,271
500630905,33,50,64,86,57,43,9,16,358
500630906,37,69,60,66,51,51,12,14,360
500630907,36,62,75,86,63,54,25,23,424
500630908,23,48,55,47,39,20,6,6,244
500630909,27,61,54,73,44,33,7,3,302
500630910,22,44,53,68,46,32,16,14,295
500630911,21,42,38,50,23,13,4,1,192
500630912,35,52,56,54,40,30,11,12,290
500630913,41,65,48,48,31,10,4,9,256
500630914,33,81,74,72,54,46,21,18,399
500630915,23,55,59,87,46,28,8,9,315
500631001,30,63,48,44,35,15,5,4,244
500631002,16,41,31,46,17,11,1,6,169
500631003,18,54,43,70,40,16,7,8,256
500631004,17,33,39,47,33,13,3,3,188
500631005,21,48,67,83,43,18,6,3,289
500631006,10,44,43,60,58,19,10,6,250
500631007,18,28,38,65,41,10,4,2,206
500631008,43,52,73,96,76,15,8,1,364
500631009,16,27,28,34,43,14,3,11,176
500631010,51,90,62,69,34,15,4,4,329
500631011,53,76,72,59,41,18,6,5,330
500631012,32,39,34,32,12,23,8,7,187
500631013,30,72,64,86,45,27,6,4,334
500631014,21,36,41,41,24,12,4,3,182
500631015,13,49,37,41,29,17,8,0,194
500631016,9,33,22,34,13,6,0,1,118
500631017,33,68,71,96,55,39,8,7,377
500631101,28,84,91,86,57,17,8,5,376
500631102,22,31,38,37,17,11,3,2,161
500631103,24,39,56,87,86,52,23,34,401
500631104,34,37,55,64,48,40,14,20,312
500631105,14,33,63,100,55,34,19,28,346
500631106,9,13,19,39,26,35,12,21,174
500631107,8,11,24,25,20,20,6,8,122
500631108,26,72,63,44,35,31,9,11,291
500631109,24,46,53,87,33,18,8,8,277
500631110,18,26,25,38,18,2,1,0,128
500631111,8,31,26,53,28,13,3,1,163
500631112,16,24,34,53,23,10,1,2,163
500631113,39,63,58,80,48,26,5,5,324
500631114,18,36,73,109,61,17,2,0,316
500631115,22,34,43,55,38,13,5,2,212
500631116,32,46,43,68,26,15,1,0,231
500700101,17,30,34,54,38,23,17,27,240
500700102,26,40,49,72,43,32,20,13,295
500700103,60,88,70,96,79,21,3,5,422
500700104,15,31,33,47,23,20,3,11,183
500700105,44,61,97,113,78,50,20,15,478
500700106,59,96,86,85,56,30,10,9,431
500700107,7,23,34,22,28,16,6,12,148
500700108,26,47,48,43,25,8,4,4,205
500700109,73,82,122,146,94,70,36,33,656
500700110,108,120,167,142,114,80,33,40,804
500700111,27,39,58,82,49,28,19,19,321
500700112,23,49,51,61,51,36,12,11,294
500700113,24,21,41,48,45,27,13,13,232
500700114,25,58,43,58,46,45,8,22,305
500700115,15,26,33,31,18,19,5,6,153
500700116,39,75,113,120,85,72,30,26,560
500700117,21,57,86,100,85,60,20,34,463
500700118,39,38,41,53,35,33,5,4,248
500700201,17,15,54,36,23,24,13,15,197
500700202,39,32,40,58,48,38,20,33,308
500700203,24,23,38,49,30,32,7,8,211
500700204,29,55,52,68,44,36,16,17,317
500700205,33,45,52,64,45,31,8,15,293
500700206,20,46,45,59,42,28,19,14,273
500700207,43,95,115,105,85,42,12,25,522
500700208,69,99,58,56,43,15,4,2,346
500700209,34,66,64,67,44,14,8,7,304
500700210,25,48,72,80,49,51,17,17,359
500700211,29,74,74,90,54,35,13,20,389
500700212,30,62,68,84,43,25,10,15,337
500700213,27,54,80,125,62,22,7,0,377
500700214,28,44,46,64,39,12,10,4,247
500700215,13,11,21,19,23,15,7,10,119
500700301,39,66,86,105,83,45,18,17,459
500700302,61,92,124,123,71,41,23,28,563
500700303,44,55,62,80,52,36,29,12,370
500700304,31,42,67,53,49,24,13,13,292
500700305,71,105,100,133,74,49,15,20,567
500700306,17,16,34,28,34,19,14,10,172
500700307,20,28,40,27,28,22,10,5,180
500700308,13,41,53,48,42,28,8,13,246
500700401,22,24,39,32,23,3,6,0,149
500700402,39,68,68,78,48,27,3,6,337
500700403,26,64,77,68,59,41,12,18,365
500700404,57,67,78,109,71,50,17,18,467
500700405,31,72,91,95,59,33,10,13,404
500700406,58,108,110,92,65,35,10,7,485
500700407,30,79,104,99,100,38,10,8,468
500700408,23,74,98,134,82,63,24,28,526
500700409,46,79,105,93,67,41,21,25,477
500700410,9,14,16,32,18,14,4,5,112
500700411,26,47,62,83,46,29,3,9,305
500700412,17,64,88,87,69,31,11,15,382
500700413,38,94,72,92,61,29,22,24,432
500700414,22,43,63,92,51,26,7,10,314
500700415,22,38,47,51,27,20,9,3,217
500700416,38,64,82,90,49,29,21,23,396
500700417,40,71,80,71,62,34,13,11,382
500700418,24,67,66,75,56,23,9,3,323
500700419,27,75,79,79,49,27,11,15,362
500700420,34,57,58,83,50,16,11,10,319
500700421,41,57,75,96,46,23,8,10,356
500700422,33,60,69,68,38,28,3,5,304
500700423,37,51,61,86,47,29,12,12,335
500700424,26,47,52,39,29,15,3,5,216
500700425,33,48,50,58,42,12,10,6,259
500700501,38,86,102,149,96,30,13,5,519
500700502,22,36,54,93,50,26,13,7,301
500700503,8,30,40,45,25,11,5,1,165
500700504,30,52,43,49,32,16,6,6,234
500700505,25,71,93,94,34,20,5,7,349
500700506,34,72,69,75,37,27,7,5,326
500700507,24,54,57,68,46,12,4,5,270
500700508,32,72,77,51,35,12,3,1,283
500700509,44,54,44,35,21,12,3,6,219
500700510,54,95,64,84,57,23,14,12,403
500700511,46,91,70,83,51,17,9,4,371
500700512,36,68,70,89,58,24,15,13,373
500700513,33,38,73,83,44,33,6,10,320
500700514,44,60,60,67,42,23,9,5,310
500700601,55,74,90,99,65,36,13,19,451
500700602,46,89,83,112,67,42,14,17,470
500700603,55,90,95,101,59,29,13,5,447
500700604,24,63,46,38,26,6,4,5,212
500700605,41,63,45,53,29,11,5,5,252
500700606,33,88,57,62,35,15,5,7,302
500700607,23,63,57,52,35,33,14,10,287
500700608,29,81,96,117,68,36,18,14,459
500700609,23,57,51,33,36,22,4,1,227
500700610,25,63,51,36,30,12,2,2,221
500700611,31,55,36,41,23,13,7,2,208
500700612,57,96,75,90,61,28,11,10,428
500700613,7,41,53,89,49,11,3,1,254
500700701,27,79,38,46,16,11,1,1,219
500700702,43,86,63,49,24,18,9,3,295
500700703,35,70,78,68,31,23,1,5,311
500700704,10,26,30,67,34,16,1,3,187
500700705,28,49,70,71,48,25,10,11,312
500700706,27,64,69,99,67,51,17,19,413
500700707,47,59,64,61,29,6,5,2,273
500700708,42,56,55,56,37,19,9,4,278
500700709,26,38,38,38,28,7,2,1,178
500700710,29,41,34,35,19,7,3,3,171
500700711,35,64,61,57,28,12,4,2,263
500700712,16,33,48,36,30,6,3,1,173
500700801,37,51,76,69,46,18,7,9,313
500700802,30,62,60,56,36,20,3,7,274
500700803,45,78,64,55,33,8,8,6,297
500700804,20,58,72,101,52,19,6,3,331
500700805,37,71,107,120,78,33,10,4,460
500700806,41,107,65,79,40,21,6,4,363
500700807,18,44,54,44,25,16,3,7,211
500700808,24,46,57,91,38,19,4,2,281
500700809,13,35,45,68,28,18,6,6,219
500700810,41,89,76,77,41,18,12,6,360
500700811,34,39,78,58,36,12,7,4,268
500700812,25,60,63,76,54,20,10,6,314
500700813,25,45,43,51,36,17,10,6,233
500700814,48,68,64,55,37,19,10,6,307
500700815,33,52,57,45,25,13,7,4,236
500700816,20,50,61,103,59,21,3,2,319
500700901,41,51,57,52,38,17,10,7,273
500700902,21,40,48,65,79,40,25,27,345
500700903,56,85,105,139,98,80,53,47,663
500700904,54,79,65,72,44,32,8,15,369
500700905,24,42,52,60,24,13,7,1,223
500700906,23,49,42,46,22,9,4,2,197
500700907,31,74,50,66,37,18,7,5,288
500700908,67,78,84,76,50,28,9,5,397
500700909,21,50,34,45,36,25,11,4,226
500700910,25,38,40,63,35,18,10,9,238
500700911,25,58,78,105,60,39,23,15,403
500700912,18,57,66,58,48,27,9,17,300
500700913,4,22,40,27,39,23,13,11,179
500701001,24,31,45,88,54,36,8,17,303
500701002,15,45,46,78,48,19,3,5,259
500701003,14,42,53,74,50,9,7,4,253
500701004,21,49,75,94,49,7,4,7,306
500701005,7,20,40,45,22,10,5,2,151
500701006,33,80,84,108,61,18,9,7,400
500701007,16,39,45,71,33,12,1,2,219
500701008,28,51,46,43,21,10,6,2,207
500701009,39,46,38,43,33,12,6,0,217
500701010,55,91,56,60,41,13,2,4,322
500701011,33,56,50,29,15,11,4,1,199
500701012,30,58,70,110,54,11,2,0,335
500701013,18,32,41,40,33,19,7,9,199
500770101,13,17,21,14,15,6,2,2,90
500770102,30,14,13,15,13,8,1,1,95
500770103,23,30,30,26,31,7,4,8,159
500770104,17,15,20,13,12,5,6,2,90
500770105,31,47,60,65,43,29,5,5,285
500770106,35,39,56,59,30,22,1,4,246
500770107,40,69,61,36,21,0,2,6,235
500770108,55,61,59,72,35,13,1,1,297
500770109,55,61,58,56,19,17,3,1,270
500770110,55,59,59,60,19,11,5,3,271
500770111,11,9,11,6,4,1,2,2,46
500770112,56,70,70,55,30,8,6,2,297
500770113,52,74,64,67,33,15,3,3,311
500770114,48,77,101,100,69,36,17,12,460
500770115,26,30,51,52,34,21,8,7,229
500770116,29,48,84,134,62,26,7,4,394
500770117,56,65,71,65,35,14,8,7,321
500770118,34,36,50,47,33,15,5,9,229
500770119,32,46,67,69,54,26,12,9,315
500770120,51,45,58,51,29,21,5,7,267
500770121,27,34,41,30,26,14,9,10,191
500770122,44,46,67,85,53,27,19,14,355
500770123,35,68,74,74,57,28,4,7,347
500770124,49,37,58,76,33,15,7,6,281
500770125,39,39,60,58,41,19,9,10,275
500770126,26,55,54,52,41,23,12,7,270
500770127,29,51,59,56,42,20,17,11,285
500770128,1,2,0,1,0,0,0,0,4
500770201,37,36,41,37,21,4,3,4,183
500770202,16,22,20,12,10,8,1,4,93
500770203,2,7,5,4,1,0,0,0,19
500770301,31,56,47,51,19,14,5,5,228
500770302,10,9,5,2,7,5,1,0,39
500770401,0,2,4,2,4,0,2,0,14
500770402,36,45,38,43,31,17,6,4,220
500770403,12,26,18,24,12,9,5,3,109
500840101,29,68,72,81,48,27,15,7,347
500840102,19,39,25,36,32,12,3,8,174
500840103,30,37,61,62,40,24,4,9,267
500840104,37,75,46,38,30,8,2,4,240
500840105,10,29,32,48,23,19,10,17,188
500840201,58,102,99,100,71,49,22,18,519
500840202,21,39,45,81,59,30,8,12,295
500840203,35,49,49,45,32,20,11,7,248
500840204,90,135,92,103,47,20,13,5,505
500840205,38,89,74,86,49,16,8,10,370
500840206,28,50,54,82,41,14,10,5,284
500840207,40,61,79,88,60,19,5,7,359
500840208,39,68,50,42,13,11,3,1,227
500840209,48,61,30,26,12,3,1,2,183
500840210,29,40,47,58,33,16,6,4,233
500840211,48,81,73,53,30,13,6,4,308
500840212,47,58,53,53,21,18,2,8,260
500840213,68,96,82,60,28,14,2,2,352
500840214,54,73,62,73,35,19,5,7,328
500840215,19,45,54,54,44,35,18,21,290
500840216,18,32,49,47,24,15,4,4,193
500840217,9,22,25,19,15,7,3,4,104
500840301,27,45,56,40,31,15,7,1,222
500840302,37,82,80,96,64,29,18,17,423
500840303,37,56,43,63,28,20,11,8,266
500840304,47,46,62,82,44,30,18,14,343
500840305,32,55,58,69,42,26,9,17,308
500840306,25,38,51,58,28,24,9,21,254
500840307,30,63,40,58,41,20,9,7,268
500840308,17,45,56,55,31,24,10,11,249
500840309,35,48,54,53,45,13,5,9,262
500840401,2,9,14,5,14,6,3,7,60
500840402,27,34,26,47,24,25,8,4,195
500840403,32,49,68,69,53,25,22,9,327
500840404,12,20,16,21,16,10,1,3,99
500840405,20,38,33,34,30,16,8,10,189
500840406,29,35,44,33,30,18,9,11,209
500840407,21,57,58,51,29,18,4,1,239
500840501,15,13,13,16,11,4,3,5,80
500840601,6,7,8,5,9,7,3,3,48
500840701,13,25,28,21,16,8,7,7,125
500840702,26,51,39,61,34,13,9,11,244
500840703,20,30,37,25,24,14,8,10,168
500840704,17,22,34,42,22,18,4,8,167
500840705,42,57,50,65,46,16,13,24,313
500840706,23,31,32,38,25,15,0,9,173
500840801,23,45,45,52,31,9,5,4,214
500840802,20,59,55,80,36,37,14,25,326
500840803,32,57,86,85,53,30,10,8,361
500840804,29,57,54,51,22,14,3,6,236
500840805,57,77,93,75,46,28,7,7,390
500840806,60,110,99,78,43,23,9,5,427
500840807,39,67,49,46,25,11,5,1,243
500840808,93,116,77,79,43,15,5,2,430
500840809,34,61,73,93,51,26,10,4,352
500840810,25,59,54,62,65,36,11,11,323
500840811,42,76,52,63,45,17,2,2,299
500840812,66,111,72,68,25,16,7,7,372
500840813,31,85,61,78,68,47,15,21,406
500910101,55,96,103,126,92,39,21,21,553
500910102,16,26,23,39,24,20,8,8,164
500910103,21,23,21,24,32,17,7,13,158
500910104,17,22,31,37,23,15,9,11,165
500910105,54,82,86,77,62,32,5,7,405
500910106,49,60,33,32,26,13,7,4,224
500910107,45,72,45,53,25,11,0,3,254
500910108,53,70,75,81,46,21,10,11,367
500910109,65,70,56,54,28,17,4,8,302
500910110,23,66,42,38,29,10,6,4,218
500910111,35,76,74,81,56,30,6,12,370
500910112,28,33,38,41,44,16,13,12,225
500910113,28,32,44,55,31,25,8,8,231
500910201,35,46,61,67,50,32,17,22,330
500910202,64,104,104,142,66,35,12,21,548
500910203,32,73,81,91,51,29,16,13,386
500910204,54,76,94,73,25,12,6,3,343
500910205,24,30,43,58,46,19,11,14,245
500910206,35,61,61,71,38,30,9,9,314
500910207,24,42,60,77,39,31,13,6,292
500910208,45,75,75,83,39,26,6,4,353
500910209,35,47,62,70,53,27,10,7,311
500910301,31,37,51,57,41,19,9,11,256
500910302,41,58,55,74,58,35,12,15,348
500910303,31,41,59,37,32,23,15,11,249
500910304,29,40,41,71,31,17,6,5,240
500910305,51,69,66,58,45,36,12,10,347
500910306,43,67,57,81,53,24,12,20,357
500910307,45,49,60,55,29,25,9,11,283
500910401,16,8,11,2,2,2,1,0,42
500910501,7,6,4,6,0,0,1,2,26
500910601,17,10,18,10,18,5,1,0,79
500980101,42,60,59,71,39,25,18,12,326
500980102,37,73,80,120,61,52,26,39,488
500980103,22,23,51,48,48,35,12,22,261
500980104,30,50,68,90,53,49,28,21,389
500980105,38,58,47,49,42,15,17,16,282
500980106,47,79,83,87,55,32,8,8,399
500980107,13,17,29,28,19,11,9,9,135
500980108,19,53,64,78,48,23,17,8,310
500980201,3,3,5,2,3,2,2,3,23
500980202,26,35,38,35,31,27,12,6,210
500980203,3,3,14,16,14,4,8,3,65
500980204,11,19,26,29,15,8,8,10,126
500980205,6,16,22,16,15,14,6,5,100
500980206,13,10,10,3,2,1,0,2,41
500980301,29,53,43,64,32,15,9,19,264
500980302,8,22,37,36,29,16,7,6,161
500980303,26,64,64,68,50,40,16,19,347
500980304,20,46,43,57,39,15,12,8,240
500980305,41,50,43,59,43,22,14,13,285
500980306,38,71,94,90,57,36,11,10,407
500980307,16,40,40,31,23,17,3,4,174
500980308,35,81,80,88,50,25,9,11,379
500980401,14,48,56,83,36,11,0,0,248
500980402,35,80,59,54,34,24,12,8,306
500980403,43,82,78,66,34,24,4,2,333
500980404,59,97,59,68,44,21,7,6,361
500980405,50,88,79,44,32,12,5,4,314
500980406,29,51,73,89,61,24,5,3,335
500980407,40,85,80,97,56,37,7,6,408
500980408,23,51,50,84,47,19,6,0,280
500980409,58,92,73,63,43,12,7,4,352
500980410,31,65,43,32,21,10,2,1,205
500980411,48,71,59,60,36,9,3,6,292
500980412,51,56,69,45,21,11,3,4,260
500980413,43,59,43,37,19,12,3,0,216
500980414,2,3,7,2,4,3,0,1,22
500980415,33,81,88,105,68,20,5,2,402
500980416,24,27,37,44,13,12,2,0,159
500980417,40,73,92,104,52,13,1,3,378
500980501,13,35,24,44,22,20,8,12,178
500980502,9,5,10,17,5,4,3,5,58
500980503,24,31,51,59,44,34,6,9,258
500980504,24,38,76,73,46,30,20,18,325
500980505,31,65,48,77,46,31,15,23,336
500980506,42,61,71,70,63,31,6,14,358
500980507,39,61,62,42,28,16,6,3,257
500980508,31,74,87,79,72,33,18,16,410
500980509,14,32,40,42,40,13,3,2,186
500980510,20,44,57,34,28,18,6,1,208
500980511,36,46,37,40,20,15,3,9,206
500980512,79,95,87,62,40,18,8,4,393
500980601,22,23,38,37,35,17,7,12,191
500980602,18,32,56,46,36,27,11,11,237
500980603,20,56,42,57,43,18,10,20,266
500980604,28,57,74,61,52,17,13,6,308
500980605,29,54,52,69,35,35,12,18,304
500980606,28,60,49,65,44,32,18,24,320
500980607,17,51,41,49,34,26,9,8,235
500980608,37,68,57,66,40,15,7,15,305
500980609,40,42,47,41,32,21,10,20,253
500980610,19,22,28,37,20,14,5,9,154
500980611,23,70,57,76,53,29,16,13,337
500980612,24,48,52,41,20,30,12,9,236
500980701,12,21,28,46,26,18,7,8,166
500980702,42,75,74,59,50,29,12,11,352
500980703,38,43,40,66,28,17,10,12,254
500980704,20,36,50,47,35,28,9,8,233
500980705,51,73,78,66,44,19,3,10,344
500980706,51,95,53,55,32,7,2,0,295
500980707,42,82,59,59,28,15,3,0,288
500980708,22,62,34,33,18,11,3,2,185
500980709,35,87,58,43,31,7,4,2,267
500980710,36,42,26,33,15,5,1,0,158
500980711,39,43,48,36,19,7,2,3,197
500980712,36,54,58,32,26,14,6,1,227
500980713,24,72,45,32,15,6,0,1,195
500980714,36,60,56,59,34,19,2,4,270
500980715,39,88,103,142,71,39,14,12,508
500980716,32,63,90,99,40,15,6,2,347
500980717,33,41,46,45,24,11,2,1,203
500980718,41,75,54,45,28,6,4,2,255
500980719,22,64,61,64,59,43,14,17,344
500980720,35,66,32,30,10,10,3,1,187
500980721,24,43,30,42,29,24,6,15,213
500980722,20,43,49,46,29,17,7,7,218
500980801,44,72,66,69,47,26,10,6,340
500980802,47,71,75,83,69,50,17,19,431
500980803,23,52,71,91,73,56,20,28,414
500980804,25,53,64,109,65,31,25,18,390
500980805,41,69,115,104,72,37,11,16,465
500980806,74,103,87,95,56,17,16,7,455
500980807,55,123,85,61,35,12,4,4,379
500980808,68,106,77,47,31,13,5,4,351
500980809,51,58,61,55,32,16,10,7,290
500980810,32,70,71,64,39,8,4,6,294
500980811,32,80,92,127,65,23,9,7,435
500980812,23,48,37,49,28,7,5,1,198
500980813,18,36,67,50,42,16,4,1,234
500980814,43,47,56,31,21,8,4,5,215
500980815,43,56,39,30,27,9,3,2,209
500980816,35,51,27,29,11,10,2,2,167
500980817,18,26,41,47,30,13,7,5,187
500980818,28,67,71,96,53,34,13,23,385
500980819,36,55,67,75,45,22,13,8,321
500980820,24,50,44,56,37,31,6,4,252
500980821,3,12,33,20,20,19,2,13,122
500980901,37,76,51,40,35,14,5,0,258
500980902,15,41,35,33,24,6,4,3,161
500980903,53,95,67,71,50,23,8,11,378
500980904,50,74,75,70,51,24,11,13,368
500980905,39,87,60,65,25,29,10,6,321
500980906,38,55,72,65,41,26,8,3,308
500980907,47,83,98,110,79,55,28,28,528
500980908,13,30,59,63,55,26,20,21,287
500980909,52,70,70,75,69,26,16,21,399
500980910,40,55,52,58,37,22,9,7,280
500980911,21,43,65,70,44,32,18,34,327
500980912,20,38,64,61,38,24,20,8,273
501050101,8,1,0,0,0,0,0,0,9
501050102,44,54,71,53,57,32,16,16,343
501050103,26,69,62,59,26,24,11,5,282
501050104,34,72,60,51,33,20,11,13,294
501050105,31,51,60,48,38,11,8,8,255
501050106,38,82,75,82,46,22,4,2,351
501050107,40,84,63,69,45,21,4,6,332
501050108,40,76,92,94,38,13,5,0,358
501050109,11,21,22,22,9,4,5,2,96
501050110,29,49,43,42,33,12,10,5,223
501050111,38,73,58,63,38,17,1,6,294
501050112,42,71,66,68,53,18,17,16,351
501050113,42,66,44,63,31,16,5,5,272
501050201,2,0,1,1,0,0,0,0,4
501050202,42,88,76,76,62,28,16,11,399
501050203,43,50,44,54,39,21,4,13,268
501050204,27,60,84,122,66,36,6,7,408
501050205,54,81,87,79,53,31,11,10,406
501050301,16,2,2,1,1,0,0,0,22
501050302,38,45,43,40,28,14,7,7,222
501050303,31,44,40,53,33,21,10,5,237
501050304,70,123,94,118,60,47,19,31,562
501050305,25,50,48,41,37,14,10,6,231
501050306,56,95,67,112,44,34,18,9,435
501050307,45,61,41,58,53,16,13,1,288
501050308,15,13,39,52,37,34,5,4,199
501050309,46,49,56,67,34,31,5,10,298
501050310,32,44,55,43,40,18,3,4,239
501050401,45,74,65,56,34,18,5,9,306
501050402,36,69,63,70,47,17,6,6,314
501050403,26,68,56,43,28,14,2,4,241
501050404,11,17,27,58,26,13,5,5,162
501050405,47,65,73,83,58,24,9,4,363
501050406,23,68,78,61,40,18,3,2,293
501050407,59,88,77,79,63,34,19,6,425
501050408,61,72,57,71,42,22,10,7,342
501050409,34,58,52,38,26,13,5,3,229
501050410,39,29,39,44,26,17,6,17,217
501050411,69,87,62,61,40,20,9,5,353
501050412,61,62,54,37,26,4,2,4,250
501050413,68,81,55,56,23,12,3,3,301
501050414,39,76,61,53,32,17,5,3,286
501050415,56,57,39,25,8,3,0,2,190
501050416,56,58,56,48,16,11,3,3,251
501050417,54,78,70,49,24,13,11,3,302
501050418,59,78,61,68,48,22,8,10,354
501050419,34,83,93,79,53,40,12,17,411
501050420,19,59,45,42,21,5,1,5,197
501050421,40,92,96,148,97,37,6,6,522
501050422,25,24,15,24,10,4,0,0,102
501050501,59,63,32,16,15,5,1,2,193
501050502,51,31,17,10,4,2,1,1,117
501050503,46,60,35,20,13,7,2,3,186
501050504,82,76,41,39,18,4,3,1,264
501050505,44,51,28,36,18,6,0,0,183
501050506,66,77,57,46,21,12,5,1,285
501050507,41,51,45,49,28,10,1,7,232
501050508,41,51,48,26,16,8,4,4,198
501050509,56,74,41,54,42,8,5,3,283
501050510,71,94,51,38,25,7,3,3,292
501050511,67,89,43,36,20,7,1,1,264
501050512,56,60,38,20,12,5,1,0,192
501050513,93,93,59,49,25,4,1,2,326
501050514,50,74,62,55,38,12,6,4,301
501050515,48,63,57,50,33,10,7,2,270
501050516,67,86,62,50,24,9,7,3,308
501050517,59,62,39,25,23,4,1,0,213
501050518,32,53,30,20,14,6,2,0,157
501050519,18,36,41,59,26,6,2,1,189
501050520,43,44,51,27,15,16,0,5,201
501050521,45,47,33,36,13,10,1,2,187
501050601,18,8,9,3,2,4,0,1,45
501050602,53,63,59,41,38,30,9,5,298
501050603,16,9,3,10,4,4,1,3,50
501050604,0,2,0,0,0,0,0,0,2
501050605,28,66,35,35,17,8,3,2,194
501050606,50,69,51,46,32,15,9,15,287
501050607,49,56,75,61,34,12,2,8,297
501050608,25,27,22,13,8,2,1,0,98
501050701,4,0,2,0,1,1,0,0,8
501050702,29,39,32,38,27,21,9,11,206
501050703,24,54,46,44,37,19,13,5,242
501050704,32,52,52,53,42,21,9,8,269
501050705,50,61,58,55,43,23,9,11,310
501050706,39,61,60,63,35,21,11,8,298
501050707,41,48,44,33,34,16,7,5,228
501050708,40,60,47,36,27,14,9,3,236
501050801,40,54,34,53,30,18,9,5,243
501050802,27,37,24,32,22,6,4,3,155
501050803,17,30,21,25,15,8,6,4,126
501050804,4,5,3,3,4,1,1,0,21
501050805,1,6,0,1,0,0,0,0,8
501050806,37,11,10,13,8,1,0,3,83
501050807,36,46,34,23,24,8,1,5,177
501050808,25,19,24,23,11,8,3,3,116
501050901,20,17,26,27,22,15,4,11,142
501050902,0,8,1,3,0,1,0,1,14
501050903,33,27,34,58,31,18,11,17,229
501050904,41,59,53,75,36,41,9,9,323
501050905,34,45,40,35,25,17,3,2,201
501050906,66,75,53,64,36,12,8,4,318
501050907,56,69,51,44,30,14,4,7,275
501051001,10,4,2,0,1,2,0,0,19
501051002,31,58,59,41,49,21,14,12,285
501051003,10,15,7,5,8,3,0,2,50
501051004,22,17,27,15,16,6,1,1,105
501051005,4,10,8,9,2,4,4,6,47
501051006,41,58,70,61,42,24,8,13,317
501051007,47,52,73,60,53,17,8,7,317
501051008,47,71,62,91,58,29,13,15,386
501051009,21,39,43,49,25,25,13,11,226
501051010,7,9,6,12,7,2,0,1,44
501051011,27,59,37,47,32,12,3,3,220
501051012,39,66,47,44,32,10,8,9,255
501051101,45,82,70,67,56,20,8,10,358
501051102,39,66,57,50,30,13,8,10,273
501051103,39,64,59,46,28,18,9,0,263
501051104,27,39,42,46,26,10,4,6,200
501051105,69,117,114,109,67,44,20,32,572
501051106,50,87,85,107,80,33,18,9,469
501051107,63,60,71,69,43,45,14,38,403
501051108,26,36,29,35,34,13,4,6,183
501051109,21,34,28,23,14,6,5,4,135
501051110,32,38,62,52,27,20,8,5,244
501051201,22,20,23,17,19,8,4,3,116
501051202,19,30,22,18,13,12,5,6,125
501051203,24,20,19,22,7,5,5,4,106
501051204,10,21,20,16,14,2,1,0,84
501051205,43,73,58,61,40,19,11,4,309
501051206,15,35,27,27,12,15,8,2,141
501051207,5,15,25,18,10,7,7,3,90
501051208,27,50,39,63,30,28,9,6,252
501051209,24,26,46,39,32,26,3,16,212
501051301,39,49,39,30,20,5,0,0,182
501051302,36,67,51,43,15,1,3,0,216
501051303,45,85,46,44,18,5,0,1,244
501051304,46,45,37,34,9,7,0,4,182
501051305,35,52,29,31,6,6,1,0,160
501051306,52,61,32,27,14,3,1,1,191
501051307,54,80,51,36,19,4,2,2,248
501051308,41,59,23,18,3,6,2,0,152
501051309,86,98,37,32,15,7,1,1,277
501051310,81,83,48,34,21,11,2,2,282
501051311,37,47,12,13,8,2,0,0,119
501051312,63,57,43,24,12,8,2,2,211
501051401,41,88,69,69,37,7,1,0,312
501051402,26,54,26,11,8,5,1,0,131
501051403,55,69,40,21,11,5,1,0,202
501051404,57,55,51,30,14,1,1,0,209
501051405,71,98,66,42,18,8,3,1,307
501051406,41,49,32,24,15,7,0,0,168
501051407,20,38,36,42,23,5,0,0,164
501051408,30,71,35,29,23,4,2,0,194
501051409,37,55,30,32,25,1,1,1,182
501051410,48,75,36,33,11,7,0,2,212
501051411,61,62,43,43,25,5,3,0,242
501051412,70,62,57,42,22,3,4,2,262
501051413,77,98,63,46,23,11,4,4,326
501051501,66,100,85,53,41,23,5,5,378
501051502,32,38,39,24,22,16,8,5,184
501051503,41,56,36,43,23,16,4,3,222
501051504,38,40,61,31,17,10,3,4,204
501051505,36,60,63,63,48,19,8,3,300
501051506,43,66,44,32,37,22,4,1,249
501051507,26,45,38,51,29,18,1,5,213
501051508,47,77,60,57,29,27,8,8,313
501051509,49,47,45,35,26,10,6,6,224
501051510,40,51,34,62,29,21,3,5,245
501051511,50,71,57,55,36,20,2,7,298
501051512,18,27,46,45,31,12,1,1,181
501051513,49,77,69,65,35,31,11,5,342
501051514,43,52,42,51,26,14,7,10,245
501051515,34,44,31,32,14,9,5,2,171
501051516,21,25,44,34,30,14,4,3,175
501051517,29,67,103,110,45,11,3,1,369
501051518,39,68,86,89,53,30,9,8,382
501051519,27,36,58,62,39,28,14,10,274
501051601,51,83,69,83,56,29,10,7,388
501051602,71,93,91,86,65,25,7,9,447
501051603,33,80,59,92,68,28,22,13,395
501051604,28,56,55,62,35,23,8,9,276
501051605,50,102,101,104,52,32,13,12,466
501051606,8,5,9,6,0,0,1,0,29
501051607,20,36,39,25,29,15,9,12,185
501051608,10,10,16,13,6,7,2,2,66
501051609,20,33,40,48,25,21,10,14,211
501051701,22,38,65,63,52,37,9,17,303
501051702,36,48,52,48,42,14,6,14,260
501051703,43,55,55,44,39,17,4,8,265
501051704,44,67,53,42,35,11,7,4,263
501051705,33,47,56,37,29,15,2,7,226
501051706,16,31,47,49,34,21,7,12,217
501051707,15,32,33,46,16,6,0,0,148
501051708,45,55,52,48,32,11,0,1,244
501051709,31,87,68,44,16,15,0,3,264
501051710,43,70,45,45,18,7,5,4,237
501051711,61,91,64,32,21,11,2,4,286
501051712,74,94,83,59,30,11,2,4,357
501051713,78,64,51,32,19,4,1,1,250
501051714,63,28,40,20,15,5,1,3,175
501051801,30,72,75,96,48,21,6,0,348
501051802,18,30,27,36,11,4,2,1,129
501051803,31,67,43,49,21,14,5,2,232
501051804,58,108,95,82,49,14,4,1,411
501051805,52,107,86,42,29,14,3,0,333
501051806,66,84,67,45,26,6,2,1,297
501051807,31,48,36,24,16,8,1,4,168
501051808,36,46,45,37,19,13,3,1,200
501051809,34,42,53,53,41,9,2,2,236
501051810,56,92,66,54,41,13,2,4,328
501051811,44,68,39,42,33,11,5,1,243
501051812,28,53,52,45,22,7,4,4,215
501051813,40,72,60,21,14,8,2,2,219
501051814,15,34,36,42,24,9,1,7,168
501051815,56,84,71,53,26,7,2,1,300
501051816,39,60,56,56,25,9,1,0,246
501051817,22,40,34,61,18,8,1,0,184
501051818,25,52,64,77,54,25,13,11,321
501051901,32,53,31,31,25,13,4,2,191
501051902,52,79,96,96,61,14,2,5,405
501051903,17,35,38,48,25,10,4,2,179
501051904,27,60,51,42,36,14,8,3,241
501051905,20,44,64,51,50,17,11,14,271
501051906,46,79,72,84,68,38,22,23,432
501051907,39,96,78,92,47,17,3,7,379
501051908,42,76,81,79,47,22,6,11,364
501051909,32,37,57,95,51,16,6,6,300
501051910,36,39,75,67,59,38,12,24,350
501051911,23,35,33,27,14,8,4,1,145
501051912,49,41,57,56,45,22,15,17,302
501051913,38,46,43,63,34,13,8,9,254
501051914,41,48,49,49,43,20,24,32,306
501051915,16,30,28,34,18,14,10,7,157
501120101,21,35,45,40,36,27,8,10,222
501120102,50,108,124,111,79,46,16,20,554
501120103,16,34,42,47,42,14,6,8,209
501120104,39,85,93,100,50,31,16,10,424
501120105,14,32,26,37,18,13,6,12,158
501120201,40,57,65,60,38,28,10,14,312
501120202,24,52,46,53,29,25,13,8,250
501120203,14,14,25,28,14,11,1,7,114
501120204,45,88,78,83,41,31,11,6,383
501120205,41,69,69,52,47,29,15,22,344
501120301,13,21,18,17,10,8,3,4,94
501120302,19,41,58,46,33,16,15,13,241
501120303,15,22,20,31,10,10,4,5,117
501120304,31,67,69,63,30,18,10,18,306
501120305,40,62,50,55,35,23,7,8,280
501120401,34,29,36,36,25,13,7,17,197
501120501,32,15,11,13,7,2,1,5,86
501120601,34,23,19,25,24,9,7,6,147
501190101,0,0,0,1,1,0,0,0,2
501190201,12,16,17,14,15,9,1,2,86
501190202,14,17,28,26,31,11,4,6,137
501190203,6,9,8,6,12,8,1,2,52
501190204,59,74,82,81,54,34,22,18,424
501190205,56,61,64,59,53,37,11,22,363
501190206,40,30,54,49,33,23,15,21,265
501190301,56,84,83,87,65,48,11,16,450
501190302,43,88,63,75,64,27,11,5,376
501190303,73,74,93,89,49,33,9,8,428
501190304,89,95,75,65,57,25,10,14,430
501190305,78,90,84,77,47,18,13,13,420
501190306,43,91,107,93,50,27,18,13,442
501190307,41,78,82,67,42,14,15,14,353
501190308,57,89,108,142,81,52,22,23,574
501190309,41,68,125,102,80,48,22,23,509
501190310,20,58,74,76,50,21,16,19,334
501190311,20,39,55,70,45,26,6,8,269
501190312,39,37,43,37,23,9,3,7,198
501190401,48,68,74,87,69,33,17,22,418
501190402,29,24,28,30,26,11,7,10,165
501190403,53,75,92,85,51,41,19,26,442
501190404,17,16,30,24,13,12,2,9,123
501190405,6,15,27,39,32,11,8,8,146
501190406,27,54,47,65,47,12,14,12,278
501190407,61,80,109,106,73,42,17,20,508
501190408,64,80,91,98,58,34,11,22,458
501190409,59,86,92,75,63,48,19,11,453
501190501,13,10,19,13,9,8,4,4,80
501190601,34,40,51,56,42,18,7,12,260
501190602,8,19,19,20,23,5,5,3,102
501190603,51,77,88,70,43,24,19,13,385
501190604,63,87,76,66,37,25,7,6,367
501190605,50,60,63,39,28,8,4,5,257
501190606,15,40,52,50,38,25,8,10,238
501190607,46,97,79,127,58,26,1,2,436
501190608,53,94,47,47,35,12,1,1,290
501190609,34,67,36,28,19,11,1,1,197
501190610,38,80,62,38,29,8,7,2,264
501190611,19,37,50,63,31,9,3,0,212
501190612,33,70,67,103,56,22,13,11,375
501190613,52,99,113,129,111,46,13,16,579
501190614,48,57,59,67,60,48,20,34,393
501260101,19,20,12,19,17,9,4,7,107
501260102,4,0,1,1,1,1,0,0,8
501260201,3,1,2,1,1,3,0,0,11
501260202,13,14,15,18,11,8,11,10,100
501260203,11,11,9,20,13,6,5,9,84
501260204,14,24,17,18,14,5,6,7,105
501260205,2,2,0,0,0,0,0,0,4
501260301,74,114,142,182,131,71,48,38,800
501260302,14,35,27,41,23,18,8,16,182
501260303,58,77,128,133,77,42,17,19,551
501260304,72,78,75,73,48,31,10,13,400
501260305,67,91,80,63,43,19,5,6,374
501260306,64,74,80,72,45,26,6,8,375
501260307,39,56,69,68,32,10,7,4,285
501260308,19,34,33,35,18,13,5,4,161
501260309,40,45,72,76,45,46,14,18,356
501260310,30,36,47,54,41,21,7,13,249
501260311,30,67,80,82,49,23,11,7,349
501260312,35,67,72,93,63,24,11,17,382
501260313,27,29,59,52,33,21,9,4,234
501260314,41,51,56,98,67,28,10,18,369
501260315,21,18,33,39,31,24,10,11,187
501260316,24,36,44,57,38,14,7,5,225
501260317,20,37,51,70,45,27,11,17,278
501260318,13,13,13,10,11,6,8,3,77
501260319,34,59,64,58,51,23,5,12,306
501260401,38,39,47,56,35,25,19,17,276
501260402,2,1,3,2,2,1,0,1,12
501260501,93,108,155,128,105,91,40,38,758
501260502,37,36,59,53,45,46,12,18,306
501260503,34,31,45,59,47,35,11,19,281
501260504,48,45,41,63,42,45,22,32,338
540070101,7,12,3,9,3,3,0,2,39
540070102,38,48,45,33,32,20,18,11,245
540070103,50,58,63,44,46,37,16,26,340
540070104,19,14,21,15,10,8,2,6,95
540070105,26,38,14,22,13,10,7,10,140
540070106,2,0,0,2,1,1,0,0,6
540070107,40,43,33,35,17,15,8,15,206
540070108,42,71,78,59,34,28,10,8,330
540070109,37,36,34,43,39,39,12,22,262
540070110,16,22,18,23,20,17,12,17,145
540070201,8,8,6,4,4,7,0,3,40
540070202,10,4,5,2,1,1,0,2,25
540070301,8,7,5,4,4,3,2,1,34
540070302,25,14,25,16,17,10,3,5,115
540070303,49,53,49,53,37,32,17,28,318
540070304,16,28,13,21,14,7,1,4,104
540070305,13,9,7,11,6,6,2,5,59
540070306,10,13,6,7,4,2,2,2,46
540070307,7,11,8,6,5,2,4,3,46
540070308,5,7,6,3,2,3,1,2,29
540070309,4,2,3,6,4,1,2,3,25
540070310,30,28,26,29,32,21,7,19,192
540070311,25,47,74,50,28,21,10,5,260
540070312,43,52,86,85,49,42,20,56,433
540070313,24,49,74,75,34,27,10,8,301
540070314,21,22,22,21,26,8,6,9,135
540070315,14,44,59,65,48,27,10,3,270
540070316,21,54,71,96,36,21,5,4,308
540070317,16,22,17,33,24,23,11,15,161
540070318,24,48,55,76,39,35,10,13,300
540070319,27,33,43,35,31,33,11,32,245
540070401,9,9,7,14,6,3,4,3,55
540070402,13,17,13,8,10,8,7,11,87
540070403,24,32,22,25,17,16,9,18,163
540070404,2,1,6,8,4,6,0,1,28
540070405,1,2,2,3,0,1,0,1,10
540070406,6,2,5,1,2,1,0,1,18
540070501,7,5,4,3,5,1,0,0,25
540070502,15,13,9,7,9,8,3,6,70
540070503,12,20,17,5,11,9,8,9,91
540070504,47,54,45,40,32,14,5,9,246
540070505,2,0,2,0,0,1,0,1,6
540070506,11,18,15,17,9,20,7,3,100
540070507,17,14,7,6,3,5,0,1,53
540070508,46,49,63,68,42,39,6,22,335
540070509,30,26,35,35,24,19,10,13,192
540070601,1,8,4,6,4,5,0,0,28
540070602,40,64,54,67,34,26,5,6,296
540070603,39,56,56,45,40,22,8,12,278
540070604,38,48,51,30,26,19,13,6,231
540070605,44,57,53,44,24,10,2,4,238
540070606,47,39,67,65,23,23,7,11,282
540070607,47,54,63,69,45,36,17,23,354
540070608,45,56,22,29,14,7,0,0,173
540070609,42,43,32,21,11,6,1,0,156
540070610,57,65,41,36,11,6,4,6,226
540070611,45,69,48,49,31,14,0,4,260
540070612,44,42,53,24,27,13,5,15,223
540070613,57,85,62,54,38,16,7,12,331
540070614,48,54,39,31,18,6,3,1,200
540070615,41,55,54,60,48,29,18,32,337
540070616,58,64,57,62,31,36,17,34,359
540070617,45,50,44,33,16,12,5,4,209
540070618,61,75,51,37,21,10,4,3,262
540070619,45,58,48,47,33,23,13,10,277
540070620,16,15,13,13,18,14,3,11,103
540140101,12,13,2,5,2,7,2,3,46
540140102,29,20,19,12,21,17,4,6,128
540140103,59,83,59,43,23,17,6,9,299
540140104,46,66,52,51,35,10,7,8,275
540140105,5,11,7,6,4,1,3,2,39
540140106,15,12,20,10,8,5,2,1,73
540140107,17,19,26,21,14,15,7,16,135
540140108,32,43,48,45,29,12,6,7,222
540140109,58,59,62,51,31,15,7,16,299
540140110,49,58,49,44,39,15,3,4,261
540140111,48,55,55,46,40,37,19,35,335
540140112,13,19,22,15,3,9,1,5,87
540140201,14,19,21,18,19,8,6,14,119
540140202,56,54,45,28,23,14,3,7,230
540140203,43,37,42,35,25,6,5,7,200
540140204,31,34,37,34,28,18,5,12,199
540140205,42,49,49,58,22,10,2,3,235
540140206,18,32,37,34,21,10,5,1,158
540140207,11,21,29,27,18,15,8,5,134
540140208,57,78,74,53,27,13,5,4,311
540140209,47,55,70,52,34,25,11,12,306
540140210,47,77,65,55,40,17,6,5,312
540140211,36,44,61,69,32,32,23,24,321
540140212,27,33,56,47,38,19,8,17,245
540140301,17,23,22,17,11,2,2,2,96
540140302,12,26,21,15,7,4,2,4,91
540140303,49,66,85,53,27,30,9,5,324
540140304,23,34,31,31,28,10,6,5,168
540140305,9,16,15,19,10,2,2,4,77
540140306,2,8,7,4,3,3,1,4,32
540140307,22,42,65,55,47,30,13,29,303
540140308,18,22,19,28,21,7,4,5,124
540140309,15,28,28,32,19,20,7,20,169
540140401,21,35,21,16,17,11,7,8,136
540140402,11,10,14,13,10,4,4,5,71
540140403,10,24,15,24,13,8,2,1,97
540140404,32,42,62,49,20,23,15,16,259
540140501,20,26,33,38,18,10,2,5,152
540140502,30,47,34,39,19,16,5,14,204
540140503,19,28,29,28,19,13,8,17,161
540140504,20,41,42,38,18,24,6,9,198
540140505,39,53,53,50,30,20,3,2,250
540140506,40,37,46,43,24,15,4,18,227
540140507,18,25,33,25,16,8,7,8,140
540140508,54,62,64,60,30,17,4,3,294
540140509,16,35,38,46,29,12,5,8,189
540140510,9,24,37,27,12,8,2,2,121
540140511,46,52,81,67,41,27,25,30,369
540140512,22,41,44,41,26,12,4,0,190
540140601,10,17,15,21,12,14,5,5,99
540140602,54,48,46,32,33,27,9,18,267
540140603,11,19,14,22,8,2,4,4,84
540140604,24,38,36,29,31,28,8,15,209
540140605,10,18,17,24,19,5,7,12,112
540140606,15,23,25,42,25,21,6,15,172
540140607,47,71,73,70,50,48,21,34,414
540140608,40,30,45,43,35,50,24,41,308
540140609,19,24,30,28,15,12,13,16,157
540140701,12,34,23,20,17,14,13,5,138
540140702,18,12,17,13,13,5,4,4,86
540140703,21,28,33,32,18,30,6,9,177
540140704,22,26,42,27,28,18,8,12,183
540140705,18,23,20,24,19,13,11,14,142
540140801,14,36,28,39,19,10,4,1,151
540140802,20,28,20,20,9,8,1,4,110
540140803,7,14,6,10,5,7,0,3,52
540140804,7,17,4,10,8,9,3,5,63
540140805,11,13,12,12,5,5,1,8,67
540140806,26,35,49,55,45,30,22,22,284
540140807,19,28,48,46,23,9,2,6,181
540140808,24,44,65,42,36,28,6,16,261
540140901,18,14,14,11,9,7,6,6,85
540140902,21,11,13,16,18,9,2,14,104
540140903,13,11,12,14,8,7,7,15,87
540140904,4,10,2,7,5,3,3,2,36
540140905,12,13,13,17,9,11,3,5,83
540140906,32,22,31,26,26,25,5,16,183
540141001,13,14,20,18,16,12,11,14,118
540141002,13,24,38,26,18,13,4,13,149
540141003,11,14,11,13,6,3,6,4,68
540141004,14,18,16,17,12,11,9,14,111
540141005,13,20,25,16,9,8,6,2,99
540141006,26,24,22,33,16,11,1,3,136
540210101,13,10,13,3,8,9,4,3,63
540210102,16,16,24,20,19,11,5,13,124
540210103,9,5,9,5,3,2,0,3,36
540210201,14,8,5,2,1,5,0,4,39
540210202,47,31,31,27,32,38,17,27,250
540210203,4,5,4,6,3,5,3,7,37
540210301,12,7,6,6,3,3,3,1,41
540210302,6,13,8,5,4,2,5,4,47
540210303,9,2,4,3,5,0,0,1,24
540210304,7,6,10,3,4,3,3,1,37
540210305,11,12,9,5,1,8,1,0,47
540210306,55,32,20,27,19,14,13,13,193
540210401,16,20,18,16,16,6,5,9,106
540210402,7,6,11,7,5,1,2,2,41
540210403,6,2,3,2,2,2,0,1,18
540210404,1,2,0,0,0,1,0,0,4
540210501,35,23,16,20,10,5,1,1,111
540210502,7,7,8,7,12,8,2,6,57
540210503,16,6,8,5,3,0,0,1,39
540210504,52,50,53,67,33,19,23,25,322
540210505,51,46,35,55,24,15,12,11,249
540210506,36,33,43,35,36,11,6,10,210
540210507,38,50,59,43,32,14,18,10,264
540210508,27,62,61,47,33,23,7,6,266
540210509,55,49,48,41,43,26,11,11,284
540210510,45,39,48,47,29,17,10,12,247
540210511,29,55,45,46,37,10,8,7,237
540210512,24,48,70,61,46,27,9,22,307
540210513,30,53,37,36,23,11,6,4,200
540210514,27,37,47,52,40,37,8,15,263
540210515,33,52,47,55,37,20,6,7,257
540210516,29,48,67,58,33,17,6,11,269
540210517,27,37,32,23,12,19,4,8,162
540210518,24,15,24,26,10,10,9,6,124
540210601,48,77,47,44,25,20,10,16,287
540210602,30,33,31,38,27,17,10,18,204
540210603,23,20,25,21,15,14,7,6,131
540210604,5,7,3,5,4,6,2,5,37
540210605,8,10,3,3,2,1,1,2,30
540210606,7,4,1,1,3,1,2,4,23
540210607,49,75,52,55,31,30,10,12,314
540210608,52,43,46,20,30,24,8,7,230
540210609,32,47,46,43,35,27,3,14,247
540210610,29,19,7,8,11,15,7,13,109
540210611,11,9,15,11,3,2,4,6,61
540210701,16,13,9,3,9,7,3,3,63
540210702,11,7,5,3,3,6,1,1,37
540210703,4,9,5,5,4,4,0,7,38
540210704,47,43,47,45,37,17,6,19,261
540210705,55,45,37,40,27,23,15,10,252
540280101,24,35,34,47,21,14,4,2,181
540280102,37,27,52,41,25,27,6,19,234
540280103,44,46,76,71,41,41,21,32,372
540280104,27,45,43,44,21,9,4,9,202
540280105,8,19,11,13,9,5,1,1,67
540280106,20,27,28,15,7,2,3,3,105
540280107,68,71,55,43,29,13,12,4,295
540280108,38,57,46,29,27,11,2,2,212
540280109,36,62,28,26,17,6,3,2,180
540280110,25,48,42,32,23,7,1,1,179
540280111,59,89,50,33,22,16,0,1,270
540280112,94,117,78,38,29,7,1,2,366
540280113,40,51,44,25,12,4,1,2,179
540280114,44,42,40,30,11,6,1,0,174
540280116,2,0,1,2,0,0,0,0,5
540280117,52,74,40,23,11,5,1,0,206
540280118,41,43,30,20,8,5,0,0,147
540280119,45,63,36,38,12,3,1,0,198
540280201,62,73,38,16,12,3,2,0,206
540280202,106,66,34,15,6,3,0,0,230
540280203,119,85,55,29,12,3,1,0,304
540280204,64,57,48,30,11,2,3,0,215
540280205,60,50,34,20,12,3,2,0,181
540280206,81,90,34,31,4,5,0,1,246
540280207,72,77,54,32,11,9,1,0,256
540280208,117,55,27,17,12,2,1,1,232
540280209,45,52,23,23,6,5,0,0,154
540280210,97,80,38,41,9,2,0,0,267
540280211,66,61,31,26,9,0,2,0,195
540280212,34,39,18,15,11,1,1,1,120
540280213,79,73,32,19,8,2,1,0,214
540280214,41,45,20,14,4,2,0,0,126
540280215,61,64,37,17,12,4,1,0,196
540280216,59,33,22,10,3,0,0,1,128
540280217,83,75,34,15,7,1,1,0,216
540280218,59,34,24,11,3,4,0,0,135
540280301,54,75,91,86,58,38,21,13,436
540280302,39,57,70,64,41,16,5,6,298
540280303,32,42,60,49,41,29,15,12,280
540280304,45,59,42,38,26,8,5,3,226
540280305,48,48,55,63,52,20,11,14,311
540280306,25,41,55,63,27,19,6,5,241
540280307,40,78,98,85,74,35,6,20,436
540280308,59,88,81,92,77,18,16,10,441
540280309,56,50,53,51,22,9,3,1,245
540280310,51,82,60,57,22,10,3,3,288
540280311,73,105,98,69,43,23,6,8,425
540280312,42,44,65,51,65,25,6,1,299
540280313,41,75,49,53,24,20,5,2,269
540280314,41,82,49,51,25,6,3,3,260
540280401,46,77,77,67,41,36,3,7,354
540280402,50,49,54,66,60,44,21,28,372
540280403,23,57,48,43,19,16,1,4,211
540280404,58,56,31,34,12,4,1,3,199
540280405,60,90,73,45,21,18,2,0,309
540280406,71,93,60,40,23,9,4,3,303
540280407,68,82,58,39,24,8,4,7,290
540280408,72,105,87,85,42,29,4,6,430
540280409,38,63,64,53,33,14,7,5,277
540280410,41,72,78,56,45,41,15,25,373
540280411,36,32,50,49,37,25,9,17,255
540280412,31,50,55,58,53,51,22,33,353
540280413,25,40,63,56,34,25,25,27,295
540280414,38,68,53,44,24,15,3,4,249
540280415,46,53,60,43,26,14,4,6,252
540280416,59,71,41,42,27,10,2,2,254
540280417,48,43,60,62,39,29,17,29,327
540280418,24,39,44,64,33,28,9,9,250
540280419,31,73,61,59,52,44,19,34,373
540280501,96,81,57,46,15,5,2,2,304
540280502,60,79,33,43,35,10,7,2,269
540280504,25,35,34,29,22,9,7,8,169
540280505,55,54,45,43,31,17,3,7,255
540280506,146,109,59,54,32,7,6,4,417
540280507,53,66,62,36,28,15,2,0,262
540280508,65,60,27,32,33,11,2,1,231
540280509,28,64,50,47,30,19,3,1,242
540280510,18,26,24,21,11,6,3,0,109
540280511,53,60,59,43,34,18,5,15,287
540280601,71,95,87,72,30,14,3,5,377
540280602,65,89,65,58,18,12,7,7,321
540280603,81,112,81,94,45,11,5,5,434
540280604,32,21,33,26,24,16,6,7,165
540280605,29,32,37,39,22,29,12,17,217
540280606,28,62,54,33,16,11,3,3,210
540280607,54,76,59,56,38,13,4,10,310
540280608,24,53,45,49,26,23,7,8,235
540280609,64,72,59,55,28,15,4,2,299
540280610,32,35,43,28,19,9,3,3,172
540280611,32,80,65,54,31,18,9,11,300
540280612,56,87,83,59,64,22,10,8,389
540280613,53,67,60,63,39,21,20,12,335
540280614,39,42,57,37,28,37,2,2,244
540280615,6,20,11,14,3,2,1,3,60
540280616,20,28,43,37,29,29,12,17,215
540280617,39,55,48,42,23,20,7,12,246
540280618,67,82,94,80,56,91,8,19,497
540280701,30,59,56,49,41,15,11,10,271
540280702,34,56,73,48,43,15,10,14,293
540280703,33,70,85,59,49,27,3,3,329
540280704,43,74,51,61,21,8,5,6,269
540280705,54,73,56,52,30,15,5,1,286
540280706,38,52,34,29,20,6,4,3,186
540280707,31,49,34,33,19,6,1,2,175
540280708,37,73,58,49,17,14,4,3,255
540280709,34,57,39,51,20,11,4,0,216
540280710,52,92,63,64,25,23,0,3,322
540280711,33,52,45,48,19,14,1,1,213
540280712,44,55,55,57,33,32,7,10,293
540280713,73,78,99,65,51,35,13,14,428
540280714,45,69,65,71,54,33,6,10,353
540280715,44,47,52,54,27,20,8,9,261
540280716,55,78,67,56,40,20,10,14,340
540280717,30,61,53,44,34,8,5,8,243
540280718,61,51,50,27,17,16,1,4,227
540280719,42,53,37,53,26,25,3,7,246
540280720,33,43,63,59,30,29,8,10,275
540280721,34,69,74,47,24,10,1,3,262
540280803,36,56,66,61,46,28,14,18,325
540280804,51,53,59,46,31,16,6,6,268
540280805,27,53,58,38,25,13,4,10,228
540280806,32,42,49,41,37,29,15,29,274
540280807,53,67,88,89,60,58,22,44,481
540280808,36,56,65,73,59,47,18,31,385
540280809,37,60,75,69,58,39,21,22,381
540280810,44,71,67,68,36,42,17,19,364
540280811,55,56,54,43,34,16,9,2,269
540280812,134,100,85,54,38,21,6,10,448
540280813,37,41,56,43,28,15,7,4,231
540280814,30,38,60,43,36,25,7,7,246
540280815,30,27,47,32,25,27,16,22,226
540280816,49,46,64,62,32,20,10,6,289
540280817,24,29,23,28,14,25,9,11,163
540280818,41,57,80,89,45,24,14,12,362
540280819,136,80,46,23,16,13,6,6,326
540280820,55,72,68,74,65,28,23,36,421
540280821,36,50,45,52,29,20,10,24,266
540280822,50,45,27,18,17,4,1,5,167
540280901,83,56,51,30,13,6,3,2,244
540280902,65,71,39,24,17,7,1,3,227
540280903,25,28,27,19,19,7,3,2,130
540280906,51,47,42,32,21,4,2,4,203
540280907,87,110,68,54,20,10,1,1,351
540280908,89,86,44,34,16,6,3,1,279
540280909,52,59,31,18,6,1,2,1,170
540280910,79,76,25,13,8,1,0,0,202
540280911,63,48,22,17,12,9,3,3,177
540281001,75,65,38,30,10,5,0,0,223
540281002,103,52,23,15,5,3,1,0,202
540281003,69,92,55,54,14,11,3,0,298
540281004,97,108,76,63,22,18,5,7,396
540281005,84,73,47,33,28,5,1,0,271
540281006,79,66,39,24,18,8,4,0,238
540281007,51,56,43,15,17,8,3,2,195
540281008,90,129,89,70,32,25,3,5,443
540281009,76,118,99,69,35,18,4,3,422
540281010,51,87,60,62,36,16,5,10,327
540281011,45,85,72,52,26,13,3,3,299
540281012,45,69,69,47,27,8,4,4,273
540281013,89,68,35,17,7,8,0,1,225
540281014,65,49,45,32,21,7,2,2,223
540281015,29,51,41,28,20,12,3,7,191
540281101,18,13,21,22,16,15,7,8,120
540281102,25,26,21,18,13,2,3,2,110
540281103,23,28,20,14,13,14,7,15,134
540281201,54,78,83,86,67,40,9,23,440
540281202,15,20,26,48,31,14,8,4,166
540281203,7,5,10,8,4,4,2,4,44
540281204,16,7,11,14,7,11,4,3,73
540281205,17,38,52,61,47,28,6,15,264
540281206,34,54,72,80,39,18,12,8,317
540281207,25,49,58,58,36,21,13,9,269
540281208,34,60,79,52,47,22,12,13,319
540281209,52,52,76,73,33,47,24,19,376
540281210,22,74,98,123,66,32,11,18,444
540281211,26,72,83,76,56,44,22,45,424
540281212,33,42,58,83,66,41,27,28,378
540281213,36,55,77,63,65,78,35,49,458
540281214,39,81,112,135,73,17,6,4,467
540281215,25,65,74,48,31,19,6,6,274
540281216,39,44,74,87,68,37,16,16,381
540281217,31,62,92,93,37,17,2,0,334
540281218,62,66,91,82,61,50,22,40,474
540281219,26,51,102,112,58,30,14,9,402
540281220,11,47,84,75,35,11,6,4,273
540281301,21,17,19,13,14,14,5,7,110
540281302,7,5,22,8,16,6,3,3,70
540281303,12,17,14,12,6,3,2,2,68
540281304,1,2,2,1,0,1,0,0,7
540281305,19,14,10,12,14,11,7,8,95
540281306,58,54,57,73,39,23,6,22,332
540281307,22,16,20,24,25,27,8,4,146
540281308,27,38,52,59,30,32,13,18,269
540281309,30,22,25,27,18,18,8,7,155
540281310,34,37,54,36,41,9,14,14,239
540281311,19,35,56,54,50,31,5,8,258
540281312,55,66,70,50,48,26,18,9,342
540281313,37,73,51,45,48,41,11,27,333
540281314,54,61,92,89,46,43,27,32,444
540281315,55,63,91,71,61,41,20,30,432
540281316,27,39,59,70,45,22,9,16,287
540281317,11,23,30,35,31,14,8,15,167
540281318,7,36,29,33,18,7,1,2,133
540281319,44,73,103,127,77,42,6,7,479
540281320,14,34,40,47,20,17,6,3,181
540281321,7,33,51,39,32,6,5,3,176
540281322,23,40,60,71,59,35,16,23,327
540281323,22,27,37,43,23,14,6,3,175
540281401,45,71,55,49,38,25,15,14,312
540281402,0,0,0,0,0,0,0,0,0
540281403,0,0,0,0,0,1,0,0,1
540281501,13,28,15,9,7,5,0,1,78
540281502,16,12,12,6,5,2,1,1,55
540281503,6,14,12,11,6,4,3,3,59
540281504,32,82,119,106,49,29,4,3,424
540281505,56,72,103,99,53,17,5,4,409
540281601,104,81,85,65,43,43,26,28,475
540281602,3,1,0,1,0,0,1,1,7
540281701,10,9,9,6,3,7,2,4,50
540281702,4,3,5,3,3,0,1,1,20
540281703,2,1,3,4,2,0,1,2,15
540281704,1,2,4,2,0,2,0,0,11
540281801,29,49,56,48,52,49,22,46,351
540281802,25,42,55,45,30,14,12,19,242
540281803,24,28,33,39,36,26,16,26,228
540281804,42,76,83,57,45,21,10,11,345
540281805,19,31,45,44,37,22,3,8,209
540281806,30,21,28,31,27,22,3,7,169
540281807,36,70,69,73,45,36,13,18,360
540281808,14,31,38,49,25,16,7,7,187
540281809,19,43,42,46,40,23,9,9,231
540281810,49,66,80,59,34,21,7,6,322
540281811,28,72,72,63,38,26,7,6,312
540281812,26,34,38,48,46,21,13,7,233
540281813,41,52,60,63,49,48,29,32,374
540281814,44,57,51,52,47,40,17,33,341
540281815,28,64,44,62,43,27,18,28,314
540281816,20,26,52,44,24,22,13,14,215
540281817,30,38,39,35,43,20,8,8,221
540281818,56,59,66,32,22,10,3,3,251
540281819,18,26,28,41,23,21,13,19,189
540281820,28,40,38,45,25,14,2,6,198
540281821,28,33,60,41,34,14,11,11,232
540281822,40,35,45,37,25,8,10,3,203
540281901,38,67,67,83,63,45,23,31,417
540281902,24,27,35,39,23,16,4,5,173
540281903,68,90,93,66,50,29,6,5,407
540281904,33,33,66,62,48,60,1,11,314
540281905,39,81,91,93,57,32,9,12,414
540281906,49,98,78,68,37,20,3,5,358
540281907,44,111,95,66,30,15,7,7,375
540281908,35,58,79,75,66,32,14,22,381
540281909,22,70,70,72,54,39,10,12,349
540281910,46,62,66,39,26,12,6,5,262
540281911,55,83,102,51,37,16,5,5,354
540281912,48,89,84,105,41,30,8,7,412
540281913,30,57,76,59,70,55,20,35,402
540281914,50,66,64,58,39,35,12,21,345
540281915,24,60,61,60,46,22,1,10,284
540281916,52,67,89,93,39,28,10,5,383
540281917,36,61,67,80,52,38,24,38,396
540281918,31,70,74,88,39,25,8,5,340
540281919,44,68,77,79,59,36,26,18,407
540281920,27,58,81,95,48,30,14,12,365
540281921,46,73,79,65,68,26,19,18,394
540281922,47,71,83,92,32,27,7,7,366
540281923,76,101,115,99,69,31,15,19,525
540281924,64,73,96,107,77,49,22,24,512
540281925,27,53,82,82,59,36,20,23,382
540281926,32,60,55,82,68,21,12,18,348
540281927,23,33,41,52,40,24,12,17,242
540281928,21,48,57,67,44,29,11,11,288
540282001,28,63,84,113,57,45,13,15,418
540282002,37,68,104,93,69,43,14,24,452
540282003,52,111,93,75,60,29,15,10,445
540282004,60,88,119,103,67,42,7,13,499
540282005,58,84,74,66,44,15,9,8,358
540282006,36,62,64,59,53,18,5,15,312
540282007,44,53,67,48,48,32,9,12,313
540282008,24,32,43,20,12,6,1,6,144
540282009,44,46,48,65,41,25,13,8,290
540282010,33,45,52,40,25,18,6,6,225
540282011,39,77,103,115,61,41,18,18,472
540282012,31,40,38,35,26,6,6,8,190
540282013,24,27,42,44,43,37,10,10,237
540282014,21,43,41,48,30,17,8,5,213
540282015,29,34,56,59,38,36,15,15,282
540282016,48,50,73,71,58,16,13,11,340
540282017,21,25,37,38,35,29,19,25,229
540282018,18,43,53,52,35,18,7,5,231
540282019,38,91,71,81,43,34,4,19,381
540282020,28,38,26,40,31,16,10,11,200
540282021,26,40,59,44,47,26,18,30,290
540282101,3,0,1,1,1,0,0,0,6
540282102,32,18,17,18,14,6,4,3,112
540282103,9,4,2,7,0,1,0,1,24
540282201,26,41,40,47,27,15,3,6,205
540282202,95,104,107,81,38,19,6,9,459
540282203,52,78,34,34,12,10,0,0,220
540282204,44,65,54,58,39,25,1,6,292
540282205,83,71,40,21,12,9,1,1,238
540282206,97,106,70,54,29,24,1,2,383
540282207,125,97,57,45,20,6,1,1,352
540282208,62,77,48,39,17,3,0,1,247
540282209,77,119,85,74,36,13,3,3,410
540282210,69,83,70,56,24,12,5,2,321
540282211,74,65,36,32,19,6,1,1,234
540282212,42,60,49,39,22,10,1,6,229
540282213,50,64,40,34,9,11,2,0,210
540282301,66,99,73,78,62,30,16,12,436
540282302,51,56,46,38,31,24,2,6,254
540282303,50,97,62,69,32,21,10,2,343
540282304,33,84,67,83,43,26,7,9,352
540282305,79,57,72,67,71,36,28,20,430
540282306,46,49,60,56,51,32,12,16,322
540282307,39,74,66,41,25,7,14,7,273
540282308,45,37,47,47,27,14,5,8,230
540282309,31,56,73,51,36,20,4,10,281
540282310,50,59,56,42,25,10,4,2,248
540282311,45,59,88,98,76,37,16,22,441
540282312,29,42,64,61,53,37,23,33,342
540282313,26,39,56,56,36,29,9,24,275
540282314,33,50,48,36,18,7,2,1,195
540282401,36,55,79,58,38,26,12,11,315
540282402,24,55,116,69,30,13,5,3,315
540282403,21,68,96,88,54,18,2,6,353
540282404,28,43,51,75,66,50,37,55,405
540282405,23,38,37,44,38,28,16,43,267
540282406,18,19,28,36,22,26,17,36,202
540282407,19,45,64,46,71,77,26,32,380
540282408,28,32,66,61,67,38,23,51,366
540282409,11,29,55,72,41,36,10,15,269
540282410,19,43,50,64,57,30,10,14,287
540282411,20,70,89,80,30,15,7,3,314
540282412,38,55,67,63,56,48,28,36,391
540282413,8,40,68,57,33,6,0,3,215
540282414,15,64,92,82,34,15,1,5,308
540282415,45,59,62,71,71,52,21,35,416
540282416,26,34,63,80,67,34,21,31,356
540282417,11,9,13,4,9,3,4,2,55
540350101,13,10,9,9,7,7,5,7,67
540350102,3,5,4,5,3,0,0,3,23
540350103,24,23,27,25,15,12,5,9,140
540350104,1,3,4,3,6,1,2,1,21
540350105,0,0,0,0,0,1,0,0,1
540350106,7,1,1,1,0,1,0,1,12
540350201,15,7,8,11,8,7,4,6,66
540350202,1,5,3,1,2,0,0,1,13
540350203,3,1,0,2,4,0,1,0,11
540350204,8,0,7,5,3,0,2,1,26
540350205,0,0,1,1,1,0,0,0,3
540350206,3,1,4,1,1,0,0,1,11
540350207,1,7,7,3,4,0,4,1,27
540350301,23,19,27,10,10,4,3,2,98
540350302,4,0,1,1,0,0,0,0,6
540350303,0,5,6,3,0,1,2,0,17
540350304,6,12,7,10,10,2,0,2,49
540350305,1,1,0,0,0,0,1,0,3
540350306,2,2,0,1,2,0,0,0,7
540350307,2,3,3,4,1,1,2,0,16
540350308,4,4,4,4,5,2,1,2,26
540350401,42,22,14,21,15,13,8,19,154
540350402,6,4,8,6,6,3,6,4,43
540350403,51,51,47,39,32,17,8,16,261
540350404,56,52,42,42,31,15,3,9,250
540350405,10,10,5,5,5,8,1,3,47
540350406,2,2,8,3,6,1,0,0,22
540350407,5,1,2,2,1,0,0,0,11
540350408,0,0,0,0,0,0,0,0,0
540350409,14,2,3,1,2,2,1,1,26
540350410,54,45,44,42,34,14,7,8,248
540350411,26,29,39,33,27,19,3,10,186
540350412,47,56,49,72,41,30,27,24,346
540350413,8,16,18,13,17,11,7,14,104
540350414,20,40,48,41,33,27,16,18,243
540420101,18,15,23,11,14,12,8,13,114
540420102,14,20,18,16,13,9,4,11,105
540420103,12,6,10,13,0,9,3,8,61
540420104,2,2,0,2,1,0,1,1,9
540420105,2,7,2,6,2,0,2,1,22
540420106,3,2,4,2,2,2,2,0,17
540420107,34,45,53,52,45,35,13,21,298
540420201,1,0,0,0,0,0,0,0,1
540420202,0,0,0,0,0,0,0,0,0
540420203,6,6,5,8,9,1,0,0,35
540420301,36,33,41,26,22,10,7,17,192
540420302,31,23,33,17,14,12,6,5,141
540420303,29,33,46,54,29,16,12,20,239
540420304,13,19,14,11,12,4,2,1,76
540420305,59,76,109,86,66,37,26,15,474
540420306,32,69,66,53,39,20,3,5,287
540420307,57,79,84,55,37,16,9,4,341
540420308,24,18,26,25,17,14,6,11,141
540420309,54,46,77,110,65,36,11,5,404
540420310,9,31,35,42,25,11,4,2,159
540420311,13,25,25,21,16,6,5,1,112
540420312,14,35,34,50,17,6,4,2,162
540420313,23,38,37,37,24,7,8,8,182
540420314,22,39,68,77,35,16,3,4,264
540420315,23,20,44,54,31,15,10,11,208
540420316,17,37,68,52,25,16,5,8,228
540420317,25,47,83,49,38,20,9,14,285
540420318,16,26,16,23,21,13,14,9,138
540420401,32,34,51,45,26,15,4,15,222
540420402,62,53,60,51,40,36,10,21,333
540420403,28,58,65,57,59,24,7,18,316
540420404,59,68,59,59,18,7,3,3,276
540420405,69,78,90,67,42,29,19,22,416
540420406,63,83,93,80,51,28,6,10,414
540420407,41,55,47,73,50,43,21,23,353
540420408,27,46,32,29,15,8,10,11,178
540420409,30,62,50,55,25,30,15,23,290
540420410,40,56,43,61,38,28,22,31,319
540420411,56,72,77,64,57,32,21,26,405
540420412,39,38,48,45,29,17,8,6,230
540420413,53,51,58,53,24,14,2,1,256
540420414,83,61,68,53,39,23,9,5,341
540420415,46,45,54,48,34,26,14,17,284
540420416,40,51,71,61,24,13,3,4,267
540420417,27,56,58,46,24,19,4,4,238
540420418,39,55,68,56,39,21,10,10,298
540420419,30,44,48,49,27,17,7,9,231
540420420,48,55,50,55,38,18,7,13,284
540420501,28,38,44,34,32,21,10,13,220
540420502,56,80,76,69,44,23,6,15,369
540420503,54,63,50,57,11,11,2,0,248
540420504,62,103,53,45,18,15,2,4,302
540420505,64,83,80,66,29,10,0,3,335
540420506,48,69,75,38,25,6,4,6,271
540420507,33,55,71,45,30,7,0,4,245
540420508,64,87,61,50,13,4,0,0,279
540420509,55,59,51,38,24,4,0,0,231
540420510,52,51,46,26,3,2,1,0,181
540420511,93,98,55,32,13,0,2,0,293
540420512,45,48,64,47,37,13,8,6,268
540420513,69,73,70,62,20,9,2,4,309
540420514,72,79,54,45,20,8,2,1,281
540420515,54,63,69,53,16,12,4,3,274
540420516,49,62,79,41,27,7,4,2,271
540420517,30,45,44,51,21,12,10,12,225
540420518,48,63,59,39,29,17,11,8,274
540420519,31,41,39,43,28,11,10,8,211
540420520,48,67,66,32,9,5,2,1,230
540420601,47,40,36,41,36,35,13,37,285
540420602,21,48,56,59,38,15,9,16,262
540420603,33,24,29,30,26,13,12,26,193
540420604,5,8,7,6,4,4,0,6,40
540420605,19,14,15,19,13,15,3,11,109
540420606,15,11,24,8,5,9,1,8,81
540420607,38,36,41,44,25,17,8,11,220
540420608,8,10,7,5,4,0,2,3,39
540420609,7,2,2,1,1,0,3,1,17
540420610,33,37,38,45,30,30,13,29,255
540420611,24,14,33,20,20,12,8,11,142
540420612,22,37,59,63,50,32,23,42,328
540420613,57,69,84,104,75,72,15,31,507
540420614,36,56,59,59,42,53,5,7,317
540420701,37,41,41,41,37,28,14,26,265
540420702,13,15,22,25,27,14,5,9,130
540420703,9,10,15,25,14,5,3,11,92
540420704,17,18,23,25,14,13,5,14,129
540420705,6,7,2,4,3,2,2,3,29
540420706,3,8,6,1,2,2,1,1,24
540420707,2,2,2,1,0,1,1,2,11
540420708,6,6,3,1,3,0,0,1,20
540420709,14,11,25,22,7,6,2,4,91
540420710,18,39,48,29,19,13,10,7,183
540420801,24,23,25,26,16,17,7,10,148
540420802,24,27,37,35,11,16,7,7,164
540420803,23,28,33,24,16,11,5,9,149
540420804,2,2,0,1,0,0,1,0,6
540420805,6,7,10,5,6,4,4,6,48
540420806,2,1,0,1,0,1,0,1,6
540420901,3,5,10,6,5,2,0,4,35
540420902,3,3,0,0,2,1,0,0,9
540420903,1,1,0,0,0,0,0,1,3
540420904,14,3,3,1,0,0,1,2,24
540421001,30,42,49,42,35,32,14,31,275
540421002,7,2,3,5,5,4,3,5,34
540421003,10,12,11,14,12,3,8,7,77
540421004,4,4,2,3,2,2,2,2,21
540421005,19,34,57,47,37,23,12,17,246
540421006,21,19,24,18,22,19,12,15,150
540421007,6,11,18,28,15,16,6,8,108
540421008,30,39,47,42,24,22,11,16,231
540421009,14,17,25,33,25,19,10,26,169
540490101,37,55,64,66,63,48,13,23,369
540490102,65,74,79,84,73,100,25,31,531
540490103,26,33,47,32,36,38,14,23,249
540490104,59,79,96,88,89,55,21,23,510
540490105,45,85,110,104,89,66,25,35,559
540490106,23,28,64,39,34,16,11,17,232
540490107,45,52,66,84,51,22,7,7,334
540490108,46,49,76,57,41,29,10,23,331
540490109,43,53,60,71,51,22,10,10,320
540490110,6,15,21,22,21,38,6,6,135
540490111,32,22,26,18,35,15,6,13,167
540490112,27,39,43,32,24,18,10,9,202
540490113,17,27,30,37,30,39,20,20,220
540490114,22,31,74,59,48,27,9,25,295
540490115,14,25,33,50,47,24,11,8,212
540490116,41,32,53,52,31,31,7,17,264
540490201,11,23,31,22,13,5,3,5,113
540490202,52,87,95,99,67,41,23,14,478
540490203,64,94,114,118,87,69,35,33,614
540490204,43,40,40,37,30,21,6,2,219
540490205,32,54,63,72,43,22,10,9,305
540490206,90,97,122,87,56,54,32,20,558
540490207,25,32,45,40,29,11,3,4,189
540490301,62,94,101,100,70,51,27,37,542
540490302,18,23,38,38,20,18,3,7,165
540490303,60,68,70,67,51,14,8,8,346
540490304,24,54,55,50,32,20,7,11,253
540490305,38,47,37,32,31,34,19,14,252
540490306,17,19,33,35,28,14,5,8,159
540490307,20,33,46,41,32,16,8,9,205
540490308,23,50,50,52,31,10,6,5,227
540490309,31,55,65,77,53,27,11,9,328
540490310,27,36,33,36,33,20,14,11,210
540490311,25,47,54,44,26,24,18,10,248
540490312,29,37,51,46,30,11,8,8,220
540490401,58,57,85,72,52,47,18,34,423
540490402,2,6,10,4,3,7,2,0,34
540490403,6,5,6,3,1,2,1,0,24
540560101,13,34,32,48,23,15,6,8,179
540560102,26,38,46,44,44,25,10,15,248
540560103,19,38,54,44,29,28,7,11,230
540560104,13,40,54,35,25,17,7,8,199
540560105,12,13,17,27,19,10,3,4,105
540560106,7,13,30,22,12,7,4,3,98
540560201,49,73,54,70,47,30,11,14,348
540560202,26,32,37,24,30,13,10,4,176
540560203,11,18,29,21,14,3,2,1,99
540560204,10,35,27,31,16,10,7,6,142
540560205,31,50,63,50,38,25,14,18,289
540560206,43,62,74,55,35,19,5,8,301
540560207,24,14,19,25,25,14,2,8,131
540560208,48,65,73,75,47,16,6,6,336
540560209,27,39,46,36,21,8,5,4,186
540560210,40,37,73,53,42,20,11,9,285
540560301,42,62,83,82,67,56,22,21,435
540560302,22,37,34,42,31,27,12,19,224
540560303,67,73,112,106,80,75,25,29,567
540560304,12,28,20,23,13,28,4,3,131
540560305,44,51,53,58,42,27,11,28,314
540560306,24,23,17,22,17,19,9,13,144
540560307,9,14,11,24,13,13,4,9,97
540560308,24,46,38,49,28,23,14,13,235
540560309,20,35,27,35,26,9,1,6,159
540560401,1,0,0,0,0,0,0,0,1
540560402,0,2,1,0,0,0,0,0,3
540560403,10,11,7,9,6,4,3,3,53
540560501,35,49,40,58,41,35,18,23,299
540560502,0,1,0,0,0,0,0,0,1
540560503,0,0,1,0,0,0,0,0,1
540560601,60,76,89,99,74,68,33,50,549
540560602,52,67,76,86,67,54,20,44,466
540560603,49,73,102,86,51,46,28,36,471
540560604,62,85,119,90,76,75,35,43,585
540560605,25,32,40,35,34,31,18,19,234
540560606,14,16,20,17,19,18,9,21,134
540560607,25,39,43,39,34,31,7,18,236
540560608,49,74,85,91,76,50,15,25,465
540560609,22,31,43,36,37,30,16,13,228
540560610,35,61,71,61,48,46,17,16,355
540560611,50,52,66,67,37,36,14,30,352
540560612,48,52,70,62,52,50,18,23,375
540560613,43,57,73,81,59,41,15,29,398
540560614,36,29,46,46,30,32,11,9,239
540560701,15,15,16,21,7,5,4,7,90
540560702,41,47,53,56,29,23,9,11,269
540560703,9,7,12,12,10,0,1,2,53
540560704,5,4,23,13,6,3,1,4,59
540560705,13,21,20,21,12,9,8,3,107
540560706,7,10,16,11,8,4,5,7,68
540560707,20,21,23,19,13,10,3,4,113
540560708,30,61,60,71,63,23,9,21,338
540560709,24,48,55,41,46,18,18,15,265
540560710,28,41,49,67,33,28,9,11,266
540560711,22,49,89,71,36,10,4,3,284
540560801,77,95,92,86,62,49,28,38,527
540560802,66,77,103,101,69,47,16,30,509
540560803,28,25,34,36,33,21,13,28,218
540560901,53,86,87,80,41,18,6,1,372
540560902,110,129,148,108,73,31,16,16,631
540560903,72,89,94,86,66,31,8,9,455
540560904,26,59,58,77,38,21,7,8,294
540560905,46,70,63,61,35,19,1,3,298
540560906,28,52,46,45,22,16,5,7,221
540560907,25,35,56,41,30,15,12,6,220
540560908,27,57,67,70,45,23,6,6,301
540560909,34,35,51,54,38,27,16,30,285
540560910,41,53,49,39,22,18,2,5,229
540560911,29,54,48,43,19,12,8,1,214
540630101,33,21,22,13,20,6,5,6,126
540630102,2,10,15,18,12,9,9,10,85
540630103,0,2,0,0,0,0,0,0,2
540630104,0,2,0,0,0,0,0,0,2
540630105,26,37,28,26,25,22,16,11,191
540630106,28,45,45,66,40,25,7,12,268
540630107,24,53,68,58,43,15,6,7,274
540630108,12,24,47,46,36,27,9,11,212
540630109,37,52,75,77,53,40,19,16,369
540630110,47,64,73,68,56,43,9,16,376
540630111,43,53,63,49,45,34,12,20,319
540630112,35,50,70,63,36,38,8,9,309
540630113,26,33,48,52,41,32,12,11,255
540630114,25,31,54,47,24,20,8,1,210
540630115,32,55,62,59,24,14,3,5,254
540630201,0,2,0,1,1,1,0,0,5
540630202,0,0,0,0,1,0,0,0,1
540630203,0,0,0,0,0,0,0,0,0
540630301,32,10,3,4,2,5,2,1,59
540630302,11,11,12,15,9,6,7,9,80
540630401,1,7,3,4,1,3,1,3,23
540630402,13,1,3,1,0,1,1,0,20
540630403,11,19,13,16,9,4,6,6,84
540630404,18,12,11,4,7,7,1,4,64
540630405,21,36,39,32,24,30,17,19,218
540630406,42,45,69,50,47,51,15,23,342
540630407,31,57,44,33,30,16,8,17,236
540630408,36,38,69,58,29,12,9,6,257
540630409,24,27,34,32,21,18,12,14,182
540630410,27,30,35,41,31,16,5,10,195
540630501,31,30,36,25,18,9,5,14,168
540630502,4,2,6,3,4,2,1,0,22
540630503,5,6,8,4,1,5,1,3,33
540630504,5,7,2,11,4,6,2,5,42
540630505,17,9,14,5,3,2,1,5,56
540630601,1,0,0,0,0,0,0,0,1
540630602,5,6,6,2,1,1,0,1,22
540630701,1,3,0,2,1,0,0,0,7
540630702,2,0,1,0,0,0,0,0,3
540630703,3,5,0,4,1,3,1,0,17
540630704,3,11,10,5,13,1,4,6,53
540630705,8,4,2,2,3,2,0,4,25
540630801,20,32,43,27,24,18,8,9,181
540630802,72,63,104,74,48,44,13,24,442
540630803,37,48,39,37,5,3,0,0,169
540630804,22,26,28,37,17,14,9,11,164
540630805,31,57,97,87,46,34,27,20,399
540630806,3,5,8,2,3,1,2,2,26
540630807,8,6,9,7,6,4,2,1,43
540630808,4,2,4,0,0,0,0,0,10
540630809,1,0,2,0,0,0,1,0,4
540630810,11,5,11,16,3,4,9,8,67
540630811,14,18,13,23,13,18,2,13,114
540630812,28,34,58,46,32,28,17,21,264
540630813,41,77,99,89,49,38,10,8,411
540630814,46,79,99,81,67,31,14,26,443
540630815,29,61,83,93,55,35,15,15,386
540630816,25,40,46,60,54,40,17,32,314
540630817,12,17,36,46,36,40,23,36,246
540630818,24,43,47,41,20,10,7,2,194
540630819,28,31,50,53,41,38,24,46,311
540630901,15,24,27,20,23,16,10,29,164
540630902,13,20,18,10,8,5,2,6,82
540630903,1,5,2,1,1,1,0,1,12
540630904,29,47,34,40,13,8,4,2,177
540630905,30,39,48,56,22,28,8,15,246
540630906,36,60,49,45,34,15,5,10,254
540630907,26,46,50,56,32,14,2,6,232
540630908,37,39,56,70,43,44,19,26,334
540630909,32,38,58,52,22,19,5,12,238
540630910,22,37,37,38,16,19,12,23,204
540630911,35,54,44,38,22,12,3,7,215
540630912,12,30,54,40,24,22,8,24,214
540630913,6,13,23,18,18,12,11,20,121
540630914,30,69,77,86,50,33,5,16,366
540630915,17,23,51,62,38,23,25,21,260
540630916,28,15,38,27,28,21,11,32,200
540630917,20,28,39,48,35,13,7,7,197
540630918,22,34,48,29,16,14,2,2,167
540631001,65,63,56,54,15,13,2,5,273
540631002,97,88,88,63,37,14,7,8,402
540631003,68,87,82,74,52,39,10,17,429
540631004,41,76,82,89,52,30,10,9,389
540631005,33,45,60,47,35,13,3,9,245
540631006,27,18,52,36,34,22,6,10,205
540631007,13,33,31,37,29,24,8,12,187
540631008,43,65,82,70,50,18,11,7,346
540631009,29,24,32,53,28,16,6,11,199
540631010,26,41,33,30,20,16,4,5,175
540631011,20,37,45,52,25,32,9,7,227
540631012,27,40,58,41,36,28,10,12,252
540631013,53,47,67,59,42,45,16,19,348
540631014,34,70,92,82,63,30,8,8,387
540631101,41,69,51,39,25,9,3,1,238
540631102,73,66,76,59,44,29,9,28,384
540631103,61,69,42,32,10,9,2,5,230
540631104,51,100,89,58,50,26,7,13,394
540631105,109,109,90,73,47,9,2,2,441
540631106,65,87,84,82,45,24,12,13,412
540631107,53,74,91,75,41,26,10,6,376
540631108,41,50,57,64,32,21,6,4,275
540631109,28,30,43,41,43,27,7,8,227
540631110,32,48,66,62,37,19,11,8,283
540631111,22,35,48,41,23,15,3,1,188
540631112,24,58,83,54,36,14,6,3,278
540631113,44,71,76,71,36,15,10,15,338
540700101,36,41,24,31,32,19,12,11,206
540700102,12,5,11,9,12,6,3,4,62
540700103,8,2,4,3,1,2,0,1,21
540700104,12,27,22,20,19,9,8,3,120
540700105,9,20,30,16,10,8,0,2,95
540700201,10,11,11,19,17,6,3,3,80
540700202,22,36,26,24,22,16,5,1,152
540700203,3,15,16,16,9,3,1,5,68
540700204,11,13,6,9,14,3,2,0,58
540700205,24,44,51,42,27,21,6,12,227
540700206,19,34,34,31,15,24,10,9,176
540700207,48,71,69,61,43,34,15,22,363
540700208,29,43,41,44,36,23,16,19,251
540700301,20,26,21,25,13,13,2,11,131
540700302,25,25,32,44,16,12,13,6,173
540700303,4,27,15,19,8,7,3,4,87
540700304,37,45,50,54,37,24,15,17,279
540700305,44,35,40,42,33,13,13,23,243
540700306,42,37,46,50,31,30,14,16,266
540700307,39,69,62,64,38,13,2,2,289
540700308,51,64,72,76,59,37,16,26,401
540700309,56,53,75,70,57,32,25,29,397
540700310,43,63,38,50,19,11,5,4,233
540700311,25,61,70,70,45,21,12,10,314
540700312,23,33,46,40,32,17,4,3,198
540700313,24,38,40,48,32,9,7,3,201
540700314,19,25,44,43,39,14,8,11,203
540700315,17,21,48,56,21,19,5,15,202
540700316,18,45,62,60,35,12,3,3,238
540700401,9,12,15,15,12,7,2,7,79
540700402,52,48,47,40,45,31,19,27,309
540700403,9,13,16,10,9,8,1,3,69
540700404,14,16,20,9,15,10,3,6,93
540700501,31,21,17,18,12,8,3,3,113
540700502,19,33,25,33,15,2,6,5,138
540700503,68,69,87,85,69,32,17,28,455
540700504,38,40,42,34,33,11,6,10,214
540700505,22,30,29,24,17,19,2,11,154
540700506,15,17,14,11,13,8,4,2,84
540700507,46,56,42,37,19,8,1,0,209
540700508,49,77,51,70,37,25,9,10,328
540700601,21,27,23,23,16,10,1,3,124
540700602,32,43,36,47,22,14,5,10,209
540700603,17,15,17,12,12,7,4,5,89
540700701,64,77,53,41,27,5,3,2,272
540700702,62,59,26,15,19,4,4,0,189
540700703,57,84,44,46,16,6,2,2,257
540700704,34,59,69,64,35,14,3,2,280
540700705,41,71,41,42,24,9,0,3,231
540700706,52,81,59,54,22,4,0,1,273
540700707,60,77,62,66,25,8,3,0,301
540700708,40,84,77,81,35,14,2,3,336
540700709,36,52,33,39,18,7,0,0,185
540700801,24,58,55,39,31,17,3,3,230
540700802,58,86,66,37,21,10,4,3,285
540700803,68,99,79,74,42,20,9,8,399
540700804,36,50,53,42,37,9,5,6,238
540700805,32,48,49,61,21,9,4,4,228
540700806,83,90,62,52,26,7,2,0,322
540700807,56,105,81,74,46,25,6,6,399
540700808,29,42,47,58,38,17,5,1,237
540770101,30,52,55,55,49,32,16,7,296
540770102,38,63,85,75,55,32,13,18,379
540770103,27,33,54,44,34,41,9,12,254
540770104,37,56,53,58,29,18,9,11,271
540770105,59,83,105,88,44,14,8,6,407
540770106,6,9,8,5,5,4,3,4,44
540770107,22,48,62,41,38,23,13,18,265
540770108,44,99,78,80,44,22,8,11,386
540770109,45,55,60,37,17,7,6,5,232
540770110,29,62,80,85,64,30,11,9,370
540770201,12,24,30,32,18,26,4,24,170
540770202,16,7,26,16,15,11,6,13,110
540770203,3,2,4,3,1,1,1,0,15
540770204,0,2,4,1,2,1,1,0,11
540770205,14,22,23,26,16,18,6,6,131
540770206,3,5,5,2,4,4,1,0,24
540770207,12,25,23,20,18,10,5,4,117
540770208,37,67,75,61,61,36,18,17,372
540770209,37,46,56,57,34,19,26,15,290
540770210,31,44,40,36,23,29,2,2,207
540770211,38,49,48,58,39,21,22,22,297
540770212,17,40,38,44,28,19,9,10,205
540770213,39,38,45,60,40,14,17,16,269
540770301,42,48,51,47,21,21,14,5,249
540770302,20,25,24,28,11,22,9,31,170
540770303,9,8,6,10,8,2,1,0,44
540770304,21,21,23,21,21,14,6,13,140
540770305,9,24,17,13,16,14,2,12,107
540770306,7,13,16,5,12,11,2,6,72
540770307,2,3,0,1,0,0,0,0,6
540770308,25,25,33,31,23,18,17,23,195
540770309,56,64,63,63,44,26,17,21,354
540770401,38,50,54,52,56,32,27,33,342
540770402,26,54,39,44,21,8,3,5,200
540770403,7,21,10,7,12,5,1,2,65
540770404,33,67,69,62,45,24,6,4,310
540770405,57,62,61,32,18,5,3,7,245
540770406,15,10,20,11,9,2,0,9,76
540770407,36,65,46,55,41,14,4,4,265
540770408,24,47,63,48,27,11,5,8,233
540770501,7,22,20,14,16,8,15,23,125
540770502,3,1,1,1,0,0,1,0,7
540770503,0,0,2,2,4,1,0,0,9
540770601,16,35,33,21,20,18,2,7,152
540770602,54,75,81,70,38,17,14,13,362
540770603,23,46,41,26,15,6,2,6,165
540770604,19,17,30,21,10,2,6,5,110
540770605,19,33,24,34,28,16,14,21,189
540770701,5,4,6,8,8,3,3,5,42
540770702,12,21,23,27,17,10,5,12,127
540770703,34,37,64,50,45,36,18,30,314
540770704,18,21,25,27,20,13,10,14,148
540770801,42,84,51,57,32,14,2,2,284
540770802,8,27,24,25,16,11,2,2,115
540770803,63,78,47,50,25,7,6,1,277
540770804,57,62,57,45,31,14,8,5,279
540770805,40,47,85,57,39,31,21,26,346
540770806,46,99,49,53,25,12,6,8,298
540770807,47,74,45,38,18,11,4,2,239
540770808,15,24,32,20,14,6,2,1,114
540770809,44,67,51,34,12,6,4,1,219
540770810,51,65,59,45,19,10,1,5,255
540770811,21,49,43,40,25,8,1,3,190
540770812,32,55,36,28,17,9,9,4,190
540840101,17,17,25,15,7,7,1,0,89
540840102,47,60,61,50,34,17,7,9,285
540840103,5,2,2,6,4,5,3,4,31
540840104,30,35,33,18,26,21,9,20,192
540840105,39,49,58,43,37,18,3,9,256
540840106,27,55,62,47,24,19,2,12,248
540840107,37,57,70,70,38,27,15,14,328
540840108,31,44,65,47,35,33,11,9,275
540840109,34,45,57,60,50,27,15,23,311
540840110,29,25,48,40,27,23,14,17,223
540840201,16,10,4,8,8,6,2,3,57
540840202,11,12,15,13,10,6,6,12,85
540840203,4,4,3,2,1,2,1,4,21
540840204,1,0,0,0,0,0,0,0,1
540840301,47,67,80,62,58,29,14,19,376
540840302,35,43,82,47,36,24,14,10,291
540840303,25,33,45,36,23,16,5,8,191
540840304,56,61,84,56,40,28,14,17,356
540840305,44,51,42,29,16,10,0,1,193
540840306,5,3,3,5,4,2,2,2,26
540840307,19,29,32,34,26,20,9,13,182
540840308,13,2,5,3,0,1,1,0,25
540840309,21,16,36,25,24,10,8,11,151
540840310,4,5,7,5,8,3,2,0,34
540840311,12,10,10,13,11,9,3,3,71
540840312,26,51,68,45,31,17,6,12,256
540840313,13,13,17,22,25,18,12,38,158
540840314,35,47,43,35,27,8,4,1,200
540840401,9,4,8,1,6,4,3,2,37
540840402,8,12,17,12,13,6,8,11,87
540840403,42,54,67,51,40,27,13,22,316
540840404,3,11,5,13,4,1,1,0,38
540840405,31,40,28,46,17,22,7,26,217
540840406,4,1,1,2,2,1,0,0,11
540840407,8,8,8,9,4,4,2,2,45
540840408,21,21,32,42,21,19,16,15,187
540840409,27,36,41,31,33,19,9,24,220
540840501,5,9,11,4,0,2,2,1,34
540840502,9,11,8,6,6,4,0,5,49
540840601,7,8,9,4,3,2,0,6,39
540840602,15,15,25,7,14,11,9,13,109
540840603,16,21,11,16,5,3,4,3,79
540840604,4,6,5,7,3,2,5,3,35
540840605,12,20,21,20,9,8,5,5,100
540840606,30,17,29,37,26,12,13,13,177
540840607,32,37,32,34,23,25,16,28,227
540840701,8,4,8,4,2,4,1,6,37
540840702,5,0,2,0,0,0,0,0,7
540840801,4,2,1,0,1,1,2,0,11
540840802,21,5,11,8,12,5,5,3,70
540840901,21,40,53,75,35,35,11,17,287
540840902,32,44,68,69,63,50,28,39,393
540840903,41,48,43,38,17,4,1,1,193
540840904,43,67,79,51,26,22,7,12,307
540840905,14,32,33,20,29,17,14,10,169
540840906,43,61,60,47,28,18,6,4,267
540840907,66,79,67,73,34,20,11,14,364
540840908,50,71,53,42,21,8,0,4,249
540840909,40,45,69,62,45,30,21,28,340
540840910,41,53,51,30,11,1,2,3,192
540910101,49,70,63,50,25,9,2,1,269
540910102,60,73,62,44,21,8,3,1,272
540910103,53,71,46,33,15,2,4,0,224
540910104,87,119,93,54,27,19,4,1,404
540910105,97,92,65,56,37,12,5,4,368
540910106,66,77,89,64,45,32,10,6,389
540910107,34,48,57,59,51,26,18,21,314
540910108,182,145,78,48,27,7,3,3,493
540910109,88,77,47,21,14,5,2,0,254
540910110,53,60,45,26,7,9,1,2,203
540910111,67,79,53,37,9,9,0,2,256
540910112,79,82,85,56,23,12,1,1,339
540910113,66,72,43,19,18,6,0,1,225
540910114,16,36,25,28,14,13,0,5,137
540910115,65,56,50,39,18,4,0,2,234
540910116,87,110,117,79,64,28,12,10,507
540910117,36,63,75,68,60,23,9,16,350
540910118,185,89,38,29,13,4,1,1,360
540910119,101,93,87,71,32,11,4,0,399
540910201,38,63,95,80,61,53,33,43,466
540910202,55,64,80,78,71,35,17,31,431
540910203,38,54,63,48,36,19,7,5,270
540910204,28,41,53,43,34,16,9,13,237
540910205,50,60,58,71,38,26,10,16,329
540910206,42,68,46,25,29,7,3,2,222
540910207,81,111,84,68,23,18,1,3,389
540910208,54,72,55,53,37,15,7,9,302
540910209,41,74,63,66,54,23,7,8,336
540910210,46,96,80,57,17,14,7,4,321
540910211,38,56,63,60,25,11,9,3,265
540910212,36,44,58,42,31,28,8,17,264
540910213,64,92,85,100,68,47,29,28,513
540910214,35,28,35,44,35,38,10,17,242
540910215,49,57,71,57,35,17,14,13,313
540910216,26,60,64,31,19,11,1,3,215
540910217,45,62,36,37,18,4,2,2,206
540910218,34,35,48,55,26,43,15,14,270
540910219,33,33,59,55,24,22,9,15,250
540910301,13,11,6,6,5,5,2,6,54
540910302,17,15,13,5,10,11,4,6,81
540910303,14,11,9,9,5,3,0,1,52
540910304,9,6,11,13,5,6,1,0,51
540910305,17,20,29,17,13,10,6,10,122
540910306,38,44,54,43,28,16,7,8,238
540910401,7,26,23,24,14,12,11,7,124
540910402,28,33,18,23,18,10,4,6,140
540910403,30,30,42,47,27,23,13,8,220
540910404,43,44,36,50,23,16,13,12,237
540910405,15,12,19,13,9,4,8,14,94
540910406,19,38,43,30,32,16,5,5,188
540910501,15,16,8,13,6,2,2,1,63
540910502,8,23,26,11,15,4,6,5,98
540910503,16,20,18,18,12,4,9,4,101
540910504,13,8,14,16,9,11,4,7,82
540910505,21,8,14,11,8,10,1,7,80
540910506,15,29,14,15,8,7,2,9,99
540910507,26,34,34,40,16,14,9,13,186
540910508,14,27,15,21,9,10,9,3,108
540910509,57,62,94,73,56,43,27,28,440
540910510,8,16,8,9,9,7,5,9,71
540910511,11,23,23,33,11,8,3,2,114
540910512,46,61,49,59,29,9,10,2,265
540910513,46,58,44,50,34,18,9,7,266
540910514,17,20,44,37,29,41,17,22,227
540910515,41,62,72,61,33,25,11,23,328
540910516,33,28,19,28,26,9,5,16,164
540910601,33,36,32,27,17,14,6,2,167
540910602,17,36,25,17,13,11,2,7,128
540910603,15,19,16,16,7,7,3,2,85
540910701,10,12,6,8,11,5,6,3,61
540910702,18,9,14,4,7,9,4,8,73
540910703,19,19,23,26,11,7,7,8,120
540910704,14,9,9,13,4,11,2,4,66
540910705,14,16,35,22,13,16,6,11,133
540910706,23,31,33,29,23,6,6,13,164
540910707,21,37,45,46,46,25,10,20,250
540910708,21,17,23,19,11,20,7,7,125
540910709,13,20,23,20,17,8,3,9,113
540910710,15,27,39,36,19,4,2,2,144
540910711,2,3,3,5,3,1,1,1,19
540910712,25,60,55,50,35,22,5,6,258
540910713,33,39,42,48,50,22,19,20,273
540910714,45,39,56,44,33,22,14,16,269
540910715,45,65,73,98,48,32,6,6,373
540910716,20,49,51,52,31,18,13,10,244
540910717,18,39,53,64,45,23,12,18,272
540910718,31,74,63,85,41,18,10,6,328
540910719,20,55,57,58,30,19,15,9,263
540910801,5,8,5,4,5,4,1,7,39
540910802,24,33,30,26,18,21,6,10,168
540910803,23,32,36,30,31,18,8,13,191
540910804,12,13,8,10,9,8,6,5,71
540910805,21,31,19,28,17,12,7,13,148
540910806,3,12,7,3,3,2,1,1,32
540910807,12,7,11,17,16,12,9,13,97
540910808,31,14,24,12,21,7,10,7,126
540910809,24,15,19,16,21,13,7,11,126
540910810,31,35,64,53,46,26,17,26,298
540910811,9,27,38,22,31,18,16,9,170
540910901,39,45,58,43,49,26,6,16,282
540910902,25,30,36,40,28,19,15,22,215
540910903,17,26,29,35,32,17,14,14,184
540910904,18,13,14,16,11,8,7,9,96
540910905,34,51,44,49,35,23,11,19,266
540911001,31,54,33,47,29,26,20,20,260
540911002,6,15,23,24,18,15,12,11,124
540911003,8,10,13,10,7,4,1,2,55
540911004,3,10,6,10,6,1,1,0,37
540911005,21,18,31,34,21,18,6,10,159
540911006,10,13,26,14,8,6,1,5,83
540911007,2,3,12,6,7,2,0,2,34
540911008,17,27,43,29,19,7,10,2,154
540911009,25,28,38,28,15,10,15,7,166
540911010,5,18,33,22,9,7,8,5,107
540911011,9,9,11,8,7,2,0,1,47
540911012,3,3,5,4,4,2,1,1,23
540911013,12,11,14,19,11,8,3,8,86
540911014,12,36,39,37,22,21,13,14,194
540911101,25,37,32,34,38,35,18,31,250
540911102,9,19,17,6,10,4,7,10,82
540911103,2,6,4,2,2,2,3,1,22
540911104,7,6,5,6,5,1,0,3,33
540911105,11,18,16,10,8,7,4,4,78
540911106,12,23,27,27,20,8,3,15,135
540911107,11,14,6,7,3,10,7,7,65
540911108,16,20,20,21,16,13,7,13,126
540911201,13,24,17,13,7,12,9,11,106
540911202,1,8,6,6,5,1,1,1,29
540911203,8,23,23,21,10,9,8,9,111
540911204,6,2,2,1,2,1,1,0,15
540911205,5,10,18,13,11,10,9,14,90
540911206,9,19,19,13,10,8,2,4,84
540911207,9,15,10,20,12,9,1,13,89
540911208,6,8,7,7,10,10,1,7,56
540911209,33,43,41,45,36,17,13,23,251
540911210,32,51,50,42,30,18,7,10,240
540911211,8,12,23,31,18,15,6,12,125
540911301,46,50,42,40,51,27,24,44,324
540911302,21,34,31,45,31,33,20,35,250
540911303,22,41,58,78,56,17,8,9,289
540911304,25,38,58,54,35,28,8,19,265
540911305,14,37,59,55,31,14,4,2,216
540911306,16,49,63,48,47,17,7,5,252
540911307,25,34,35,43,29,17,5,16,204
540911308,38,48,61,65,34,15,7,4,272
540911309,52,83,101,100,55,31,8,15,445
540911310,133,129,83,66,31,15,2,0,459
540911311,76,89,59,51,37,27,7,19,365
540911312,32,53,80,76,41,22,11,15,330
540911313,39,55,53,63,35,12,2,2,261
540980101,26,34,34,27,19,11,6,3,160
540980102,19,18,17,20,12,5,1,5,97
540980103,20,12,9,10,11,10,1,5,78
540980104,59,55,51,46,33,22,11,24,301
540980105,11,10,6,11,9,3,3,3,56
540980106,55,52,59,62,42,20,15,11,316
540980201,5,4,3,0,3,6,4,2,27
540980202,46,51,57,69,47,36,11,35,352
540980203,14,16,21,23,21,10,8,15,128
540980204,5,11,7,9,4,2,2,3,43
540980205,6,4,7,4,3,4,2,1,31
540980206,38,55,77,59,36,27,13,12,317
540980207,40,61,72,65,33,28,11,17,327
540980301,10,10,8,14,1,3,6,9,61
540980302,21,29,29,28,19,11,5,6,148
540980303,17,12,10,19,12,8,9,12,99
540980401,24,17,16,21,15,12,8,11,124
540980402,10,8,9,11,12,6,2,7,65
540980403,10,8,7,13,2,2,5,2,49
540980501,27,63,66,72,48,12,14,13,315
540980502,35,73,66,59,42,16,10,8,309
540980503,43,57,60,48,24,10,3,2,247
540980504,37,52,63,36,21,16,7,4,236
540980505,46,63,52,42,19,5,3,2,232
540980506,38,44,34,32,15,7,1,1,172
540980507,26,35,34,37,27,28,13,12,212
540980508,3,8,5,5,6,2,1,0,30
540980509,14,36,24,27,20,14,5,14,154
540980510,7,19,14,13,13,6,7,5,84
540980511,20,21,32,34,18,13,9,7,154
540980512,15,17,12,18,9,10,3,5,89
540980513,25,38,45,38,23,20,10,10,209
540980514,45,38,49,28,25,17,2,6,210
540980515,33,48,40,39,14,4,0,2,180
540980516,44,51,52,67,45,33,14,31,337
540980517,12,15,24,17,14,17,4,12,115
540980518,18,53,65,52,15,16,3,3,225
540980601,12,17,11,7,10,2,2,8,69
540980602,6,10,10,12,8,8,2,4,60
540980603,5,14,5,6,1,3,2,3,39
540980604,7,5,4,2,3,3,0,1,25
540980605,3,2,3,1,2,2,0,0,13
540980701,24,35,28,18,22,8,7,13,155
540980702,46,39,54,35,34,30,9,18,265
540980703,8,7,9,15,5,4,2,3,53
540980704,24,28,30,24,18,12,3,7,146
540980801,24,26,14,11,10,8,2,8,103
540980802,13,16,19,16,23,12,6,16,121
540980803,23,17,21,14,19,8,5,11,118
540980901,42,24,30,28,19,12,5,9,169
540980902,47,52,67,61,42,42,22,20,353
540980903,41,50,56,37,24,13,5,8,234
540980904,29,41,50,41,34,20,6,13,234
540980905,22,20,24,20,17,7,6,11,127
540980906,9,23,8,11,9,8,6,8,82
540980907,49,58,61,61,28,23,7,12,299
540980908,48,37,57,74,37,30,15,16,314
540981001,3,1,2,1,1,0,1,3,12
540981002,69,67,91,91,67,49,23,50,507
540981003,44,37,30,36,23,20,10,21,221
540981004,30,43,42,52,25,16,11,4,223
540981005,41,47,45,41,28,20,4,9,235
540981006,55,57,52,47,23,20,7,5,266
540981007,40,31,36,45,28,25,12,12,229
540981008,39,63,63,30,28,21,8,10,262
540981009,38,45,40,37,14,11,3,2,190
540981010,24,44,37,33,29,8,9,9,193
540981011,29,35,61,59,38,34,10,32,298
540981101,7,8,10,4,5,6,3,13,56
540981102,15,15,18,19,7,13,9,15,111
540981103,26,16,21,13,19,16,5,26,142
540981201,16,24,39,28,24,10,4,3,148
540981202,24,29,50,36,31,19,7,13,209
540981203,16,25,35,34,21,12,3,10,156
540981204,23,30,57,58,42,36,22,37,305
540981205,49,40,66,62,51,39,27,33,367
540981206,19,49,55,61,38,7,10,12,251
540981207,40,41,50,34,25,19,11,10,230
540981208,59,57,64,43,42,38,11,24,338
540981209,18,41,69,55,27,11,6,4,231
540981210,35,53,39,35,15,11,3,1,192
540981211,33,58,59,50,17,9,2,3,231
540981212,12,26,46,46,23,19,12,16,200
540981213,26,44,40,34,17,9,1,0,171
540981214,39,43,44,57,38,39,9,21,290
541050101,14,6,15,12,17,8,3,2,77
541050102,4,9,8,10,7,2,2,1,43
541050103,21,30,35,41,24,17,7,10,185
541050104,9,13,10,18,4,9,6,3,72
541050105,9,15,15,14,6,8,10,4,81
541050106,1,1,0,1,1,0,0,1,5
541050107,6,9,10,8,9,5,1,2,50
541050108,11,17,18,24,4,5,5,5,89
541050109,1,1,2,2,0,0,0,0,6
541050110,5,3,2,3,1,1,0,0,15
541050111,2,2,1,2,2,0,0,0,9
541050112,17,16,13,19,10,7,5,0,87
541050113,32,45,36,35,23,24,6,4,205
541050201,12,23,20,25,13,5,5,4,107
541050202,12,14,13,23,9,9,7,4,91
541050203,6,18,15,16,17,12,4,4,92
541050204,12,16,8,14,3,8,5,6,72
541050205,0,1,2,0,0,1,1,1,6
541050206,0,2,0,0,2,1,0,1,6
541050207,18,27,28,22,16,12,5,3,131
541050208,7,10,23,16,12,10,2,7,87
541050209,41,50,70,73,57,44,19,32,386
541050210,10,6,7,4,3,1,2,0,33
541050211,5,2,3,2,3,3,0,2,20
541050212,11,4,16,12,4,3,4,2,56
541050213,30,30,43,50,36,14,7,11,221
541050214,54,54,61,41,18,16,8,3,255
541050215,21,34,35,31,22,11,5,9,168
541050216,37,31,43,51,31,18,5,6,222
541050217,36,56,54,35,37,17,9,12,256
541050218,29,62,84,65,48,17,9,9,323
541050219,42,74,57,42,27,12,2,1,257
541050220,20,39,29,34,23,25,10,7,187
541050221,24,49,52,45,27,14,6,13,230
541050222,26,51,52,41,17,6,3,6,202
541050223,15,26,52,42,20,14,6,6,181
541050301,10,6,7,12,4,1,1,3,44
541050302,45,60,38,45,34,25,8,10,265
541050303,4,10,7,3,0,9,2,5,40
541050304,2,4,1,2,0,1,0,0,10
541050305,6,16,7,10,4,6,3,4,56
541050306,6,7,16,11,9,6,2,4,61
541050307,16,10,19,15,10,7,4,6,87
541050308,6,5,5,7,6,4,5,4,42
541050401,17,46,45,32,34,19,10,7,210
541050402,17,37,30,36,24,15,10,17,186
541050403,16,23,37,24,9,12,4,3,128
541050404,11,18,15,11,7,6,3,1,72
541120101,35,63,87,101,67,44,27,54,478
541120102,69,105,151,138,123,121,33,51,791
541120103,42,46,61,61,48,43,11,19,331
541120104,7,4,7,2,6,7,5,3,41
541120105,12,6,14,0,3,4,0,0,39
541120106,16,9,18,18,5,15,3,5,89
541120201,0,1,2,1,0,1,0,0,5
541120202,0,7,4,5,1,1,1,1,20
541120301,0,0,0,5,1,0,0,0,6
541120302,6,5,3,5,4,3,1,0,27
541120401,1,0,0,0,0,0,0,0,1
541120402,0,0,1,0,0,0,0,0,1
541120501,52,57,63,60,44,33,16,10,335
541120502,47,73,59,67,11,26,1,5,289
541120503,46,35,39,34,31,23,7,9,224
541120504,35,31,33,45,43,32,16,18,253
541120505,39,59,56,66,49,36,9,26,340
541120506,40,25,40,39,35,31,14,32,256
541120507,17,24,30,29,23,19,9,18,169
541120508,34,50,75,52,53,37,13,23,337
541120509,25,27,51,55,27,40,1,22,248
541120510,37,55,63,64,55,41,12,19,346
541120511,22,48,52,61,51,40,11,9,294
541120512,30,38,50,50,34,17,7,19,245
541120513,25,38,50,48,25,12,7,9,214
541120514,17,15,27,21,15,12,6,10,123
541120515,30,30,48,36,40,35,5,17,241
541120601,23,30,36,34,34,24,17,32,230
541120602,58,73,85,75,69,82,22,45,509
541120701,5,6,3,2,1,0,0,1,18
541120702,51,53,52,51,45,44,31,43,370
541120703,79,94,136,101,91,63,32,63,659
541120704,13,22,25,27,17,14,7,11,136
541190101,23,31,35,34,38,23,14,21,219
541190102,14,28,35,34,30,24,11,14,190
541190103,44,87,73,65,58,26,13,24,390
541190104,42,64,79,57,55,21,15,19,352
541190105,55,98,132,105,81,53,21,38,583
541190106,49,60,69,60,23,12,7,7,287
541190107,85,108,101,95,65,36,12,23,525
541190201,15,22,21,20,21,11,11,21,142
541190202,18,24,52,43,45,36,19,34,271
541190203,25,44,45,55,37,35,12,9,262
541190204,16,20,43,26,17,8,3,4,137
541190301,4,9,13,11,11,4,7,4,63
541190302,33,96,94,76,46,32,9,21,407
541190303,22,58,72,55,41,12,2,5,267
541190304,7,35,27,27,18,7,5,4,130
541190305,16,34,35,41,24,8,4,3,165
541190306,6,15,20,12,11,6,1,3,74
541190307,45,70,58,46,25,11,1,3,259
541190401,7,25,32,28,16,14,7,5,134
541190402,24,44,63,39,46,27,9,15,267
541190403,47,106,100,79,40,30,6,9,417
541190501,9,22,22,20,14,5,1,3,96
541190502,62,112,94,88,65,50,9,13,493
541190503,27,46,54,50,34,8,11,9,239
541190504,13,39,33,15,23,16,8,11,158
541190505,6,10,9,10,10,3,2,0,50
541190506,18,25,26,24,12,6,3,4,118
541190507,24,20,21,28,15,18,3,5,134
541190508,43,70,80,84,47,29,7,3,363
541190601,4,6,6,5,5,3,1,6,36
541190602,21,44,45,31,24,8,8,7,188
541190603,12,21,31,22,8,7,8,4,113
580070101,0,0,0,0,0,0,0,0,0
580070102,58,31,19,12,5,4,2,2,133
580070103,23,20,27,29,17,9,5,6,136
580070104,48,35,44,21,20,6,3,2,179
580070105,27,23,19,6,8,5,0,2,90
580070201,33,14,12,7,8,8,6,5,93
580070202,6,8,5,5,5,2,0,0,31
580070203,21,12,12,14,11,4,2,2,78
580070204,12,3,7,4,3,2,1,0,32
580070205,30,38,45,34,30,19,7,6,209
580070301,37,20,26,13,9,4,1,1,111
580070302,92,90,105,125,74,28,13,20,547
580070303,62,64,68,61,39,21,10,13,338
580070304,76,72,90,65,33,18,3,6,363
580070305,13,9,23,28,11,5,3,0,92
580140101,37,23,22,12,11,4,1,0,110
580140102,38,27,28,19,10,8,1,0,131
580140103,25,12,12,13,7,7,1,1,78
580140104,60,57,61,47,34,13,4,2,278
580140105,21,21,11,13,11,7,0,0,84
580140106,67,82,78,68,20,17,5,3,340
580140107,22,31,44,53,28,15,9,9,211
580140108,44,44,39,43,25,16,6,5,222
580140109,63,81,105,94,77,43,8,20,491
580140110,62,43,59,62,58,28,18,11,341
580140111,35,20,28,17,9,5,3,0,117
580140112,26,10,14,12,7,1,1,1,72
580140113,24,12,12,8,5,4,3,2,70
580140114,48,43,52,60,36,20,1,4,264
580140115,16,25,26,32,22,10,3,6,140
580140116,34,37,55,73,46,27,5,12,289
580210101,10,9,6,5,1,0,1,1,33
580210102,10,5,8,4,6,1,0,2,36
580210103,23,15,12,14,7,4,2,1,78
580210104,9,11,7,6,3,6,0,0,42
580210105,25,12,11,12,6,6,5,0,77
580210106,4,3,2,1,3,0,0,0,13
580210107,10,14,8,9,1,3,2,1,48
580210108,8,6,1,2,3,0,0,0,20
580210109,9,4,6,10,11,3,0,1,44
580210110,5,3,10,8,4,1,1,0,32
580210111,3,1,5,4,3,1,0,0,17
580210112,34,29,42,43,42,15,13,3,221
580280101,7,12,1,7,3,1,1,0,32
580280102,6,4,1,2,2,0,0,0,15
580280103,10,16,10,6,3,4,1,0,50
580280104,11,9,11,6,6,11,1,0,55
580280105,10,2,5,3,3,2,0,0,25
580280106,7,3,3,0,1,0,1,1,16
580280107,28,53,74,61,28,23,4,11,282
580280108,8,9,12,24,26,13,4,7,103
580280109,54,50,58,48,29,12,5,8,264
580280110,4,15,18,35,18,13,5,8,116
580280115,12,10,6,5,3,0,1,0,37
580280116,11,12,13,8,12,2,0,5,63
580280117,41,66,42,64,24,12,3,6,258
580350101,12,7,2,2,3,0,0,0,26
580350102,31,21,13,13,6,4,3,4,95
580350103,11,3,2,2,0,0,0,0,18
580350104,8,10,1,4,1,1,0,0,25
580350105,9,9,2,1,1,0,0,2,24
580350106,11,4,7,1,3,1,0,0,27
580350107,13,7,3,2,1,0,0,0,26
580350108,3,4,6,5,2,0,0,0,20
580350109,6,4,2,1,0,0,0,0,13
580350201,19,22,28,26,21,6,4,4,130
580350202,24,21,24,31,20,17,6,4,147
580350203,1,4,1,0,0,0,1,0,7
580350204,84,79,57,52,30,18,6,4,330
580350205,34,31,38,18,23,6,7,3,160
580350206,16,15,9,1,3,0,0,1,45
580350207,39,24,24,26,16,19,1,2,151
580350208,36,36,29,15,15,3,1,3,138
580350209,21,39,62,56,22,15,1,3,219
580350210,46,48,61,47,23,16,1,3,245
580350211,42,29,47,20,6,5,2,0,151
580350212,39,23,35,27,13,4,1,1,143
580350213,20,29,34,29,12,5,1,2,132
580350214,26,27,38,32,13,10,6,2,154
580350215,31,29,55,35,26,14,7,6,203
580350216,4,10,13,10,6,3,1,0,47
580350301,31,55,58,53,34,12,2,5,250
580350302,36,47,40,54,36,20,5,7,245
580350303,28,60,61,53,34,16,5,6,263
580350304,61,99,79,91,32,10,2,0,374
580350305,39,102,72,90,48,9,5,2,367
580350306,38,79,92,82,46,9,2,0,348
580350307,64,119,85,64,32,7,4,1,376
580350308,63,64,87,101,59,32,15,15,436
580350309,68,105,78,60,23,9,1,1,345
580350310,81,80,58,44,18,5,1,0,287
580350311,16,24,29,31,12,8,3,0,123
580350312,20,33,32,30,15,2,3,0,135
580350313,19,72,43,66,45,18,4,1,268
580350314,13,15,9,15,10,2,0,0,64
580350315,27,15,59,33,24,8,4,6,176
580350316,29,83,67,78,26,17,1,0,301
580350401,74,96,60,20,6,2,0,0,258
580350402,58,115,61,49,17,6,0,0,306
580350403,20,36,30,34,12,3,0,1,136
580350404,64,89,117,96,66,26,7,5,470
580350405,48,63,51,54,27,20,12,6,281
580350406,62,86,61,47,22,6,2,1,287
580350407,45,74,47,36,20,9,2,0,233
580350408,74,93,74,51,26,5,2,2,327
580350409,103,95,64,51,25,7,1,1,347
580350410,51,102,83,77,24,14,1,2,354
580350411,59,75,77,70,17,8,5,0,311
580350412,58,91,96,55,27,18,4,3,352
580350413,38,39,34,33,20,7,2,4,177
580350414,58,84,58,65,22,16,6,7,316
580350415,96,78,60,44,19,7,2,4,310
580350416,64,85,47,41,19,7,2,5,270
580350417,94,100,51,27,12,5,1,0,290
580350418,137,84,49,19,8,2,0,0,299
580350419,79,132,77,53,18,3,2,0,364
580350420,49,95,64,60,17,6,0,1,292
580350421,28,53,44,44,20,4,0,1,194
580350501,99,76,29,9,6,1,0,0,220
580350502,62,85,57,34,11,6,1,0,256
580350503,94,107,73,38,14,7,2,2,337
580350504,108,63,18,6,0,0,0,0,195
580350505,82,66,37,20,6,1,0,0,212
580350506,92,89,36,29,4,2,0,0,252
580350507,74,63,39,13,6,1,0,0,196
580350508,58,71,28,12,8,0,0,0,177
580350509,108,89,34,14,6,1,1,0,253
580350510,121,88,44,23,5,1,0,0,282
580350511,114,94,57,22,10,4,1,0,302
580350512,40,36,32,9,2,0,0,0,119
580350513,84,96,48,20,12,1,1,0,262
580350514,73,79,27,12,2,1,0,0,194
580350515,100,61,30,9,2,0,0,0,202
580350516,126,109,52,28,4,2,0,1,322
580350517,77,90,23,13,2,1,0,0,206
580350518,50,48,17,12,5,0,0,1,133
580350519,41,41,36,21,6,0,3,0,148
580350520,33,40,26,17,2,5,0,1,124
580350521,61,62,34,22,10,2,1,0,192
580350522,60,74,37,29,8,0,0,1,209
580350523,67,67,28,20,3,4,1,0,190
580350601,76,100,95,70,31,6,3,2,383
580350602,85,75,35,19,6,2,1,1,224
580350603,44,73,51,23,10,5,1,1,208
580350604,60,78,40,28,13,4,0,0,223
580350605,69,82,59,31,14,6,2,0,263
580350606,28,28,44,48,15,11,6,2,182
580350607,30,46,40,39,21,15,7,7,205
580350608,81,115,99,38,28,14,0,3,378
580350609,76,82,65,53,12,8,0,0,296
580350610,53,62,50,44,8,1,5,0,223
580350611,54,80,44,32,16,5,2,0,233
580350612,88,94,53,27,8,3,2,0,275
580350613,134,85,48,24,8,1,1,0,301
580350614,93,95,55,27,8,3,1,3,285
580350615,92,81,39,16,4,6,0,0,238
580350616,64,59,33,26,7,2,1,1,193
580350617,81,74,40,27,9,5,2,1,239
580350618,46,35,10,4,2,1,0,0,98
580350701,15,14,12,9,4,1,0,0,55
580350702,27,44,42,27,19,6,1,1,167
580350703,69,93,72,63,23,3,0,0,323
580350704,52,79,92,97,46,28,9,6,409
580350705,28,38,60,55,37,30,6,11,265
580350706,45,56,75,60,44,35,11,7,333
580350707,43,53,63,69,37,32,4,9,310
580350708,60,73,86,73,51,24,16,12,395
580350709,56,61,76,58,37,24,10,7,329
580350710,48,67,55,67,40,20,9,8,314
580350711,45,59,86,72,53,29,10,7,361
580350712,50,99,81,75,55,19,14,8,401
580350713,31,50,56,43,31,18,7,8,244
580350714,40,49,60,43,36,12,6,5,251
580350715,20,29,49,52,52,25,9,11,247
580350801,28,42,53,44,16,14,3,2,202
580350802,67,84,118,101,60,32,10,8,480
580350803,45,71,95,78,53,27,10,7,386
580350804,20,43,50,51,26,22,5,2,219
580350805,22,32,27,27,8,3,0,0,119
580350806,43,48,76,66,47,23,8,16,327
580350807,34,42,51,61,52,37,11,12,300
580350808,46,50,46,45,18,4,3,3,215
580350809,40,69,74,61,36,18,3,5,306
580350810,45,71,68,71,43,27,11,14,350
580350811,56,72,86,60,43,19,7,5,348
580350812,25,61,70,36,33,5,3,6,239
580350813,24,45,54,45,45,23,5,5,246
580350814,45,51,83,75,64,42,12,16,388
580350815,47,52,79,52,40,23,1,2,296
580350816,44,55,90,102,39,27,14,7,378
580350817,26,48,60,71,44,28,5,2,284
580350818,12,27,44,56,27,9,2,3,180
580350819,15,31,46,59,51,14,3,0,219
580350820,39,58,67,60,31,16,2,4,277
580350821,19,34,30,45,34,14,13,5,194
580350822,22,49,62,83,67,45,19,16,363
580350823,23,43,52,56,52,31,14,10,281
580350824,17,19,55,51,25,10,2,3,182
580350825,17,35,44,65,29,19,11,8,228
580350826,16,20,49,51,36,29,13,4,218
580350901,29,24,51,43,27,19,9,9,211
580350902,13,54,57,58,47,24,8,9,270
580350903,42,58,69,91,39,17,17,5,338
580350904,38,68,76,59,56,32,14,16,359
580350905,16,23,39,38,39,24,10,11,200
580350906,20,35,53,62,45,30,6,9,260
580350907,27,76,85,82,39,16,10,4,339
580350908,45,60,67,73,39,17,13,9,323
580350909,29,68,79,82,40,24,9,6,337
580350910,28,57,69,73,46,16,8,6,303
580350911,29,51,71,68,41,23,11,7,301
580350912,27,58,56,52,42,24,14,12,285
580350913,42,56,73,77,53,37,16,20,374
580350914,32,60,78,67,44,20,11,9,321
580350915,23,42,69,36,43,28,3,3,247
580350916,39,60,52,58,34,22,13,6,284
580350917,47,63,69,58,39,23,9,15,323
580350918,13,42,59,65,57,34,5,10,285
580351001,10,22,42,51,34,18,0,1,178
580351002,57,58,57,50,40,20,10,4,296
580351003,35,77,49,43,24,6,2,2,238
580351004,61,79,76,45,22,8,3,0,294
580351005,78,79,102,53,43,24,9,8,396
580351006,60,109,101,80,52,21,9,2,434
580351007,42,63,60,52,20,9,0,1,247
580351008,32,80,68,49,20,22,3,3,277
580351009,57,59,85,65,28,15,3,2,314
580351010,14,29,45,41,21,5,3,2,160
580351011,50,63,60,50,27,12,2,1,265
580351012,28,62,68,51,48,23,8,11,299
580351013,44,105,131,145,50,27,5,5,512
580351014,14,34,50,65,22,8,3,1,197
580351015,25,56,62,73,33,16,7,4,276
580351016,26,52,52,65,26,8,1,4,234
580351017,35,80,52,58,26,4,0,1,256
580351018,23,37,33,30,14,8,3,2,150
580351101,43,48,67,48,30,10,5,3,254
580351102,46,75,57,46,19,11,2,2,258
580351103,68,91,91,67,54,22,4,12,409
580351104,92,115,104,78,48,9,5,1,452
580351105,53,72,57,40,18,4,1,1,246
580351106,89,84,77,64,37,15,5,3,374
580351107,75,103,97,87,27,15,3,1,408
580351108,41,54,61,57,19,5,1,0,238
580351109,12,24,21,24,14,7,1,0,103
580351110,45,70,39,58,19,9,1,2,243
580351111,0,0,0,0,0,0,0,0,0
580351112,59,82,84,71,31,14,6,6,353
580351113,39,54,75,62,32,26,9,12,309
580351114,32,41,51,49,29,22,11,11,246
580351115,9,27,34,63,51,35,15,8,242
580351116,23,39,38,42,30,4,0,1,177
580351117,36,57,71,84,70,34,16,18,386
580351118,14,36,41,85,35,6,4,1,222
580351119,30,45,57,50,24,11,1,0,218
580351120,53,47,36,29,20,10,5,2,202
580351121,35,57,60,71,32,4,2,1,262
580351122,18,50,61,64,43,18,0,1,255
580351123,12,41,47,54,28,11,4,1,198
580351124,4,11,26,36,16,7,7,4,111
580351125,23,27,32,53,23,5,1,0,164
580351126,24,25,37,45,16,12,1,3,163
580351201,123,121,51,37,14,2,1,4,353
580351202,55,51,36,18,3,4,0,0,167
580351203,54,64,37,38,19,8,2,1,223
580351204,85,89,84,68,36,18,8,8,396
580351205,63,107,101,78,52,12,11,9,433
580351206,45,79,53,47,18,7,2,6,257
580351207,23,46,49,48,20,12,2,5,205
580351208,69,61,54,42,20,11,3,2,262
580351209,70,92,79,58,38,8,1,3,349
580351210,60,60,39,51,22,12,3,1,248
580351211,42,41,30,32,16,6,0,4,171
580351212,70,77,38,38,13,8,3,2,249
580351213,86,76,47,39,17,6,3,3,277
580351214,50,64,63,35,22,9,3,1,247
580351215,73,88,74,59,31,8,2,1,336
580351216,38,67,67,39,36,12,1,3,263
580351301,76,75,55,26,13,6,2,0,253
580351302,57,51,23,13,5,3,0,1,153
580351303,50,41,14,10,4,1,0,0,120
580351304,42,47,31,19,10,2,0,1,152
580351305,52,45,47,15,7,3,0,0,169
580351306,71,89,59,43,19,5,2,1,289
580351307,98,99,38,31,11,12,2,2,293
580351308,61,67,33,26,12,3,3,0,205
580351309,88,87,60,59,20,5,1,3,323
580351310,77,84,83,71,29,15,6,8,373
580351311,67,75,40,46,20,6,3,2,259
580351312,85,79,65,42,27,15,1,2,316
580351313,92,103,86,65,35,16,8,2,407
580351314,73,74,52,35,16,11,5,4,270
580351315,98,104,74,50,22,16,4,5,373
580351316,54,90,66,79,16,9,2,1,317
580351401,29,59,35,35,14,7,4,3,186
580351402,16,14,9,14,4,2,1,1,61
580351403,43,68,59,59,39,22,4,8,302
580351404,65,55,65,64,20,13,6,10,298
580351405,71,74,64,47,24,9,3,3,295
580351406,69,62,34,21,10,4,0,0,200
580351407,100,98,67,40,26,10,5,5,351
580351408,93,94,72,52,24,9,5,1,350
580351409,63,77,83,43,27,15,1,2,311
580351410,40,71,98,89,54,23,3,2,380
580351411,42,70,76,79,77,32,15,27,418
580351412,61,74,73,80,36,17,0,2,343
580351413,80,113,92,88,26,8,5,3,415
580351414,64,102,93,91,51,11,4,3,419
580351415,12,18,40,35,33,15,7,6,166
580351416,20,28,24,48,19,2,1,1,143
580351417,43,46,67,67,40,28,8,6,305
580351418,37,74,71,95,54,31,9,8,379
580351419,38,66,76,66,48,18,3,2,317
580351420,9,12,9,12,3,3,0,0,48
580351421,20,32,45,46,29,18,2,6,198
580351422,28,62,58,56,22,6,3,1,236
580351501,90,108,96,59,39,8,8,6,414
580351502,88,60,51,38,15,5,3,0,260
580351503,64,94,85,73,27,10,2,0,355
580351504,51,70,62,46,22,13,5,3,272
580351505,73,103,116,77,37,18,7,4,435
580351506,67,108,78,78,46,16,6,5,404
580351507,64,70,87,70,35,25,4,2,357
580351508,34,59,82,75,32,10,1,1,294
580351509,50,67,75,70,34,11,6,0,313
580351510,70,68,86,79,41,16,3,7,370
580351511,66,70,76,61,40,20,5,1,339
580351512,30,59,46,65,16,17,2,2,237
580351513,61,69,58,57,23,15,1,3,287
580351514,37,69,59,80,40,12,3,1,301
580351515,26,34,48,43,31,8,0,0,190
580351601,33,43,30,28,19,14,6,6,179
580351602,36,48,51,51,29,17,10,6,248
580351603,12,12,11,18,6,3,2,1,65
580351604,28,37,30,32,26,11,3,3,170
580351605,38,41,48,54,34,19,11,12,257
580351606,34,35,45,43,16,10,4,1,188
580351607,17,8,21,26,16,8,2,5,103
580351608,31,31,36,35,14,6,2,0,155
580351609,34,36,41,27,10,6,4,1,159
580351610,22,44,48,48,22,19,6,3,212
580351611,37,31,71,52,37,23,14,6,271
580351612,23,23,42,50,37,24,9,8,216
580351613,42,34,51,30,16,12,4,4,193
580351614,20,27,25,36,20,8,1,1,138
580351615,34,37,49,41,18,6,4,3,192
580351616,27,57,62,82,60,37,11,8,344
580351617,16,13,13,8,2,2,0,0,54
580351618,10,13,7,10,10,6,0,4,60
580351619,23,28,32,24,14,9,2,0,132
580351620,13,13,24,13,9,3,0,1,76
580351701,90,103,45,57,22,10,3,1,331
580351702,69,77,58,51,11,4,2,0,272
580351703,48,47,22,22,14,4,0,0,157
580351704,55,76,67,61,37,5,0,2,303
580351705,13,24,29,18,11,3,2,3,103
580351706,40,70,40,38,25,6,3,1,223
580351707,96,93,78,67,20,9,4,7,374
580351708,94,101,79,69,28,20,4,3,398
580351709,58,81,81,70,42,21,9,4,366
580351710,52,93,84,68,36,16,5,4,358
580351711,83,112,92,77,36,13,6,5,424
580351801,2,2,0,0,0,0,0,0,4
580351802,39,56,54,74,25,19,5,3,275
580351803,58,49,59,66,28,10,1,4,275
580351804,26,42,44,36,19,7,5,1,180
580351805,10,38,75,92,31,17,5,7,275
580351806,33,40,61,47,21,5,4,3,214
580351807,53,82,90,57,26,13,4,5,330
580351808,44,80,64,56,26,12,5,5,292
580351809,51,81,97,59,26,16,2,1,333
580351810,82,97,76,58,32,9,1,4,359
580351811,33,50,53,64,42,28,5,11,286
580351812,73,82,78,84,44,23,7,8,399
580351813,25,40,61,62,38,15,3,9,253
580351814,39,30,29,16,11,5,9,3,142
580351815,34,53,56,55,31,26,6,8,269
580351816,24,38,50,71,47,15,7,1,253
580351817,33,41,48,35,22,19,7,4,209
580351818,28,71,74,64,27,6,1,2,273
580351819,27,42,50,40,13,9,4,0,185
580351820,25,29,42,36,31,21,7,6,197
580351821,30,46,56,67,23,9,3,7,241
580351822,24,42,49,40,32,10,1,2,200
580351823,4,17,52,70,33,19,9,1,205
580351824,34,45,67,77,19,7,2,2,253
580351825,28,48,51,62,30,12,5,2,238
580351826,16,33,50,53,51,14,9,9,235
580351901,45,65,36,31,13,14,2,4,210
580351902,35,82,73,57,39,16,5,8,315
580351903,36,50,64,53,29,17,8,2,259
580351904,59,73,86,53,33,10,4,3,321
580351905,59,81,92,66,38,13,3,5,357
580351906,71,84,68,59,32,12,3,1,330
580351907,63,87,82,51,25,5,1,2,316
580351908,48,84,77,102,33,14,5,3,366
580351909,20,54,71,72,55,30,4,8,314
580351910,43,47,43,47,28,22,3,9,242
580351911,56,54,77,102,42,23,13,3,370
580351912,17,28,28,25,8,2,0,1,109
580351913,17,21,25,58,31,13,11,6,182
580351914,34,41,43,30,21,4,3,4,180
580352001,31,24,23,19,15,2,0,2,116
580352002,28,47,40,42,33,14,1,1,206
580352003,19,7,12,7,4,1,1,1,52
580352004,22,22,18,15,16,7,1,0,101
580352005,4,2,5,4,4,1,0,0,20
580352006,49,30,15,10,8,2,2,1,117
580352007,74,82,70,74,61,40,13,8,422
580352008,71,84,108,83,54,24,7,7,438
580352009,38,48,46,51,31,16,9,2,241
580352010,44,54,66,55,43,22,6,6,296
580352011,27,54,57,64,41,28,11,7,289
580352012,20,50,81,86,81,43,18,19,398
580352101,29,21,18,16,13,3,8,4,112
580352102,27,64,77,61,30,20,7,8,294
580352103,44,73,51,49,24,26,7,0,274
580352104,49,78,71,88,41,15,7,6,355
580352105,78,54,67,39,22,11,4,2,277
580352106,69,74,67,48,21,7,1,3,290
580352107,76,90,83,58,28,6,3,2,346
580352108,26,41,63,69,34,24,6,8,271
580352109,21,40,62,69,31,20,9,6,258
580352110,36,50,89,58,48,10,8,9,308
580352111,35,39,61,53,48,22,4,9,271
580352112,16,42,50,52,27,12,2,0,201
580352113,26,33,21,34,14,6,2,3,139
580352114,28,54,52,60,36,20,3,3,256
580352115,21,30,45,45,33,3,5,3,185
580352116,16,30,43,54,26,12,6,8,195
580352201,51,44,36,25,11,11,3,3,184
580352202,16,27,42,57,34,12,6,4,198
580352203,7,7,6,5,7,2,0,1,35
580352204,1,3,2,3,3,2,1,0,15
580352205,35,33,45,78,38,29,9,12,279
580352206,39,57,71,64,32,15,3,5,286
580352207,52,67,52,42,31,21,6,1,272
580352208,41,60,75,58,49,19,8,3,313
580352209,59,73,57,42,23,17,6,0,277
580352210,41,70,55,48,30,9,4,5,262
580352211,50,69,86,77,57,31,7,7,384
580352212,13,18,39,25,14,15,3,6,133
580352213,21,46,43,53,36,17,9,7,232
580352214,59,67,52,56,29,13,5,5,286
580352215,45,57,38,26,10,6,2,3,187
580352216,30,39,42,27,19,14,3,3,177
580352217,42,61,77,66,50,32,9,13,350
580352218,10,21,18,24,24,10,3,11,121
580352219,33,55,71,56,32,30,12,9,298
580352220,32,37,54,59,31,26,5,6,250
580352221,14,28,32,55,53,24,5,5,216
580352301,14,7,10,10,7,7,0,0,55
580352302,32,45,74,70,35,14,4,3,277
580352303,28,42,50,56,15,15,4,3,213
580352304,71,86,59,39,29,7,2,1,294
580352305,77,63,52,26,16,6,3,2,245
580352306,46,40,29,27,17,4,0,0,163
580352307,61,87,73,50,15,10,1,0,297
580352308,52,86,81,50,20,4,3,2,298
580352309,69,91,74,59,33,14,6,1,347
580352310,60,64,55,41,24,12,6,2,264
580352311,55,94,71,61,25,4,5,3,318
580352312,71,76,50,65,20,6,3,4,295
580352313,49,62,81,58,28,15,1,1,295
580352314,34,61,59,62,26,20,3,2,267
580352315,24,49,45,48,20,15,3,6,210
580352316,28,48,47,47,31,18,4,3,226
580352317,30,49,56,60,36,14,6,6,257
580352318,18,34,37,49,22,6,2,3,171
580352319,31,63,80,73,54,14,16,3,334
580352320,17,35,56,55,29,5,0,2,199
580352321,11,20,39,42,29,16,9,2,168
580352322,6,1,1,1,0,0,0,0,9
580352323,11,21,33,52,36,17,10,9,189
580352324,16,25,49,62,32,10,3,1,198
580352325,40,56,63,57,21,7,0,0,244
580352326,29,40,59,55,26,12,1,2,224
580352327,15,20,33,49,23,16,9,6,171
580352401,22,26,50,68,39,22,7,8,242
580352402,25,24,47,51,44,25,12,9,237
580352403,42,69,72,90,72,58,24,17,444
580352404,29,36,62,94,60,49,16,16,362
580352405,26,33,35,51,46,30,15,14,250
580352406,40,34,49,49,39,30,6,9,256
580352407,47,60,59,59,36,19,4,3,287
580352408,41,50,64,55,38,18,13,8,287
580352409,42,40,55,57,30,18,4,5,251
580352410,20,39,45,71,49,28,10,19,281
580352411,38,75,87,96,45,39,8,3,391
580352412,22,57,76,68,41,30,7,14,315
580352413,14,19,48,55,43,18,4,7,208
580352414,23,31,38,54,34,9,5,2,196
580352501,36,32,71,98,57,31,7,13,345
580352502,30,46,66,89,49,25,5,14,324
580352503,34,51,68,92,46,30,12,4,337
580352504,27,47,45,55,32,12,1,4,223
580352505,21,31,39,51,25,6,0,1,174
580352506,30,24,39,28,24,9,7,5,166
580352507,24,47,48,38,21,18,9,10,215
580352508,34,40,47,30,17,5,2,3,178
580352509,23,53,54,34,22,10,8,1,205
580352510,32,43,65,65,43,15,9,7,279
580352511,28,35,51,52,42,19,3,4,234
580352512,25,28,46,61,38,28,7,8,241
580352513,26,50,47,62,47,25,11,12,280
580352514,28,40,57,65,50,33,17,15,305
580352515,26,59,57,63,30,16,9,4,264
580352516,24,51,53,79,40,20,7,3,277
580352517,48,58,67,65,51,25,11,7,332
580420101,18,20,15,18,15,0,3,3,92
580420102,17,19,18,11,2,1,1,0,69
580420103,9,15,15,19,11,4,1,1,75
580420104,14,17,11,10,6,1,2,1,62
580420105,14,28,19,28,14,2,1,1,107
580420106,31,41,34,19,10,7,2,1,145
580420107,10,9,9,3,2,1,0,1,35
580420108,14,7,15,8,0,1,1,0,46
580420109,9,10,10,14,7,4,0,1,55
580420201,66,38,40,53,22,9,1,0,229
580420202,18,34,50,50,30,19,8,9,218
580420203,20,29,52,63,24,11,9,6,214
580420204,35,30,38,37,20,5,7,5,177
580420205,39,48,48,52,11,7,2,9,216
580420206,48,54,55,47,23,12,2,2,243
580420207,64,73,57,46,20,9,4,3,276
580420208,65,56,67,49,20,15,2,3,277
580420209,42,35,50,30,21,8,6,0,192
580420210,19,43,52,40,22,6,1,2,185
580420211,20,28,71,84,49,29,12,6,299
580420212,32,40,56,38,19,9,2,9,205
580420213,28,32,42,38,18,16,4,5,183
580420214,34,60,70,67,26,19,2,2,280
580420215,46,55,71,29,17,10,3,1,232
580420216,42,40,50,25,27,6,4,2,196
580420217,15,42,51,76,53,30,16,9,292
580490101,1,2,1,0,0,0,0,0,4
580490102,21,11,6,5,3,3,2,1,52
580490103,1,5,2,1,0,1,0,0,10
580490201,2,2,3,1,3,1,0,4,16
580490202,17,14,15,23,20,19,6,7,121
580490203,18,12,12,13,6,3,2,2,68
580490204,7,12,8,15,12,11,4,2,71
580490205,17,22,16,20,15,10,1,2,103
580490301,28,15,14,9,5,3,1,2,77
580490302,13,6,3,2,1,0,0,0,25
580490401,51,54,59,77,22,13,4,1,281
580490402,7,12,30,37,21,8,4,3,122
580490403,12,40,56,70,40,27,8,8,261
580490404,65,89,68,60,18,11,2,1,314
580490405,36,50,45,28,19,9,2,2,191
580490406,22,36,40,58,26,13,10,3,208
580490407,76,87,112,92,43,32,8,12,462
580490408,59,66,47,50,32,13,10,6,283
580490409,72,55,58,48,16,13,3,4,269
580490410,35,47,45,41,24,3,1,2,198
580490411,31,32,44,48,28,13,7,12,215
580490412,11,35,45,47,15,17,10,9,189
580490413,30,39,62,58,51,26,11,9,286
580490414,29,39,57,47,19,8,5,7,211
580490415,27,34,51,46,14,10,2,1,185
580560101,17,4,13,13,14,6,3,2,72
580560102,6,3,2,0,0,1,0,0,12
580560104,4,0,2,0,2,0,0,0,8
580560105,32,26,24,16,13,5,1,4,121
580560201,7,10,6,0,7,0,1,1,32
580560202,2,8,1,3,2,1,0,0,17
580560203,7,2,2,1,0,0,0,0,12
580560204,1,3,1,3,0,0,0,0,8
580560205,0,7,2,1,0,1,0,0,11
580560206,9,9,4,4,1,0,0,0,27
580560301,32,53,36,32,20,11,2,1,187
580560302,36,45,62,66,41,23,9,10,292
580560303,29,56,61,65,33,18,16,5,283
580560304,34,59,62,53,39,15,7,14,283
580560305,43,102,67,74,32,15,3,8,344
580560306,40,64,83,72,38,14,7,6,324
580560307,45,49,48,40,19,9,2,3,215
580560308,64,84,86,67,45,31,5,5,387
580560309,64,68,44,21,7,5,1,1,211
580560310,10,17,30,28,15,7,4,3,114
580560401,31,60,47,39,29,7,0,2,215
580560402,16,34,31,59,32,18,8,6,204
580560403,42,75,70,60,17,9,0,1,274
580560404,37,64,49,47,10,3,0,1,211
580560405,78,94,111,103,51,20,6,8,471
580560406,28,65,63,78,34,13,2,3,286
580560407,54,73,93,112,46,27,9,6,420
580560408,8,26,44,56,41,31,9,11,226
580560409,28,57,38,48,12,9,1,4,197
580560410,31,37,41,32,19,5,0,1,166
580560411,16,21,10,10,7,5,0,0,69
580560501,1,3,10,1,1,1,0,0,17
580560502,28,48,31,31,11,5,1,1,156
580560503,14,25,22,24,11,4,1,0,101
580560504,67,37,29,27,9,3,2,0,174
580560505,57,81,74,67,38,25,6,5,353
580560506,61,71,54,53,27,24,5,3,298
580560507,54,62,83,71,50,28,10,8,366
580560508,49,57,50,44,26,32,7,3,268
580560509,59,90,80,45,21,7,3,4,309
580560510,64,62,45,24,9,2,1,0,207
580560511,59,72,43,35,11,3,2,1,226
580560512,64,51,40,28,15,5,0,3,206
580560513,34,48,31,18,8,0,0,0,139
580560514,31,31,28,13,9,1,0,0,113
580560515,46,57,35,23,10,2,1,0,174
580560516,96,63,25,15,8,1,0,0,208
580560517,42,39,29,21,5,3,0,2,141
580630101,13,11,7,5,4,1,1,1,43
580630102,16,15,15,7,7,13,1,2,76
580630103,7,5,4,7,0,3,0,0,26
580630104,16,18,32,29,27,15,7,3,147
580630105,10,9,13,16,11,16,3,14,92
580630106,6,3,1,0,0,1,0,0,11
580630107,1,2,3,1,4,2,0,1,14
580630108,14,4,7,8,0,1,1,0,35
580630109,19,16,18,16,11,6,1,4,91
580630110,11,8,7,7,6,2,1,0,42
580630111,83,132,121,113,73,36,10,16,584
580630112,88,106,108,106,45,32,12,9,506
580630113,43,43,70,83,49,23,13,9,333
580700101,1,5,4,1,2,0,0,0,13
580700102,6,13,6,5,2,0,0,0,32
580700103,71,91,70,62,19,7,3,2,325
580700104,40,55,39,42,19,4,1,0,200
580700105,90,113,120,71,48,7,4,3,456
580700106,81,72,51,39,24,4,2,0,273
580700107,61,72,92,102,62,34,6,5,434
580700108,32,50,47,52,14,3,1,0,199
580700109,28,43,49,36,21,11,3,3,194
580700110,39,50,39,30,14,2,1,0,175
580700111,51,62,74,70,32,17,4,3,313
580700112,42,31,39,35,11,5,1,0,164
580700113,71,84,69,66,26,11,3,4,334
580700114,34,53,73,68,36,19,7,5,295
580700201,13,10,6,0,3,0,1,1,34
580700202,38,13,7,5,1,1,0,0,65
580700203,3,5,3,1,3,0,0,0,15
580700204,21,17,25,23,11,3,2,0,102
580770101,0,0,0,0,0,0,0,0,0
580770102,35,33,24,37,14,9,1,1,154
580770103,45,36,36,34,20,13,4,2,190
580770104,18,31,22,15,7,8,2,1,104
580770105,45,33,28,31,19,7,0,2,165
580770106,38,37,48,58,38,13,1,4,237
580770201,31,24,24,26,19,7,0,4,135
580770202,6,1,7,14,8,3,3,3,45
580770203,10,15,11,17,16,7,2,1,79
580770204,15,18,23,10,9,4,1,1,81
580770205,40,40,59,42,22,13,6,4,226
580770206,21,19,22,16,6,3,2,3,92
580770207,35,43,48,52,27,7,5,3,220
580770208,58,65,79,84,51,18,10,11,376
580770210,17,14,23,14,12,6,4,1,91
580840101,7,5,2,1,0,0,0,0,15
580840102,29,42,43,41,31,13,4,3,206
580840103,16,21,22,14,8,4,2,0,87
580840104,12,16,6,3,2,1,0,0,40
580840105,19,14,29,25,23,11,4,8,133
580840106,39,45,60,51,27,16,5,9,252
580840107,26,24,11,12,10,0,2,3,88
580840108,26,23,22,20,10,7,0,3,111
580840109,11,23,25,18,11,9,1,2,100
580840110,11,5,1,0,0,0,1,0,18
580840111,7,14,18,27,14,18,6,6,110
580840112,3,7,7,3,0,0,0,0,20
580840113,1,0,0,1,1,0,0,0,3
580840114,8,4,2,2,1,0,0,0,17
580840115,0,0,0,0,0,0,0,0,0
580840116,43,39,24,37,26,9,1,1,180
580910101,3,6,6,3,4,0,0,0,22
580910102,21,11,16,14,5,2,1,4,74
580910103,39,55,47,51,31,7,8,4,242
580910104,8,7,3,4,2,1,0,1,26
580910105,6,3,1,2,0,0,0,0,12
580910106,26,24,23,24,14,7,5,4,127
580910107,89,84,100,77,45,24,9,8,436
580910108,56,41,74,68,45,18,6,4,312
580910109,24,12,5,5,5,3,0,1,55
580910201,5,4,1,0,0,0,0,0,10
580910202,5,3,4,1,0,0,0,0,13
580910203,6,5,2,0,0,1,0,0,14
580910204,4,2,3,0,0,0,0,0,9
580910205,9,12,8,8,5,0,1,3,46
580910301,7,9,3,1,2,2,1,0,25
580910302,32,34,31,16,24,5,2,3,147
580910303,74,39,54,55,33,15,5,6,281
580910304,74,84,82,104,43,20,1,1,409
580910305,75,56,59,47,28,14,0,4,283
580910306,71,45,39,21,18,9,0,2,205
580910307,56,35,27,14,7,8,0,0,147
580910308,67,37,41,25,15,9,1,2,197
580910309,35,40,45,41,18,7,7,3,196
580910310,41,33,27,29,22,9,1,3,165
580910311,44,46,65,58,34,19,14,6,286
580910312,30,32,34,30,27,9,5,3,170
580910313,42,29,37,36,22,5,2,3,176
580910314,51,37,40,24,11,10,1,4,178
580910315,43,31,40,20,10,10,4,1,159
580910316,25,23,29,29,12,9,4,2,133
580910317,47,41,50,45,25,17,2,2,229
580910318,54,50,58,63,41,23,13,2,304
580910319,50,39,45,64,29,19,1,3,250
580910320,34,35,41,54,43,13,8,4,232
580910321,15,41,49,74,25,18,10,2,234
580910322,41,37,48,55,41,18,4,1,245
580910323,27,39,52,64,37,24,7,3,253
580910324,27,40,67,63,48,26,6,9,286
580910325,39,30,36,59,28,20,3,1,216
580910326,21,24,34,51,20,8,1,1,160
580910327,23,36,70,61,22,17,2,1,232
580980101,34,22,16,14,4,6,0,0,96
580980102,2,0,0,0,1,0,0,0,3
580980103,98,101,96,77,47,29,8,10,466
580980104,55,69,106,103,68,34,15,11,461
580980105,31,17,18,9,9,5,3,1,93
580980201,18,7,3,4,2,1,0,1,36
580980202,41,30,30,24,13,10,2,1,151
580980203,10,6,2,2,0,0,0,0,20
580980204,20,27,11,6,2,2,0,1,69
580980205,12,14,14,14,6,3,3,0,66
581050101,11,11,7,6,7,2,4,1,49
581050102,16,30,28,23,19,5,4,3,128
581050103,25,33,36,48,26,19,15,13,215
581050104,61,63,69,63,29,14,2,7,308
581050105,33,54,43,37,31,25,6,7,236
581050106,51,66,102,104,61,33,13,24,454
581050201,1,1,2,0,0,0,0,0,4
581050202,6,1,3,3,0,1,0,0,14
581050203,6,2,2,0,1,1,0,0,12
581050204,5,5,13,15,15,3,0,2,58
581050205,13,5,2,1,1,2,1,0,25
581050206,3,2,3,2,1,0,0,0,11
581050207,15,17,16,4,4,1,0,1,58
581050208,6,4,2,4,1,2,1,0,20
581050209,17,14,12,10,4,2,3,1,63
581050210,12,9,4,2,4,2,0,1,34
581050211,21,35,40,49,40,18,6,4,213
581050212,12,12,3,0,0,1,0,0,28
581050213,7,4,6,4,4,2,2,0,29
581050214,5,4,1,5,1,2,1,1,20
581120101,28,33,10,16,8,2,2,1,100
581120102,8,5,5,2,1,1,0,1,23
581120103,7,16,20,39,13,3,0,0,98
581120104,7,5,3,6,2,3,3,1,30
581120105,25,15,11,11,6,2,0,0,70
581120106,3,6,6,5,3,1,0,1,25
581120107,1,2,2,7,4,6,3,0,25
581120108,8,11,7,3,0,1,1,1,32
581120109,8,5,10,7,3,2,2,1,38
581120201,21,16,17,11,7,1,0,4,77
581120202,13,15,16,17,18,8,6,2,95
581120203,14,12,9,2,2,0,0,0,39
581120205,33,28,49,44,27,15,7,4,207
581120206,17,46,52,43,35,13,2,6,214
581120207,9,18,19,26,14,3,1,0,90
581120208,35,32,49,47,25,19,8,9,224
581120301,14,14,22,30,26,13,6,2,127
581120302,37,54,75,86,56,26,14,22,370
581120303,51,51,73,87,60,47,16,17,402
581120304,35,55,79,85,55,41,11,14,375
581120305,43,53,62,81,40,28,12,14,333
581120306,31,51,52,48,33,23,7,7,252
581120307,35,59,55,87,55,24,10,6,331
581120308,31,54,64,46,47,41,22,27,332
581120309,48,57,57,65,40,20,1,6,294
581120310,39,82,63,69,38,24,8,7,330
581120311,28,48,66,42,26,15,9,5,239
581120312,76,90,63,37,26,4,4,3,303
581120313,60,72,42,36,12,7,3,1,233
581120314,35,73,44,65,26,10,3,1,257
581120315,40,45,26,20,9,5,0,0,145
581120316,52,48,53,45,21,7,1,1,228
581120401,31,28,34,42,21,14,2,3,175
581120402,23,31,57,71,36,17,7,4,246
581120403,5,2,9,3,1,0,1,1,22
581120404,30,70,66,79,43,34,13,10,345
581120405,42,61,60,40,28,16,6,8,261
581120406,35,55,30,20,21,10,1,4,176
581120407,44,52,48,31,19,12,1,0,207
581120408,97,95,82,53,28,10,5,1,371
581120409,47,40,31,21,9,6,1,0,155
581120410,38,57,33,28,15,6,4,0,181
581120411,52,44,41,29,19,8,1,4,198
581120412,34,47,42,35,25,9,1,6,199
581120413,63,66,71,73,42,23,10,10,358
581120414,16,29,20,17,18,10,1,3,114
581120415,57,60,65,61,35,16,7,12,313
581120416,21,36,29,26,11,3,4,0,130
581120417,5,4,3,2,1,2,0,0,17
581120418,30,55,92,110,78,37,9,2,413
581120419,12,25,62,82,46,26,4,10,267
581120420,67,79,58,60,29,8,5,1,307
581120421,38,53,72,93,43,26,11,6,342
620070101,5,6,3,3,0,0,0,0,17
620070201,25,7,3,0,2,1,0,0,38
620070301,10,8,3,2,0,0,0,0,23
620070302,45,51,34,31,9,7,5,1,183
620070303,23,23,29,26,6,7,2,0,116
620070401,23,7,2,1,0,0,0,0,33
620070501,30,42,52,33,25,5,0,4,191
620070502,37,44,23,26,12,9,5,1,157
620070503,46,64,60,60,29,9,3,4,275
620070504,38,51,43,23,7,1,0,0,163
620070505,48,66,33,26,8,1,0,0,182
620070506,71,80,30,21,10,2,0,0,214
620070507,86,78,37,20,11,3,0,0,235
620070508,43,69,37,27,10,4,1,0,191
620070509,42,49,29,32,12,1,0,1,166
620070510,100,119,69,57,13,7,6,2,373
620070511,80,88,36,20,11,3,0,3,241
620070601,35,19,12,7,9,5,0,0,87
620070602,60,59,50,35,32,9,2,6,253
620070603,43,44,41,29,23,11,8,5,204
620070604,42,33,17,14,7,4,0,0,117
620070605,4,0,1,1,0,0,0,0,6
620070606,17,15,10,5,1,1,1,1,51
620070607,23,24,29,22,26,9,4,8,145
620070608,30,67,85,80,57,28,14,7,368
620070609,50,58,70,71,46,19,9,2,325
620070610,19,17,42,60,43,22,3,4,210
620070611,18,18,44,37,24,19,0,4,164
620070612,33,60,64,71,49,22,5,4,308
620070613,14,13,35,27,12,8,0,1,110
620070614,18,22,30,29,22,9,1,2,133
620070701,42,52,39,43,9,4,3,2,194
620070702,49,69,53,41,17,7,2,2,240
620070703,35,60,45,20,20,7,6,5,198
620070704,55,77,70,52,29,22,11,14,330
620070705,56,91,62,56,34,17,13,10,339
620070706,39,50,41,35,16,16,6,7,210
620070707,37,83,93,94,37,35,11,13,403
620070708,68,97,102,67,52,33,11,10,440
620070709,20,36,28,24,17,9,1,2,137
620070710,14,11,9,9,8,3,2,1,57
620070711,104,154,133,117,90,39,13,8,658
620070712,22,50,44,48,33,15,6,7,225
620070713,25,41,45,60,44,26,4,4,249
620070801,38,53,32,39,9,3,0,0,174
620070802,26,41,24,28,7,10,0,3,139
620070803,10,6,8,7,1,0,0,0,32
620070804,47,37,60,66,36,19,2,12,279
620070805,41,62,66,66,36,31,12,8,322
620070806,32,51,78,76,55,30,14,11,347
620070807,15,46,31,42,22,19,6,4,185
620070808,23,44,45,43,31,16,3,2,207
620070809,32,67,41,22,11,2,1,0,176
620070810,68,63,81,57,26,7,4,3,309
620070811,28,58,57,58,28,13,7,9,258
620070812,30,47,28,25,21,8,4,4,167
620070813,32,71,42,59,13,4,1,1,223
620070814,30,45,48,49,11,4,1,0,188
620070815,29,44,35,33,12,5,4,0,162
620070816,33,42,33,30,10,6,1,0,155
620070817,29,51,32,29,10,3,0,0,154
620070818,33,26,37,30,10,10,3,5,154
620070901,7,8,4,5,1,0,0,0,25
620070902,12,33,8,9,11,4,1,0,78
620070903,14,9,3,4,0,0,0,0,30
620070904,21,23,7,2,2,1,1,0,57
620070905,9,12,6,1,2,0,0,2,32
620070906,16,24,6,10,2,0,0,0,58
620071001,64,53,27,20,10,2,1,0,177
620071002,45,76,35,20,4,0,0,0,180
620071003,62,90,33,32,16,3,0,0,236
620071004,42,74,40,14,12,1,0,0,183
620071005,45,68,44,27,13,7,0,1,205
620071006,74,67,34,24,8,2,1,2,212
620071007,83,88,55,24,6,6,1,0,263
620071008,50,63,42,20,8,1,0,1,185
620071009,51,56,37,14,5,2,1,1,167
620071010,56,50,39,14,6,6,0,0,171
620071011,45,45,33,21,10,3,0,1,158
620071012,66,51,43,24,15,10,5,4,218
620071013,46,54,44,39,19,11,2,5,220
620071101,31,68,69,88,44,13,8,10,331
620071102,28,50,39,47,14,5,2,0,185
620071103,52,72,58,78,42,18,10,8,338
620071104,16,38,42,69,55,29,9,8,266
620071105,12,25,25,34,17,13,0,0,126
620071106,30,23,36,44,31,16,5,3,188
620071107,27,43,58,42,31,10,6,5,222
620071108,14,19,31,52,31,26,11,10,194
620071109,29,34,41,39,33,30,14,12,232
620071110,28,43,34,48,21,14,5,4,197
620071111,56,47,40,64,46,35,14,13,315
620071112,31,34,47,72,47,43,17,15,306
620140101,4,3,1,4,2,0,1,0,15
620140102,60,48,29,41,22,15,6,6,227
620140103,51,74,73,56,40,11,5,9,319
620140104,50,57,70,60,42,29,10,13,331
620140105,38,53,63,56,33,19,12,12,286
620140106,9,8,2,3,2,0,0,2,26
620140107,0,0,0,0,0,0,0,0,0
620140108,28,22,33,34,27,14,7,7,172
620140109,16,11,11,7,5,4,1,3,58
620140110,56,77,67,50,32,17,1,5,305
620140111,24,37,70,77,55,32,15,13,323
620140112,31,28,34,29,28,19,4,7,180
620140201,44,60,55,45,29,14,6,8,261
620140202,55,61,28,26,17,10,2,1,200
620140203,44,61,47,49,21,8,8,2,240
620140204,58,71,65,45,30,17,5,7,298
620140301,49,85,84,65,40,21,10,9,363
620140302,31,28,38,25,17,11,4,2,156
620140303,28,42,45,57,35,23,2,4,236
620140304,18,40,63,78,55,32,7,7,300
620140401,53,72,79,72,45,28,12,7,368
620140402,91,114,59,42,22,13,2,0,343
620140403,63,69,57,43,22,9,0,1,264
620140404,56,65,56,51,41,15,5,2,291
620140405,40,43,40,46,29,8,3,2,211
620140406,57,60,47,44,20,12,1,3,244
620140407,51,61,40,38,22,4,0,1,217
620140408,43,58,74,80,57,28,7,8,355
620140409,47,72,45,29,9,6,0,0,208
620140410,34,54,68,56,32,15,6,5,270
620140501,17,0,4,2,0,1,0,0,24
620140601,55,46,58,36,24,10,5,3,237
620140602,48,48,61,42,31,10,6,6,252
620140603,42,50,35,38,24,13,7,5,214
620140604,26,53,48,41,22,16,5,1,212
620140605,43,38,50,50,21,11,4,8,225
620140606,33,34,38,36,15,8,7,2,173
620140607,28,44,45,49,33,19,10,9,237
620140608,33,36,43,48,34,17,9,12,232
620140609,24,41,49,40,32,23,7,8,224
620140701,12,14,10,4,0,1,3,0,44
620140801,27,8,5,5,1,2,0,0,48
620140901,34,36,38,29,27,7,2,7,180
620140902,28,26,21,23,5,10,6,2,121
620140903,7,3,3,1,3,0,0,0,17
620141001,29,11,9,8,7,2,2,2,70
620141002,37,26,37,27,19,12,3,2,163
620141003,20,18,36,38,37,17,7,4,177
620141101,33,35,30,29,23,6,1,3,160
620141102,37,57,71,78,26,20,9,2,300
620141103,22,27,38,45,23,13,4,0,172
620210101,21,31,23,23,9,7,2,3,119
620210102,60,89,58,61,36,21,1,5,331
620210103,12,40,16,16,7,3,0,0,94
620210104,49,53,42,34,13,8,2,0,201
620210105,12,29,24,26,8,1,0,1,101
620210106,47,65,53,33,19,4,2,0,223
620210107,54,62,44,31,17,10,1,0,219
620210108,48,60,41,39,20,3,0,1,212
620210109,32,49,37,33,11,3,5,0,170
620210110,50,53,44,59,18,13,3,1,241
620210111,33,48,58,49,27,10,3,2,230
620210112,24,44,22,21,3,5,2,0,121
620210201,14,24,21,25,6,2,0,1,93
620210202,29,46,22,30,14,6,0,1,148
620210203,54,46,65,63,41,25,10,7,311
620210204,27,40,46,64,34,14,11,6,242
620210205,18,33,51,60,49,14,12,9,246
620210206,17,63,63,93,41,26,9,7,319
620210207,25,38,42,40,36,10,8,2,201
620210208,23,52,48,81,35,15,6,7,267
620210209,21,32,36,41,26,18,3,4,181
620210210,21,37,63,55,40,17,3,4,240
620210211,42,65,65,66,43,19,6,10,316
620210212,33,17,33,27,34,17,8,8,177
620210301,54,45,18,10,4,3,0,0,134
620210302,94,37,12,4,2,0,0,0,149
620210303,104,55,24,9,2,0,0,0,194
620210304,56,53,23,12,2,0,0,0,146
620210305,60,41,18,8,4,2,0,0,133
620210306,45,47,18,5,1,0,0,0,116
620210307,49,32,27,6,2,0,0,0,116
620210308,50,51,23,15,3,0,0,0,142
620210309,114,79,31,13,5,0,0,1,243
620210310,60,59,29,7,2,2,0,0,159
620210311,58,52,34,19,7,1,0,0,171
620210312,30,66,39,16,6,4,0,0,161
620210313,70,78,42,19,7,3,0,0,219
620210401,13,13,8,4,1,1,0,0,40
620210402,30,17,7,9,6,2,2,2,75
620210403,12,5,4,2,2,1,0,0,26
620210501,43,53,43,25,23,10,2,4,203
620210502,41,36,14,11,9,3,5,2,121
620210503,7,2,2,2,1,0,1,1,16
620210601,29,23,17,14,11,9,2,3,108
620210602,49,45,35,34,10,5,4,2,184
620210603,55,32,31,19,9,0,2,0,148
620210604,59,84,39,29,11,7,2,1,232
620210605,29,43,29,13,13,7,0,2,136
620210606,50,49,35,23,13,7,2,1,180
620210607,72,74,41,33,15,12,4,4,255
620210608,65,63,61,53,31,14,12,4,303
620210701,56,52,53,41,18,9,4,0,233
620210702,33,23,19,25,15,4,2,0,121
620210703,44,28,20,22,8,8,0,0,130
620210704,36,31,20,11,13,4,4,9,128
620210705,55,52,63,51,30,12,8,5,276
620210706,46,50,71,77,35,14,9,4,306
620210707,83,74,88,78,49,24,11,5,412
620210708,33,31,25,18,11,5,3,2,128
620210709,44,68,71,60,19,28,6,5,301
620210710,24,35,28,35,14,3,1,0,140
620210801,57,56,38,34,12,3,1,3,204
620210802,61,50,44,17,12,1,2,1,188
620210803,63,64,63,38,19,8,2,1,258
620210804,31,39,38,28,15,3,2,0,156
620210805,48,62,53,47,24,20,8,2,264
620210806,35,50,52,34,36,9,1,1,218
620210807,52,66,45,37,24,10,2,7,243
620210808,43,53,47,51,28,8,7,4,241
620210809,55,66,81,69,42,20,7,4,344
620210810,27,77,84,57,50,24,9,8,336
620210901,77,67,34,24,8,2,0,0,212
620210902,95,90,63,42,19,5,4,0,318
620210903,68,66,58,68,33,22,10,11,336
620210904,85,92,91,67,24,17,1,2,379
620210905,83,91,57,54,25,9,3,6,328
620210906,46,40,44,30,19,6,3,2,190
620210907,46,68,55,38,15,1,3,0,226
620210908,73,94,81,88,39,15,1,3,394
620210909,34,43,45,32,20,14,6,2,196
620211001,57,73,68,42,30,13,6,4,293
620211002,52,65,83,49,37,14,5,2,307
620211003,35,67,68,36,28,8,7,5,254
620211004,33,36,41,40,18,13,6,4,191
620211005,41,67,73,68,49,26,4,12,340
620211006,19,41,43,49,30,20,9,7,218
620211007,26,37,37,49,24,8,3,2,186
620211008,39,37,42,37,25,12,7,10,209
620211009,8,34,43,42,24,25,6,7,189
620211010,20,31,38,36,25,16,8,10,184
620211011,14,26,30,43,29,9,5,10,166
620211101,20,22,37,45,27,6,5,1,163
620211102,46,74,45,33,7,7,2,1,215
620211103,70,90,52,37,17,10,1,2,279
620211104,55,55,36,32,15,1,0,0,194
620211105,34,72,49,40,20,4,2,1,222
620211106,64,87,53,35,13,3,0,2,257
620211107,38,58,40,35,13,6,1,0,191
620211108,43,49,35,30,9,5,1,2,174
620211109,28,46,37,43,25,5,4,0,188
620211110,32,56,35,39,15,12,1,3,193
620211111,41,46,60,44,43,16,3,5,258
620211112,53,73,54,56,47,23,2,3,311
620211113,36,68,53,40,24,3,0,0,224
620211114,25,46,37,31,12,4,1,1,157
620211201,37,61,44,35,16,2,0,1,196
620211202,39,57,35,34,14,6,1,0,186
620211203,36,51,31,27,14,2,3,0,164
620211204,26,30,32,27,10,1,2,0,128
620211205,29,41,30,32,10,0,0,0,142
620211206,41,57,50,37,20,8,3,1,217
620211207,40,48,49,38,23,2,2,2,204
620211208,54,82,72,60,31,12,2,3,316
620211209,14,10,4,5,2,2,0,0,37
620211301,44,57,42,33,6,1,2,0,185
620211302,63,82,62,43,16,8,2,0,276
620211303,37,75,42,42,19,6,0,1,222
620211304,25,51,24,26,20,5,2,0,153
620211305,30,38,28,20,8,4,0,1,129
620211306,44,66,51,40,13,4,0,1,219
620211307,37,61,46,41,21,6,1,0,213
620211308,43,60,49,30,14,10,1,0,207
620211309,19,39,26,24,10,6,0,0,124
620211310,39,64,40,33,18,4,1,1,200
620211311,51,76,56,41,18,4,1,0,247
620211401,41,48,45,26,25,9,4,5,203
620211402,38,56,81,80,50,17,18,7,347
620211403,38,48,73,98,52,23,9,6,347
620211404,38,39,60,99,52,26,10,10,334
620211405,26,47,75,105,55,31,14,10,363
620211406,29,35,63,39,27,8,2,3,206
620211407,43,34,44,44,22,9,2,4,202
620211408,27,33,42,45,32,33,21,16,249
620211409,43,78,96,79,40,30,9,4,379
620211410,41,63,85,73,45,20,14,3,344
620211411,32,39,78,71,46,22,9,6,303
620211412,46,69,60,55,18,4,0,1,253
620211413,19,42,59,44,19,5,1,3,192
620211414,20,48,60,54,33,7,2,0,224
620211415,38,61,67,67,16,10,1,0,260
620211416,38,64,70,82,25,6,3,4,292
620211417,36,58,39,48,20,9,4,2,216
620211418,13,10,9,9,3,1,1,1,47
620211501,58,53,21,12,2,0,1,0,147
620211502,41,51,27,7,4,3,0,0,133
620211503,80,101,53,35,7,3,0,1,280
620211504,63,41,22,18,3,1,1,0,149
620211505,48,49,31,21,7,2,1,1,160
620211506,74,84,49,36,24,11,1,2,281
620211507,53,62,22,13,8,3,0,2,163
620211508,43,45,38,16,8,4,1,0,155
620211509,48,51,23,18,3,2,0,0,145
620211510,56,54,24,13,2,3,0,0,152
620211511,59,61,42,21,9,2,1,0,195
620211512,53,74,37,28,13,2,0,0,207
620211601,76,86,63,58,23,9,2,4,321
620211602,59,66,58,44,27,7,1,5,267
620211603,53,76,91,69,33,19,9,7,357
620211604,25,49,43,61,32,26,10,8,254
620211605,11,29,31,33,35,16,10,10,175
620211606,34,61,59,51,29,26,10,16,286
620211607,48,67,80,66,45,20,5,6,337
620211608,35,64,77,60,48,25,14,8,331
620211609,27,55,62,52,27,12,7,4,246
620211701,39,50,64,46,29,12,4,2,246
620211702,20,36,59,37,28,11,7,12,210
620211703,13,23,37,22,21,15,9,8,148
620211704,28,35,41,52,20,12,7,6,201
620211705,40,44,61,63,32,29,5,17,291
620211706,28,34,38,65,21,28,18,7,239
620211707,30,43,40,35,43,16,16,9,232
620211708,34,63,65,78,37,26,7,4,314
620211709,14,33,44,52,40,17,8,3,211
620211710,34,40,54,63,36,14,5,3,249
620211801,48,64,50,43,24,8,1,2,240
620211802,62,52,54,51,22,4,2,1,248
620211803,44,54,50,33,16,16,2,3,218
620211804,34,54,43,24,15,6,2,1,179
620211805,62,83,49,31,10,3,1,1,240
620211806,57,55,40,32,14,7,1,0,206
620211807,24,36,51,39,16,12,7,3,188
620211808,10,15,32,41,16,12,3,4,133
620211809,26,49,73,77,35,13,3,4,280
620211901,37,44,47,31,18,8,0,0,185
620211902,51,55,49,33,23,14,4,5,234
620211903,71,77,48,45,18,4,3,1,267
620211904,37,53,52,56,30,10,3,3,244
620211905,45,51,32,38,19,9,2,1,197
620211906,34,40,31,22,15,4,1,3,150
620211907,25,40,29,8,12,3,0,0,117
620211908,31,44,71,64,41,29,9,5,294
620211909,36,44,40,30,15,8,2,0,175
620211910,31,40,38,41,29,6,5,2,192
620211911,49,71,54,47,22,17,5,5,270
620211912,46,45,37,42,35,14,9,1,229
620280101,6,0,3,0,0,0,0,0,9
620280102,10,6,2,5,3,4,0,1,31
620280103,14,15,15,11,2,4,0,1,62
620280104,42,41,45,36,30,19,5,6,224
620280105,28,24,22,21,18,9,3,1,126
620280201,12,2,7,1,1,1,0,1,25
620280301,8,9,5,1,0,0,0,0,23
620280401,57,87,80,67,29,16,5,1,342
620280402,75,99,58,48,23,13,1,3,320
620280403,46,53,47,30,7,11,1,4,199
620280404,32,41,53,57,51,16,6,12,268
620280405,31,31,40,33,25,12,7,2,181
620280406,57,79,63,58,24,14,3,6,304
620280407,13,39,31,33,19,3,2,0,140
620350101,32,35,32,25,18,6,5,8,161
620350102,54,40,29,30,16,8,3,1,181
620350103,19,21,14,16,3,5,3,1,82
620350104,12,16,20,20,13,1,0,3,85
620350105,9,11,10,9,3,3,2,1,48
620350106,30,24,18,6,8,1,0,1,88
620350107,23,24,16,6,0,1,0,0,70
620350108,14,9,2,1,0,0,0,0,26
620350109,15,10,6,3,2,2,0,0,38
620350110,28,38,23,32,26,25,12,7,191
620350111,121,88,47,20,11,3,4,4,298
620350112,42,44,35,27,12,2,2,1,165
620350113,77,54,40,37,13,7,0,2,230
620350114,33,51,39,40,31,8,3,1,206
620420101,11,1,5,5,2,1,1,0,26
620420102,16,14,8,5,5,4,2,3,57
620420103,25,23,18,27,22,11,2,3,131
620420104,12,10,3,3,2,1,0,0,31
620420201,25,18,11,5,3,2,1,1,66
620420202,41,40,29,23,21,13,5,5,177
620420301,12,3,1,1,1,1,0,0,19
620420401,45,63,67,75,49,24,13,11,347
620420402,48,53,65,48,22,16,7,2,261
620420403,27,25,41,39,16,12,7,5,172
620420404,35,29,48,53,30,14,8,5,222
620420405,41,65,62,68,34,23,4,4,301
620420406,49,52,38,30,19,16,6,6,216
620420407,16,23,12,12,8,4,4,2,81
620420408,62,20,17,28,20,12,6,3,168
620420409,41,33,16,12,10,9,2,1,124
620420410,51,46,59,53,22,11,5,2,249
620420411,30,19,36,39,29,16,10,3,182
620420412,29,34,45,54,36,22,4,8,232
620420501,19,39,28,23,14,11,3,2,139
620420502,34,33,17,33,12,7,5,5,146
620420503,7,6,7,16,4,2,0,3,45
620420504,29,24,35,38,30,22,7,6,191
620420505,17,38,51,47,18,14,0,0,185
620420506,13,21,58,54,44,24,9,7,230
620420601,28,39,52,58,38,26,11,10,262
620420602,34,51,87,74,49,16,7,9,327
620420603,21,34,44,36,17,9,5,2,168
620420604,28,45,54,47,26,8,4,0,212
620420605,31,37,46,35,36,19,8,4,216
620420606,29,47,35,45,28,12,7,1,204
620420607,58,57,63,57,26,13,3,5,282
620420608,42,50,38,36,10,6,1,1,184
620420609,40,81,65,39,17,7,1,0,250
620420610,51,53,43,47,18,5,1,1,219
620420611,54,79,34,32,11,0,1,1,212
620420612,46,32,41,32,8,3,3,0,165
620420613,32,50,41,32,24,6,3,1,189
620420614,37,42,49,39,18,9,2,2,198
620420615,36,59,52,50,50,8,8,7,270
620420701,71,69,84,95,49,21,12,10,411
620420702,81,69,80,91,67,40,11,7,446
620420703,40,36,23,22,22,7,6,2,158
620420704,37,39,39,44,30,14,6,3,212
620420705,56,76,80,81,48,22,10,10,383
620420706,21,23,15,21,17,12,3,5,117
620420707,48,58,41,51,20,7,5,7,237
620420708,44,29,36,37,21,13,1,3,184
620420709,43,32,38,32,22,15,8,3,193
620420710,29,28,38,51,29,14,6,11,206
620420711,21,35,47,57,24,4,1,0,189
620420712,36,15,34,30,13,3,0,1,132
620420713,43,62,106,75,39,22,3,5,355
620420714,21,42,81,90,64,42,12,4,356
620420715,29,32,39,56,27,19,8,5,215
620420716,35,31,38,51,31,17,5,2,210
620420717,22,19,32,33,18,12,3,1,140
620420801,52,92,65,55,17,8,2,1,292
620420802,53,86,61,55,18,13,0,2,288
620420803,43,46,52,32,25,8,4,2,212
620420804,45,50,50,25,16,4,0,1,191
620420805,33,38,44,34,12,2,0,1,164
620420806,41,63,43,47,20,13,4,0,231
620420807,73,72,49,42,16,8,1,2,263
620420808,77,85,52,28,12,3,1,0,258
620420809,86,63,28,9,9,1,0,0,196
620420810,96,86,39,17,9,2,0,0,249
620420901,19,41,49,43,17,17,5,10,201
620420902,66,80,61,68,43,21,14,4,357
620420903,37,46,49,52,28,18,15,11,256
620420904,29,40,59,40,17,10,5,1,201
620420905,36,51,45,55,26,15,7,8,243
620420906,54,68,84,72,21,11,6,9,325
620420907,19,32,61,70,56,33,2,4,277
620420908,27,34,25,61,36,17,7,6,213
620420909,25,36,51,54,25,13,6,0,210
620420910,38,57,56,47,16,9,6,5,234
620421001,51,43,78,63,40,31,10,10,326
620421002,26,67,63,42,24,12,4,8,246
620421003,31,44,52,40,38,10,4,3,222
620421004,30,52,35,27,16,10,0,4,174
620421005,56,61,53,40,26,12,4,4,256
620421006,47,54,54,47,24,17,2,7,252
620421007,26,36,37,55,23,16,5,4,202
620421008,37,47,56,56,27,12,4,2,241
620421009,43,68,64,55,36,17,5,4,292
620421010,35,58,59,51,34,24,6,6,273
620421011,47,70,51,34,16,9,3,4,234
620421012,47,57,40,32,12,9,1,0,198
620421013,51,56,36,27,13,4,0,1,188
620421101,45,33,45,40,20,16,7,5,211
620421102,52,46,41,40,28,16,6,5,234
620421103,37,37,29,38,19,8,7,4,179
620421104,55,47,38,34,25,20,6,6,231
620421105,20,37,45,48,46,23,7,9,235
620421106,30,33,56,47,29,12,10,11,228
620421107,33,34,39,52,36,26,7,5,232
620421108,39,26,28,26,23,11,4,3,160
620421109,43,43,47,46,27,15,10,6,237
620421110,40,42,56,68,44,30,7,12,299
620421111,13,40,39,35,27,7,3,2,166
620421112,41,29,47,45,26,27,5,4,224
620421201,37,55,68,59,48,8,4,3,282
620421202,24,43,68,62,55,28,15,6,301
620421203,59,99,76,73,25,8,4,4,348
620421204,37,58,43,59,20,13,3,2,235
620421205,44,39,25,24,15,6,0,0,153
620421206,37,48,38,23,11,6,0,3,166
620421207,84,102,63,51,19,5,1,3,328
620421208,52,68,58,47,19,10,1,0,255
620421209,44,86,42,39,14,5,1,0,231
620421210,60,63,38,21,14,3,2,1,202
620421211,48,57,31,24,4,3,2,0,169
620421212,46,77,37,27,3,3,0,1,194
620421213,72,63,43,15,5,3,1,1,203
620421214,54,43,15,11,4,1,0,0,128
620421301,31,40,40,56,28,23,5,10,233
620421302,55,41,70,77,49,21,12,6,331
620421303,43,69,68,48,28,13,6,6,281
620421304,30,70,84,57,52,18,6,4,321
620421305,61,59,69,74,33,13,3,0,312
620421306,55,85,77,65,42,27,8,10,369
620421401,35,37,37,60,25,19,5,6,224
620421402,7,3,6,3,1,3,0,0,23
620421403,42,53,69,46,47,32,6,2,297
620421404,23,33,38,32,28,12,3,0,169
620421405,47,72,62,64,34,21,11,8,319
620421406,20,17,29,19,15,11,1,2,114
620421407,54,71,47,73,23,2,4,4,278
620421408,59,51,34,40,28,13,1,7,233
620421409,39,27,37,32,22,8,4,5,174
620421410,19,27,21,17,13,11,2,1,111
620421411,25,36,39,48,31,18,7,7,211
620421412,10,19,26,24,7,6,0,4,96
620421501,52,92,89,70,45,19,7,6,380
620421502,54,36,42,38,17,25,3,4,219
620421503,40,41,51,49,23,15,9,8,236
620421504,46,33,42,43,25,12,6,6,213
620421505,28,43,52,34,21,9,5,3,195
620421506,25,33,35,37,31,17,4,3,185
620421507,23,51,55,66,27,14,4,1,241
620421508,10,17,18,28,26,16,2,2,119
620421601,31,49,36,57,30,24,10,9,246
620421602,21,28,25,17,11,16,7,6,131
620421603,42,32,38,31,29,16,7,6,201
620421604,32,37,37,39,25,15,8,6,199
620421701,34,45,54,47,43,26,4,12,265
620421702,40,41,38,31,30,12,6,9,207
620421801,45,67,48,47,19,11,5,3,245
620421802,30,33,32,16,10,10,3,4,138
620421803,49,62,54,73,39,15,18,6,316
620421804,48,53,56,47,19,9,12,3,247
620421805,34,45,46,53,24,21,6,11,240
620421806,26,51,48,30,21,16,5,6,203
620421807,24,56,49,66,40,31,20,15,301
620421901,50,71,57,56,33,13,1,3,284
620421902,27,35,35,33,32,20,3,8,193
620421903,36,50,62,48,30,14,9,8,257
620421904,24,40,46,56,46,26,12,10,260
620421905,18,18,12,17,14,4,5,1,89
620422001,12,10,17,8,9,2,4,7,69
620422002,43,81,51,37,15,8,2,0,237
620422003,33,49,33,25,8,1,2,0,151
620422004,60,76,28,12,9,2,3,1,191
620422005,53,48,22,17,8,1,1,0,150
620422006,47,40,65,50,23,14,6,3,248
620422007,46,58,54,53,17,6,5,4,243
620422008,38,54,32,27,14,4,1,0,170
620422009,42,51,30,15,9,2,2,0,151
620422010,44,41,26,12,6,5,0,0,134
620422011,45,69,47,46,8,7,2,0,224
620422012,57,71,48,25,11,10,4,0,226
620422013,29,63,46,38,31,21,10,6,244
620422101,47,65,43,42,38,17,4,12,268
620422102,27,33,36,29,13,10,4,2,154
620422103,23,40,54,84,45,25,14,10,295
620422104,16,18,22,35,28,12,6,6,143
620422105,33,28,52,40,25,20,9,8,215
620422106,21,30,32,37,33,21,8,2,184
620422107,34,61,48,49,23,23,8,11,257
620422108,17,28,30,23,13,6,4,2,123
620422109,20,27,19,25,6,8,3,5,113
620422201,73,88,77,64,49,30,15,11,407
620422202,6,13,17,13,12,1,3,2,67
620422203,25,39,47,53,53,21,9,7,254
620422204,24,8,14,15,10,5,3,1,80
620422205,42,48,59,70,52,23,18,12,324
620422206,45,40,59,38,27,17,9,6,241
620422301,28,46,55,53,26,22,9,7,246
620422302,23,36,40,46,27,25,8,3,208
620422303,28,38,47,42,23,10,2,1,191
620422304,32,40,48,48,30,17,3,2,220
620422305,38,84,91,83,50,26,14,2,388
620422306,28,46,36,53,31,15,6,2,217
620422307,50,50,38,33,23,9,0,1,204
620422308,23,52,45,34,16,8,1,1,180
620422309,53,46,45,31,18,15,3,1,212
620422310,22,44,42,29,15,14,4,0,170
620422311,42,55,62,73,43,23,8,5,311
620422401,22,48,35,47,24,24,3,17,220
620422402,48,43,52,40,19,8,5,3,218
620422403,37,64,48,34,17,12,3,7,222
620422404,49,76,65,67,40,19,7,7,330
620422405,52,67,72,60,31,19,11,3,315
620422406,40,56,32,28,19,6,2,5,188
620422407,49,53,31,31,14,4,3,0,185
620422408,97,94,66,61,18,7,1,0,344
620422501,46,65,72,63,44,13,9,8,320
620422502,49,45,88,55,33,19,7,5,301
620422503,42,88,81,89,48,21,11,6,386
620422504,36,51,42,53,19,10,3,2,216
620422505,65,78,90,75,38,20,4,4,374
620422506,42,65,52,44,23,15,2,2,245
620422507,67,63,58,44,30,15,8,5,290
620422508,86,100,104,61,37,12,10,2,412
620422509,50,67,58,45,33,19,2,8,282
620422510,42,88,69,63,35,23,6,6,332
620422601,21,56,61,49,37,28,12,6,270
620422602,38,40,51,36,33,23,7,9,237
620422603,34,43,53,64,61,33,11,13,312
620422604,20,28,34,47,19,11,10,3,172
620422605,25,32,47,32,25,11,7,7,186
620422606,30,35,42,49,26,15,9,6,212
620422607,25,32,36,35,27,10,9,2,176
620422608,22,43,47,34,9,11,3,4,173
620422609,55,56,62,45,36,11,6,7,278
620422610,27,31,45,31,18,18,7,6,183
620422611,19,42,28,38,19,4,4,1,155
620422612,39,46,56,44,31,4,5,5,230
620422613,42,54,64,54,18,10,3,2,247
620422614,35,57,40,39,19,4,4,0,198
620422615,47,40,23,19,11,5,2,0,147
620422701,35,42,55,35,27,13,2,5,214
620422702,51,71,60,46,21,9,5,0,263
620422703,53,51,50,25,8,0,0,1,188
620422704,51,66,36,25,8,1,0,0,187
620422705,51,78,38,28,8,2,1,1,207
620422706,41,57,40,34,10,4,1,1,188
620422707,29,50,41,26,14,9,2,0,171
620422708,65,88,69,54,22,7,5,0,310
620422709,15,40,43,42,38,20,8,7,213
620422710,20,66,69,55,26,14,4,3,257
620422711,11,34,26,27,22,13,7,8,148
620422712,12,40,43,45,34,13,5,4,196
620422713,80,88,66,65,16,9,4,2,330
620422714,44,59,44,41,19,21,5,4,237
620422715,20,34,32,34,25,15,3,2,165
620422801,31,62,74,83,40,16,7,2,315
620422802,24,34,48,45,24,10,6,2,193
620422803,40,59,75,98,58,23,5,9,367
620422804,31,64,63,67,43,27,14,11,320
620422805,25,64,76,74,49,25,9,11,333
620422806,38,70,87,68,42,26,8,13,352
620422807,13,22,37,46,39,20,7,12,196
620422808,13,27,38,52,31,18,13,10,202
620422901,27,46,49,66,26,14,5,2,235
620422902,25,42,48,35,13,7,1,0,171
620422903,45,57,69,67,38,22,7,7,312
620422904,64,66,66,62,30,18,4,2,312
620422905,29,49,55,52,35,12,7,5,244
620422906,39,52,76,55,26,11,5,8,272
620422907,56,81,53,42,27,13,4,2,278
620422908,46,55,66,69,38,17,6,12,309
620422909,35,44,69,58,49,22,11,6,294
620422910,56,66,51,57,32,19,14,7,302
620423001,66,95,53,41,18,2,2,2,279
620423002,96,111,68,61,38,16,2,0,392
620423003,57,73,50,35,22,8,1,1,247
620423004,37,63,67,49,26,9,1,2,254
620423005,30,36,48,35,30,14,3,4,200
620423006,9,8,10,4,4,4,0,0,39
620423007,47,61,91,72,48,18,4,7,348
620423008,39,59,87,83,50,20,7,5,350
620423009,38,62,73,69,60,16,4,6,328
620423010,25,31,50,55,35,21,9,7,233
620423011,53,43,41,75,43,17,10,9,291
620423012,19,23,18,21,10,6,5,5,107
620423101,43,52,78,73,52,37,7,14,356
620423102,30,46,81,74,62,46,13,17,369
620423103,14,27,45,82,53,31,8,5,265
620423104,16,44,64,76,45,33,15,14,307
620423105,31,59,64,67,63,37,11,13,345
620423106,20,44,57,63,35,28,7,15,269
620423107,15,23,50,79,69,40,6,12,294
620423108,34,32,48,63,36,20,9,2,244
620423109,29,64,61,66,44,20,4,9,297
620423201,56,67,71,45,16,7,0,0,262
620423202,18,72,49,47,18,11,8,5,228
620423203,27,33,54,44,22,10,4,9,203
620423204,80,79,87,71,40,19,5,3,384
620423205,36,49,37,37,20,15,2,1,197
620423206,34,54,42,36,24,7,6,2,205
620423207,39,56,32,39,23,10,3,3,205
620423208,31,50,44,44,17,8,3,2,199
620423209,52,59,47,40,25,10,2,4,239
620423210,43,67,51,41,13,10,0,1,226
620423211,69,54,42,49,16,15,3,3,251
620423212,37,75,38,15,14,13,1,1,194
620423301,32,47,37,41,17,13,3,5,195
620423302,24,39,57,43,24,7,3,4,201
620423303,79,80,81,69,39,21,1,3,373
620423304,60,75,64,54,28,8,2,4,295
620423305,53,66,43,34,14,14,2,2,228
620423306,60,59,38,23,9,2,0,1,192
620423307,54,46,35,21,9,3,0,0,168
620423308,46,54,36,20,4,2,0,1,163
620423309,87,63,38,24,14,2,2,0,230
620423310,65,76,37,29,19,4,1,0,231
620423311,76,111,59,47,27,9,2,0,331
620423401,17,39,60,55,32,17,8,0,228
620423402,26,55,76,114,73,28,6,5,383
620423403,15,25,44,73,36,16,5,2,216
620423404,11,30,37,49,27,14,6,3,177
620423405,21,68,73,81,37,12,2,1,295
620423406,9,41,41,51,13,10,0,1,166
620423407,25,30,36,36,22,7,2,1,159
620423408,13,42,35,44,17,5,4,0,160
620423409,10,26,34,62,51,4,1,0,188
620423410,34,83,86,90,37,12,5,1,348
620423501,72,71,45,26,9,3,1,0,227
620423502,77,79,45,27,12,3,2,2,247
620423503,95,101,49,26,9,5,0,1,286
620423504,60,69,50,27,15,3,1,0,225
620423505,71,79,52,29,11,1,1,0,244
620423506,108,72,35,24,12,3,1,0,255
620423507,34,69,53,68,39,15,1,4,283
620423508,46,42,42,38,12,13,3,5,201
620423509,36,95,76,44,28,8,4,0,291
620423601,47,79,52,54,26,10,1,2,271
620423602,56,81,36,43,16,2,0,0,234
620423603,55,89,59,46,20,6,1,0,276
620423604,41,64,47,45,29,13,5,1,245
620423605,56,58,34,36,15,3,1,1,204
620423606,33,65,36,32,12,6,2,4,190
620423607,40,80,62,54,20,7,2,2,267
620423608,35,45,62,43,33,15,7,3,243
620423609,40,55,49,59,22,12,3,1,241
620423610,15,29,40,40,20,6,6,2,158
620423611,33,44,61,38,32,11,6,6,231
620423612,37,44,54,55,24,8,4,4,230
620423701,30,29,42,51,37,16,6,5,216
620423702,22,34,45,42,31,12,5,2,193
620423703,36,24,68,64,39,18,10,4,263
620423704,32,31,46,41,36,31,8,8,233
620423705,29,44,68,65,43,25,10,7,291
620423706,45,39,57,83,53,33,9,12,331
620423707,48,43,56,78,44,25,14,7,315
620423708,18,19,29,23,10,2,4,3,108
620423709,24,40,50,81,49,43,20,9,316
620423710,40,49,69,110,42,15,2,2,329
620423711,18,34,43,61,29,5,0,2,192
620423801,46,58,71,53,30,19,4,5,286
620423802,57,88,69,52,35,10,7,5,323
620423803,39,50,44,35,31,16,8,8,231
620423804,55,47,50,36,17,5,3,3,216
620423805,66,74,49,26,18,10,2,1,246
620423806,69,60,46,28,13,3,0,1,220
620423807,22,25,33,32,19,11,5,5,152
620423808,40,42,50,45,20,10,8,3,218
620423809,26,48,51,38,19,13,6,2,203
620423810,30,51,48,39,23,11,5,4,211
620423811,40,66,69,59,42,25,4,10,315
620423812,26,49,39,27,25,6,3,4,179
620423813,22,34,40,36,23,22,3,8,188
620423814,24,48,74,77,37,24,16,16,316
620423901,79,103,52,19,12,3,0,0,268
620423902,48,53,32,20,4,2,0,0,159
620423903,61,50,25,26,2,5,0,0,169
620423904,54,68,50,25,10,3,1,0,211
620423905,38,79,69,59,18,8,1,0,272
620423906,92,93,49,29,8,7,2,1,281
620423907,80,95,63,53,9,6,1,2,309
620423908,67,70,35,26,7,2,0,1,208
620423909,64,61,35,24,3,2,0,0,189
620423910,74,66,23,21,4,6,0,1,195
620423911,86,82,37,22,13,3,0,0,243
620423912,85,80,31,20,3,1,1,1,222
620424001,42,30,50,52,28,10,5,8,225
620424002,47,44,59,40,30,7,1,1,229
620424003,30,65,86,80,58,28,6,2,355
620424004,33,49,68,78,45,24,7,7,311
620424005,26,39,33,41,27,15,1,1,183
620424006,23,33,40,43,22,11,6,4,182
620424007,22,24,47,60,38,21,6,3,221
620424008,31,29,38,38,27,3,1,2,169
620424009,31,51,84,73,39,18,8,14,318
620424010,32,25,27,33,17,9,1,2,146
620424011,25,52,49,67,33,18,4,2,250
620424012,31,43,54,45,22,2,0,0,197
620424013,15,24,39,34,15,2,0,0,129
620424014,44,77,74,79,36,17,5,6,338
620424101,72,79,40,30,10,4,1,0,236
620424102,83,76,41,21,9,4,1,1,236
620424103,60,69,25,27,14,5,1,0,201
620424104,31,43,21,15,9,1,3,0,123
620424105,52,62,63,39,12,9,1,1,239
620424106,57,69,35,31,12,5,1,0,210
620424107,36,76,28,26,12,3,0,0,181
620424108,69,80,57,49,10,1,2,0,268
620424109,45,58,45,26,3,2,4,0,183
620424110,40,41,41,21,10,2,0,0,155
620424111,44,60,53,42,21,3,1,0,224
620424112,38,60,52,70,23,1,2,1,247
620424113,51,52,39,32,11,1,2,2,190
620424114,37,54,42,20,18,3,3,2,179
620424201,39,66,68,58,38,10,3,2,284
620424202,84,80,65,42,24,9,4,9,317
620424203,71,73,48,40,16,6,1,1,256
620424204,56,91,48,36,23,12,4,1,271
620424205,24,35,33,34,26,8,5,5,170
620424206,41,62,68,75,43,29,8,10,336
620424207,81,102,81,65,48,25,8,4,414
620424208,62,47,68,61,46,19,9,4,316
620424209,26,53,65,43,38,24,10,18,277
620424210,50,66,59,41,16,7,4,1,244
620424301,22,22,25,38,43,32,14,22,218
620424302,18,45,25,26,6,3,0,0,123
620424303,33,48,44,32,22,10,2,1,192
620424304,45,65,37,30,13,5,1,0,196
620424305,24,47,55,65,34,11,8,4,248
620424306,36,57,77,92,55,24,6,5,352
620424307,35,54,71,74,36,14,5,2,291
620424308,24,40,69,43,36,33,10,10,265
620424309,57,68,68,74,35,24,7,2,335
620424310,22,40,45,61,42,8,9,4,231
620424311,63,56,74,45,41,17,4,11,311
620424312,20,52,64,73,44,31,8,20,312
620490101,42,41,38,43,39,21,6,2,232
620490102,49,49,60,63,29,16,5,7,278
620490103,27,17,7,10,8,3,4,0,76
620490104,43,36,18,17,9,2,1,0,126
620490105,35,25,22,14,9,5,2,2,114
620490106,49,36,55,31,30,8,5,3,217
620490107,31,17,14,6,6,3,1,2,80
620560101,29,17,36,32,21,5,4,4,148
620560102,29,14,22,11,10,7,2,1,96
620560103,88,55,35,15,8,9,1,1,212
620560104,76,37,27,19,12,9,0,1,181
620630101,32,49,48,38,22,9,3,3,204
620630102,54,61,34,31,8,0,0,0,188
620630103,63,64,34,35,13,10,0,1,220
620630104,49,59,46,53,19,10,4,2,242
620630105,36,40,50,51,27,13,3,4,224
620630106,77,67,72,56,29,17,6,4,328
620630107,11,19,20,12,9,5,2,1,79
620630108,35,33,57,37,26,19,4,4,215
620630109,55,93,62,55,18,9,2,0,294
620630110,56,43,34,22,11,2,1,2,171
620630111,37,54,50,23,16,4,0,0,184
620630112,48,50,50,41,17,14,3,5,228
620630113,27,54,80,87,45,13,4,6,316
620630114,45,44,24,25,10,4,0,0,152
620630115,25,32,44,39,23,17,4,7,191
620630116,45,55,24,19,6,1,0,0,150
620630117,44,44,37,34,26,16,9,4,214
620630118,28,24,22,22,26,12,5,6,145
620630201,55,76,69,53,23,18,7,4,305
620630202,30,36,16,7,12,4,1,2,108
620630203,19,18,13,11,4,3,0,0,68
620630204,29,31,20,24,10,7,4,2,127
620630205,31,31,39,42,32,4,5,9,193
620630301,5,3,5,3,0,0,1,1,18
620630302,41,19,6,1,0,0,0,0,67
620630401,42,3,6,3,1,0,1,0,56
620700101,44,48,45,54,22,17,2,4,236
620700102,37,47,54,48,28,8,6,4,232
620700103,36,27,38,36,25,9,7,4,182
620700104,68,61,38,23,15,4,4,4,217
620700105,21,18,22,11,12,5,1,1,91
620700106,65,30,18,13,11,7,1,1,146
620700107,37,22,22,23,15,6,2,0,127
620700201,46,74,51,48,21,1,4,1,246
620700202,23,63,35,40,20,4,2,4,191
620700203,34,64,66,79,27,19,1,8,298
620700204,32,50,44,34,17,1,2,1,181
620700205,28,58,49,43,24,8,2,1,213
620770101,42,48,42,44,22,9,2,2,211
620770102,34,42,35,24,10,9,1,3,158
620770103,41,48,26,23,14,3,1,0,156
620770104,54,82,43,35,16,6,2,3,241
620770105,35,29,29,21,8,3,0,2,127
620770106,34,51,40,38,20,12,1,2,198
620770107,40,50,61,45,32,15,4,6,253
620770108,19,41,42,41,23,7,1,5,179
620770109,60,70,59,34,32,11,3,4,273
620770110,53,73,46,32,26,9,2,2,243
620770111,42,37,54,54,51,30,12,25,305
620770112,38,63,52,54,37,22,7,9,282
620770113,37,35,35,35,14,8,3,3,170
620770114,40,46,23,30,12,1,0,1,153
620770115,33,38,23,26,9,7,1,2,139
620770116,30,59,30,34,19,3,3,3,181
620770117,31,27,46,40,28,13,3,9,197
620770201,67,88,61,62,34,17,2,5,336
620770202,36,39,31,27,13,12,5,2,165
620770203,26,44,40,31,20,14,4,4,183
620770204,17,39,18,22,8,9,0,0,113
620770205,48,58,49,41,25,13,2,4,240
620770206,17,56,36,32,12,4,4,4,165
620770207,20,38,22,26,14,5,1,2,128
620770208,20,35,42,57,38,18,8,9,227
620770209,40,39,37,48,10,13,5,5,197
620770210,48,54,59,49,34,18,7,6,275
620770211,62,49,58,49,21,6,9,1,255
620770301,9,34,14,8,2,0,2,0,69
620770302,23,18,15,8,2,1,0,0,67
620770303,23,26,7,5,5,2,0,0,68
620770304,25,24,12,8,5,3,0,0,77
620770305,37,44,31,23,12,5,1,0,153
620770306,17,23,8,7,4,0,0,0,59
620770307,31,36,38,28,12,7,3,1,156
620770401,27,23,22,20,16,7,1,4,120
620770402,49,29,15,20,12,3,2,2,132
620770403,44,64,81,76,35,17,13,4,334
620770404,34,30,48,70,70,32,15,14,313
620770405,31,51,60,70,41,23,8,7,291
620770406,34,53,63,95,41,21,10,3,320
620770407,6,11,8,8,3,1,0,1,38
620770408,6,3,1,1,0,1,0,0,12
620770409,26,31,31,38,21,14,2,4,167
620770410,26,20,14,10,9,5,0,0,84
620770411,30,37,18,19,10,4,0,0,118
620770412,26,32,26,12,9,5,2,1,113
620770413,4,9,31,45,35,16,10,4,154
620770501,26,6,2,0,0,0,0,0,34
620770502,5,6,0,1,1,1,0,0,14
620770503,16,8,5,3,3,0,0,0,35
620770504,16,8,2,4,4,1,0,1,36
620770601,24,16,8,9,2,0,0,1,60
620770602,8,9,3,3,5,1,0,0,29
620770603,22,26,13,8,6,2,2,0,79
620770604,24,27,15,14,9,4,0,0,93
620770605,25,19,32,23,9,3,0,2,113
620770606,17,16,6,5,9,1,0,1,55
620770607,21,25,20,13,4,1,2,1,87
620840101,38,39,32,24,21,11,1,2,168
620840102,48,32,29,22,13,4,2,3,153
620840103,22,19,31,21,14,9,4,2,122
620840104,32,48,53,48,31,20,9,7,248
620840105,37,27,31,29,20,9,6,8,167
620840106,26,32,23,24,17,6,5,1,134
620840107,28,28,29,35,30,20,4,1,175
620840201,4,2,2,0,1,0,0,0,9
620840202,2,9,8,16,3,3,2,0,43
620840203,5,4,5,6,3,0,0,0,23
620840204,20,9,8,4,4,4,2,3,54
620840205,7,3,2,1,0,0,1,0,14
620840206,18,6,5,3,1,0,1,0,34
620840207,16,11,6,4,1,1,0,0,39
620840208,82,35,15,10,1,1,0,0,144
620840209,36,17,5,8,1,1,0,0,68
620849999,3,15,44,91,145,156,1,3,458
620910101,55,53,85,78,56,51,7,10,395
620910102,20,26,22,59,61,44,6,2,240
620910103,37,56,83,99,64,25,13,8,385
620910104,9,19,33,49,43,33,3,4,193
620910201,44,24,44,32,31,13,12,6,206
620910202,57,57,67,49,37,16,10,10,303
620910203,24,40,49,18,25,15,5,9,185
620910301,49,48,47,34,23,13,4,3,221
620910302,28,31,38,29,16,6,2,3,153
620910303,50,69,66,33,34,7,4,3,266
620910304,42,51,57,53,28,22,5,3,261
620910305,55,52,88,63,48,25,12,11,354
620910306,39,50,47,34,19,6,5,3,203
620910307,36,57,62,42,17,7,1,1,223
620910308,46,51,66,56,36,14,5,8,282
620910401,9,8,5,5,3,1,1,2,34
620910402,12,9,8,8,5,3,4,2,51
620910403,7,7,7,4,3,1,0,1,30
620910404,49,75,44,68,25,18,0,4,283
620910405,95,31,30,20,5,4,1,1,187
620910406,43,29,24,10,4,3,2,1,116
620910407,52,18,15,7,7,3,0,0,102
660070101,25,25,43,34,24,11,9,14,185
660070102,16,3,0,0,0,0,0,0,19
660070103,6,14,11,15,6,11,4,16,83
660070104,17,12,3,9,4,2,2,1,50
660070105,20,15,15,16,7,8,3,2,86
660070106,32,24,32,29,33,18,13,13,194
660070107,21,26,43,35,29,23,14,12,203
660070108,19,24,33,47,37,33,19,21,233
660070201,22,13,17,16,10,12,3,3,96
660070202,30,7,12,5,5,5,1,2,67
660070203,7,2,1,0,1,0,0,0,11
660070204,13,11,12,9,21,11,8,9,94
660070205,24,29,35,44,30,17,9,21,209
660070206,5,5,1,2,0,2,0,0,15
660070207,24,36,44,45,37,30,13,20,249
660070208,25,37,42,29,30,14,14,23,214
660070209,24,25,32,47,30,20,9,9,196
660070210,37,49,26,28,20,21,7,5,193
660070211,16,30,56,49,42,34,7,14,248
660070212,37,38,44,44,36,38,12,16,265
660070213,31,34,45,28,27,22,7,16,210
660070214,16,29,42,45,24,29,8,11,204
660070301,3,1,1,0,0,0,0,0,5
660070302,7,8,1,3,2,1,0,0,22
660070303,13,11,22,29,38,13,14,18,158
660070304,17,5,6,5,2,4,2,0,41
660070305,11,7,3,2,2,2,1,0,28
660070306,9,2,0,0,0,0,0,0,11
660070307,5,3,3,1,0,0,1,0,13
660070308,0,2,4,4,5,2,1,2,20
660070309,4,2,1,4,0,0,1,1,13
660070310,1,0,1,0,1,0,0,0,3
660070311,9,7,2,2,3,0,0,0,23
660070312,3,2,0,0,1,0,0,0,6
660070313,15,8,0,1,0,0,0,0,24
660070314,5,3,3,1,1,0,0,1,14
660070315,30,20,41,33,23,18,6,18,189
660070316,20,27,42,73,60,34,17,36,309
660070317,24,25,43,59,44,32,24,13,264
660070318,37,52,67,70,53,39,20,26,364
660070319,38,51,46,42,39,20,9,13,258
660070320,16,24,38,46,46,34,18,40,262
660070321,29,38,66,58,53,45,25,44,358
660070322,15,39,35,44,34,37,17,28,249
660070401,9,6,3,2,1,3,1,1,26
660070402,11,5,6,3,0,0,0,0,25
660070403,12,4,2,2,2,0,0,1,23
660070404,5,2,4,0,3,0,0,1,15
660070405,28,7,15,8,16,6,6,14,100
660070406,10,4,3,2,0,2,0,1,22
660070407,6,8,16,10,4,9,6,10,69
660070408,17,25,50,56,45,42,17,24,276
660070409,16,7,11,6,6,5,0,0,51
660070410,10,5,5,5,6,7,2,7,47
660070411,5,4,2,5,0,1,0,0,17
660070412,5,3,6,9,5,3,2,1,34
660070413,7,4,4,6,5,3,4,6,39
660070414,12,15,16,21,15,10,6,9,104
660070415,30,18,22,25,23,19,15,12,164
660070416,50,58,70,81,57,41,30,12,399
660070417,24,32,52,55,43,52,23,45,326
660070418,25,51,52,72,41,30,15,21,307
660070419,27,51,62,61,35,31,13,18,298
660070420,20,33,71,59,54,23,17,22,299
660070421,28,29,41,47,22,14,6,8,195
660070422,40,45,45,48,28,26,3,11,246
660070423,31,54,78,45,27,15,7,12,269
660070424,37,41,63,71,49,57,28,51,397
660070425,20,19,45,33,30,29,16,38,230
660070426,18,12,30,40,28,38,20,40,226
660070427,23,26,41,47,35,41,18,32,263
660070501,11,14,8,6,1,7,1,4,52
660070502,1,0,6,4,4,3,0,0,18
660070503,5,4,8,6,5,4,0,3,35
660070504,7,7,3,2,2,7,0,1,29
660070505,9,6,9,7,10,11,0,1,53
660070506,18,8,6,4,0,4,2,3,45
660070507,0,4,4,2,0,0,0,0,10
660070508,15,4,8,12,8,11,4,3,65
660070509,6,2,4,3,3,2,1,0,21
660070510,27,20,26,32,20,26,17,25,193
660070601,41,42,81,87,69,44,28,40,432
660070602,1,4,2,0,2,1,0,3,13
660070603,2,5,4,2,1,0,4,2,20
660070604,3,0,9,1,0,1,3,3,20
660070605,6,5,1,4,3,0,0,0,19
660070606,8,5,6,4,8,9,3,4,47
660070607,7,9,14,18,6,5,4,0,63
660070608,9,4,3,6,2,4,3,7,38
660070609,13,4,5,9,6,1,9,3,50
660070610,6,2,5,4,2,4,3,4,30
660070611,18,13,12,11,12,6,5,9,86
660070612,6,14,4,5,8,8,0,4,49
660070613,2,4,2,1,0,0,0,0,9
660070614,36,47,54,51,51,32,12,30,313
660070615,20,24,28,29,30,22,16,20,189
660070616,21,25,27,35,21,20,12,22,183
660070617,27,39,42,52,33,23,11,26,253
660070618,24,30,42,28,23,21,10,15,193
660070619,21,33,36,54,35,35,12,19,245
660070620,20,27,45,51,21,15,10,10,199
660070621,37,23,40,44,42,36,24,45,291
660140101,24,3,13,24,16,16,6,27,129
660140102,3,4,10,5,3,2,3,7,37
660140103,19,13,15,17,12,6,10,18,110
660140104,15,17,34,16,10,14,9,12,127
660140201,0,2,0,0,0,0,0,1,3
660140202,110,91,81,108,72,61,43,55,621
660140203,35,23,35,39,24,27,10,17,210
660140204,27,11,12,11,6,4,6,6,83
660140205,4,2,1,1,1,0,0,1,10
660140206,48,39,47,59,45,29,13,15,295
660140207,46,39,26,33,20,13,4,5,186
660210101,20,18,9,10,11,6,7,4,85
660210102,9,6,5,4,2,2,0,3,31
660210103,18,30,26,41,38,20,11,16,200
660210104,34,31,40,46,33,35,14,30,263
660210105,2,2,0,8,2,3,2,0,19
660210106,19,15,17,11,10,5,9,3,89
660210107,29,40,50,50,39,22,12,10,252
660210108,26,29,56,48,43,37,18,32,289
660210109,25,46,42,58,37,28,14,33,283
660210110,33,38,58,49,35,45,17,28,303
660210111,31,36,44,42,33,17,18,8,229
660210112,43,49,45,50,39,24,13,28,291
660210113,47,49,44,40,33,30,15,9,267
660210114,64,56,59,54,37,24,14,18,326
660210115,54,32,43,39,42,31,23,26,290
660210116,39,49,51,60,40,36,11,31,317
660210201,2,0,0,2,1,0,0,0,5
660210202,7,3,2,1,0,1,0,2,16
660280101,22,31,19,28,17,11,4,4,136
660280102,13,8,6,19,5,9,4,0,64
660280103,10,7,9,10,2,3,2,0,43
660280104,48,42,59,52,55,56,22,25,359
660280105,37,62,92,90,56,12,5,5,359
660280106,39,49,59,75,29,13,5,5,274
660280107,24,34,45,38,25,21,9,13,209
660280108,12,26,32,32,29,12,8,9,160
660280109,17,35,38,45,31,28,10,18,222
660280110,29,40,45,50,44,15,18,24,265
660280111,17,35,54,46,38,19,12,14,235
660280112,45,90,68,83,62,28,13,12,401
660280113,22,33,43,38,36,13,7,8,200
660280114,15,26,38,52,64,44,4,4,247
660280115,15,25,46,52,34,13,3,2,190
660280116,21,22,23,29,16,6,2,7,126
660280117,31,37,84,86,58,31,21,19,367
660280118,23,48,75,88,71,43,17,11,376
660280119,19,30,98,85,53,21,8,15,329
660280120,18,29,20,33,20,21,7,20,168
660280121,19,20,22,24,25,13,2,7,132
660280201,64,52,48,40,35,15,7,7,268
660280202,17,25,44,55,31,16,10,4,202
660280203,16,5,2,0,0,2,0,0,25
660280204,2,5,2,1,1,0,1,1,13
660280205,29,46,47,73,24,11,1,0,231
660280206,33,48,51,56,40,28,11,15,282
660280207,22,51,88,108,69,40,12,9,399
660280208,12,52,111,56,26,11,6,3,277
660280301,1,3,1,1,0,1,0,0,7
660280302,21,1,4,3,0,0,0,1,30
660280303,5,5,1,1,1,0,1,1,15
660280304,7,7,3,3,3,2,0,0,25
660280401,63,61,37,57,31,20,6,10,285
660280402,25,40,49,71,53,41,27,30,336
660280403,42,37,48,49,52,38,19,20,305
660280404,37,47,67,72,80,59,23,30,415
660280405,32,41,77,72,76,58,24,44,424
660280406,48,52,74,75,63,54,22,45,433
660280407,19,37,47,56,63,42,17,42,323
660280408,19,30,62,79,53,66,21,35,365
660280409,77,58,52,61,37,25,13,9,332
660280410,45,54,51,41,31,31,12,7,272
660280411,58,67,31,35,21,11,2,3,228
660280412,146,62,81,69,45,11,8,10,432
660280413,103,100,82,73,38,22,12,14,444
660280414,87,68,38,35,20,13,6,3,270
660280415,57,42,52,49,37,30,19,16,302
660280416,80,51,49,48,25,13,5,7,278
660280417,53,52,81,85,81,57,26,63,498
660280418,20,41,47,42,48,32,31,32,293
660280419,24,32,45,49,52,57,16,19,294
660280420,14,27,22,39,34,29,11,33,209
660280421,42,38,41,41,30,24,14,10,240
660280422,47,50,84,60,57,40,27,51,416
660280423,116,69,60,75,42,35,21,42,460
660280501,32,54,76,68,64,45,27,28,394
660280502,19,40,35,43,31,18,10,6,202
660280503,14,40,32,42,35,38,19,21,241
660280504,13,21,31,68,52,26,10,12,233
660280505,18,24,41,57,52,42,15,15,264
660280506,27,46,57,56,37,31,24,24,302
660280507,33,61,80,65,48,26,13,20,346
660280508,33,55,62,63,36,33,9,27,318
660280509,46,43,43,41,43,34,19,31,300
660280510,69,70,71,77,49,42,14,24,416
660280511,50,39,47,48,28,24,8,8,252
660280512,41,43,41,37,46,27,9,5,249
660280513,30,54,54,47,42,9,5,6,247
660280514,33,49,41,38,34,20,10,7,232
660280515,23,39,39,61,53,26,5,10,256
660280516,45,71,87,81,60,28,16,12,400
660280517,44,81,66,78,44,21,10,10,354
660280518,34,51,59,40,20,12,1,5,222
660280519,26,33,50,36,18,14,3,2,182
660280520,41,42,35,50,24,10,10,2,214
660280601,38,68,56,71,52,26,4,16,331
660280602,43,60,58,75,52,22,13,12,335
660280603,74,79,71,84,31,17,11,7,374
660280604,60,57,72,48,45,22,3,11,318
660280605,37,59,84,82,35,32,15,13,357
660280606,21,47,49,47,39,18,10,4,235
660280607,42,48,45,52,38,23,7,7,262
660280608,36,70,54,56,40,26,3,9,294
660280609,21,40,49,36,20,18,7,6,197
660280610,58,73,46,51,43,14,10,3,298
660280611,48,75,100,69,47,24,8,11,382
660280612,31,54,51,45,39,13,4,3,240
660280613,25,62,44,50,24,14,3,4,226
660280614,28,60,35,54,31,10,4,1,223
660280615,26,58,47,58,24,7,1,5,226
660280616,52,80,86,64,39,11,10,6,348
660280617,29,48,53,36,33,14,6,1,220
660280618,30,40,37,36,29,15,4,4,195
660280619,55,66,61,45,48,22,10,11,318
660280620,56,52,48,45,27,12,7,5,252
660280621,84,97,74,63,42,38,16,21,435
660280622,106,95,75,65,41,30,16,7,435
660280701,43,48,66,60,55,31,15,17,335
660280702,33,51,70,79,62,31,10,22,358
660280703,27,44,50,55,41,38,11,22,288
660280704,22,43,70,56,30,22,19,27,289
660280705,31,38,39,49,32,36,16,13,254
660280706,28,44,40,47,31,28,13,19,250
660280707,50,51,73,72,65,52,15,33,411
660280708,43,58,53,72,62,44,16,20,368
660280709,55,65,72,71,54,45,16,23,401
660280710,45,58,67,64,56,33,16,24,363
660280711,49,68,81,84,71,56,24,37,470
660280712,20,39,43,34,39,20,5,9,209
660280713,32,47,60,56,40,37,15,25,312
660280714,38,70,57,55,37,26,12,20,315
660280715,47,47,61,50,41,23,19,26,314
660280716,33,62,49,58,52,38,17,23,332
660280717,47,49,57,58,37,27,13,29,317
660280801,0,0,0,0,0,0,0,0,0
660280802,36,38,47,43,30,21,5,7,227
660280803,45,39,37,34,30,26,12,11,234
660280804,62,56,50,52,30,14,6,14,284
660280805,47,68,40,39,32,23,5,7,261
660280806,48,50,59,54,32,25,5,11,284
660280807,39,52,49,33,25,35,11,8,252
660280808,33,40,43,43,48,27,9,10,253
660280809,61,67,90,78,76,41,28,27,468
660280810,31,51,49,60,27,24,13,18,273
660280811,29,36,50,45,33,21,13,8,235
660280812,35,29,45,47,35,20,9,10,230
660280813,55,62,52,44,39,17,9,11,289
660280814,53,49,38,25,13,10,2,3,193
660280815,55,51,36,35,22,14,5,8,226
660280901,34,64,71,111,65,32,3,8,388
660280902,51,71,85,112,72,29,11,5,436
660280903,27,49,38,52,35,25,11,17,254
660280904,19,45,49,32,32,31,15,27,250
660280905,58,84,67,93,62,38,17,24,443
660280906,42,54,78,77,60,39,24,31,405
660280907,27,45,43,67,52,21,5,6,266
660280908,46,48,51,66,47,31,12,12,313
660280909,59,84,72,65,53,36,16,20,405
660280910,21,46,48,26,35,14,3,5,198
660280911,30,52,26,29,28,14,10,5,194
660280912,35,50,62,36,19,5,5,3,215
660280913,65,67,52,42,35,9,5,6,281
660280914,46,72,49,55,41,22,7,7,299
660280915,30,52,34,46,20,11,4,3,200
660280916,37,49,49,40,24,12,7,3,221
660281001,38,59,51,50,27,20,5,5,255
660281002,62,81,62,52,37,23,4,9,330
660281003,73,75,72,55,29,38,7,9,358
660281004,74,63,62,52,39,18,9,10,327
660281005,99,90,59,47,16,12,1,3,327
660281006,95,89,82,54,32,19,9,10,390
660281007,60,81,49,26,21,11,5,3,256
660281008,32,45,36,27,12,11,3,3,169
660281009,54,81,55,55,21,10,6,9,291
660281010,77,100,41,51,24,7,3,2,305
660281011,37,50,32,27,13,4,2,3,168
660281012,43,52,48,45,26,12,5,11,242
660281013,33,46,40,36,26,13,6,6,206
660281101,54,62,69,45,16,10,2,6,264
660281102,43,44,32,26,16,5,2,2,170
660281103,88,104,64,33,21,5,3,7,325
660281104,68,65,33,31,22,10,2,3,234
660281105,76,83,41,28,28,9,5,6,276
660281106,50,47,54,36,21,8,6,3,225
660281107,36,58,46,35,27,4,4,1,211
660281108,47,67,24,26,12,3,2,0,181
660281109,56,59,31,24,8,5,1,1,185
660281110,90,67,29,18,10,2,4,1,221
660281111,69,50,33,22,10,3,4,2,193
660281112,66,52,35,20,28,6,2,3,212
660281113,76,50,38,20,2,3,0,0,189
660281114,73,68,49,23,13,4,3,0,233
660281115,57,25,21,11,7,4,1,3,129
660281116,19,37,17,12,8,5,0,0,98
660281201,23,68,61,52,41,20,5,2,272
660281202,50,55,46,37,19,14,3,1,225
660281203,31,61,41,33,24,5,6,3,204
660281204,32,65,61,32,18,8,0,0,216
660281205,22,43,39,28,9,11,0,2,154
660281206,22,44,39,15,19,7,1,3,150
660281207,52,61,26,21,13,3,1,0,177
660281208,16,46,40,32,12,8,3,2,159
660281209,30,49,41,24,18,8,3,1,174
660281210,42,65,35,38,35,23,6,9,253
660281211,52,64,62,58,43,15,13,18,325
660281212,51,49,98,94,71,45,21,33,462
660281213,49,64,83,103,62,61,24,34,480
660281214,33,40,55,46,31,31,16,16,268
660281215,33,36,41,56,27,29,16,24,262
660281301,66,64,44,27,26,11,0,1,239
660281302,60,38,17,11,4,2,0,0,132
660281303,69,75,44,45,16,6,3,2,260
660281304,41,41,35,30,16,7,0,3,173
660281305,88,97,63,69,36,23,6,10,392
660281306,75,81,37,56,25,13,4,3,294
660281307,103,99,72,55,27,19,3,8,386
660281308,55,51,54,30,13,13,3,1,220
660281309,37,42,39,26,10,3,0,2,159
660281310,33,58,40,29,26,11,3,1,201
660281311,46,36,26,22,7,4,1,1,143
660281401,54,77,72,51,28,21,10,8,321
660281402,52,96,78,62,37,21,5,12,363
660281403,68,76,66,53,32,22,9,8,334
660281404,53,58,51,43,26,13,7,3,254
660281405,63,54,57,39,29,26,5,10,283
660281406,91,98,78,59,40,26,11,16,419
660281407,64,69,69,72,51,40,15,16,396
660281408,63,64,78,64,57,30,11,19,386
660281409,73,84,74,51,38,28,18,21,387
660281410,64,73,44,60,31,26,15,29,342
660281411,88,88,89,73,67,31,17,28,481
660281412,56,66,89,81,59,29,15,25,420
660281413,67,91,84,62,57,23,19,20,423
660281414,32,52,55,40,32,21,6,10,248
660281501,22,24,39,67,39,18,12,6,227
660281502,33,42,50,74,63,50,33,45,390
660281503,32,54,58,55,83,59,38,28,407
660281504,28,62,66,93,73,34,13,20,389
660281505,21,26,76,74,64,33,20,35,349
660281506,19,42,57,66,48,37,26,31,326
660281507,33,41,55,73,45,40,21,50,358
660281508,22,38,49,51,39,30,16,23,268
660281509,49,37,62,43,32,25,6,22,276
660281510,40,45,49,45,39,21,15,15,269
660281511,43,55,71,58,55,44,22,38,386
660281512,44,55,63,55,57,46,23,34,377
660281513,22,33,51,48,45,30,20,27,276
660281514,48,61,68,53,35,14,6,6,291
660281515,65,90,82,74,47,33,12,24,427
660281516,52,68,48,61,30,24,6,6,295
660281517,29,37,56,40,35,15,7,5,224
660281518,38,51,67,55,36,35,21,23,326
660281519,38,45,42,44,37,16,7,15,244
660281520,40,46,55,47,37,20,11,17,273
660281521,28,45,29,46,39,29,7,14,237
660281522,53,43,63,55,54,39,17,20,344
660281523,46,43,59,44,35,15,12,20,274
660281524,50,81,75,80,70,52,12,24,444
660281525,50,44,65,59,53,33,23,27,354
660281601,62,63,71,59,63,41,13,30,402
660281602,71,80,92,107,101,52,28,38,569
660281603,23,46,37,46,30,23,9,19,233
660281604,32,48,66,53,51,25,15,15,305
660281605,55,82,79,74,51,40,8,22,411
660281606,50,80,71,61,47,28,21,17,375
660281607,44,54,63,53,52,16,13,11,306
660281608,25,34,37,52,50,28,28,31,285
660281609,33,50,56,48,44,31,27,28,317
660281610,39,58,67,54,51,38,15,32,354
660281611,32,58,70,86,52,37,11,20,366
660281612,19,51,54,52,40,25,12,18,271
660281613,20,36,32,43,37,33,13,30,244
660281614,26,58,46,71,54,32,11,27,325
660281615,19,41,53,43,32,31,11,32,262
660281616,41,43,57,56,43,38,20,34,332
660281617,40,59,82,90,59,44,32,31,437
660281618,21,56,69,98,75,43,23,27,412
660281619,51,64,71,72,88,48,29,49,472
660281701,58,67,52,39,24,16,4,6,266
660281702,38,47,51,37,32,14,7,6,232
660281703,65,48,48,39,29,14,11,8,262
660281704,60,66,40,34,18,11,7,2,238
660281705,46,57,44,54,40,22,9,8,280
660281706,45,50,44,27,20,16,9,10,221
660281707,52,85,68,71,43,37,10,19,385
660281708,47,69,66,63,44,35,8,29,361
660281709,50,56,54,67,45,27,18,20,337
660281710,33,41,27,33,23,31,8,15,211
660281711,39,43,35,24,40,20,8,21,230
660281712,49,67,70,63,54,35,19,31,388
660281713,41,58,52,64,33,31,15,39,333
660281714,51,48,86,83,60,47,22,39,436
660281715,42,49,54,52,47,24,12,17,297
660281716,44,48,57,64,43,31,15,28,330
660281801,79,80,63,48,34,14,10,8,336
660281802,78,83,74,90,44,35,12,18,434
660281803,44,56,55,42,29,18,10,8,262
660281804,29,38,43,34,24,29,7,21,225
660281805,55,45,46,43,22,20,14,20,265
660281806,41,46,56,60,37,30,12,13,295
660281807,47,45,39,42,34,23,6,13,249
660281808,39,55,42,50,22,26,4,11,249
660281809,59,64,38,43,30,17,12,12,275
660281810,42,41,48,36,42,36,6,12,263
660281811,75,57,91,61,42,29,13,18,386
660281812,47,50,55,50,44,19,12,9,286
660281813,29,47,50,54,29,49,17,23,298
660281814,52,43,64,49,50,38,23,23,342
660281815,36,33,52,41,36,24,8,19,249
660281816,50,47,58,59,31,22,9,20,296
660281817,43,40,57,59,38,29,10,21,297
660281818,28,28,45,46,41,44,8,21,261
660281901,34,48,63,82,55,37,20,25,364
660281902,23,46,52,66,52,39,22,17,317
660281903,31,39,46,41,31,30,18,17,253
660281904,38,33,54,56,31,23,11,20,266
660281905,27,40,68,88,65,42,17,24,371
660281906,42,58,56,52,45,36,16,18,323
660281907,41,55,68,57,33,34,19,19,326
660281908,27,49,56,54,34,34,14,11,279
660281909,24,34,34,50,39,32,18,25,256
660281910,36,51,76,60,82,50,31,41,427
660281911,26,52,72,60,50,30,12,25,327
660281912,31,36,39,36,32,18,16,12,220
660281913,45,76,66,63,40,24,9,15,338
660281914,25,32,50,65,50,31,18,29,300
660281915,26,27,56,66,50,30,20,23,298
660282001,24,25,47,64,36,15,5,7,223
660282002,20,47,67,84,47,26,14,11,316
660282003,30,53,58,45,32,18,6,4,246
660282004,42,57,57,52,35,25,13,14,295
660282005,35,59,52,35,21,15,1,2,220
660282006,35,52,47,35,22,15,1,0,207
660282007,53,60,68,78,60,35,20,24,398
660282008,54,49,54,59,34,31,14,23,318
660282009,38,53,72,56,49,38,17,32,355
660282010,19,22,39,42,26,14,20,33,215
660282011,30,54,56,52,54,44,24,47,361
660282012,33,36,60,58,55,42,13,36,333
660282013,14,21,36,27,37,38,25,32,230
660282014,19,48,53,54,56,40,20,31,321
660282015,27,43,59,59,50,38,20,31,327
660282016,14,33,53,66,48,40,19,45,318
660282017,22,26,50,56,44,37,23,54,312
660282018,30,54,73,91,75,55,29,60,467
660282019,48,32,69,49,23,21,12,9,263
660282101,50,67,66,35,16,12,4,2,252
660282102,55,61,52,35,16,5,1,0,225
660282103,16,28,33,33,16,8,4,1,139
660282104,28,78,56,75,55,33,23,19,367
660282105,33,58,95,116,56,44,25,25,452
660282106,47,77,75,89,53,41,19,13,414
660282107,46,51,63,57,26,28,12,7,290
660282108,24,35,45,50,30,17,11,4,216
660282109,34,63,44,59,22,9,2,5,238
660282110,59,53,32,23,4,4,3,0,178
660282111,30,38,48,42,28,27,8,11,232
660282112,14,37,55,47,46,17,12,1,229
660282113,15,31,43,45,39,25,13,29,240
660282114,29,41,59,36,37,21,4,10,237
660282115,15,72,69,82,45,43,10,32,368
660282116,29,39,71,79,76,46,34,35,409
660282117,29,60,72,90,61,28,17,24,381
660282118,40,75,67,59,35,30,11,10,327
660282119,43,66,73,76,41,28,16,12,355
660282120,32,49,68,56,65,38,11,22,341
660282121,39,68,79,82,46,41,19,24,398
660282122,34,65,71,63,55,38,7,7,340
660282123,23,32,62,70,41,13,3,10,254
660282124,30,47,56,46,32,26,10,6,253
660282201,44,62,70,64,46,28,13,10,337
660282202,33,39,48,36,25,17,9,12,219
660282203,13,31,42,68,59,37,23,39,312
660282204,14,40,55,76,70,47,34,54,390
660282205,34,62,43,34,39,24,8,8,252
660282206,29,47,56,40,35,20,10,16,253
660282207,23,45,45,53,33,21,8,11,239
660282208,24,37,56,85,57,28,3,4,294
660282209,25,56,58,81,60,23,6,1,310
660282210,30,39,65,95,65,31,4,3,332
660282211,18,45,55,75,56,19,5,2,275
660282212,19,72,73,92,68,33,15,14,386
660282213,25,41,57,61,63,44,15,26,332
660282214,27,49,78,95,67,44,17,19,396
660282301,19,31,41,54,61,59,32,38,335
660282302,24,36,42,42,43,31,22,27,267
660282303,25,61,67,69,78,49,36,46,431
660282304,23,42,57,42,68,46,23,45,346
660282305,34,54,58,67,39,54,32,42,380
660282306,39,44,64,65,43,46,30,34,365
660282307,32,33,56,57,58,48,32,38,354
660282308,29,39,48,64,52,41,25,56,354
660282309,19,44,54,80,58,54,23,57,389
660282310,12,47,54,73,60,39,22,37,344
660282311,27,31,66,78,57,51,38,35,383
660282312,13,23,33,60,41,44,28,49,291
660282313,16,29,41,52,53,56,40,53,340
660282314,24,36,52,56,63,62,33,41,367
660282315,32,47,49,52,59,88,13,23,363
660282316,13,17,44,81,70,42,16,19,302
660282317,13,22,47,75,60,46,29,35,327
660282318,11,31,55,73,59,46,19,30,324
660282401,15,12,31,31,14,6,3,0,112
660282402,19,31,38,48,42,19,2,2,201
660282403,16,40,62,45,51,46,20,21,301
660282404,20,40,58,85,65,34,27,40,369
660282405,16,29,51,73,63,48,29,30,339
660282406,24,37,44,59,49,22,28,35,298
660282407,16,17,35,52,34,21,11,26,212
660282408,29,50,37,70,57,55,34,55,387
660282409,30,23,65,48,62,60,21,37,346
660282410,20,61,90,86,67,48,24,49,445
660282411,12,33,42,82,65,67,28,47,376
660282412,28,38,60,67,67,57,41,70,428
660282501,59,85,83,100,65,25,13,14,444
660282502,25,43,56,50,41,17,6,5,243
660282503,30,32,41,58,40,22,10,4,237
660282504,41,38,48,68,47,24,7,6,279
660282505,19,35,28,35,27,8,7,3,162
660282506,40,50,40,38,39,20,9,6,242
660282507,35,50,49,53,35,35,5,15,277
660282508,43,68,72,81,61,28,15,25,393
660282509,24,38,49,68,45,19,8,6,257
660282510,17,48,69,109,78,36,11,12,380
660282511,23,49,75,83,68,53,21,12,384
660282512,30,45,64,74,40,21,2,0,276
660282513,21,34,40,58,44,14,7,5,223
660282514,27,57,64,71,42,32,12,9,314
660282515,32,59,72,117,50,28,5,3,366
660282601,29,41,53,72,43,32,14,16,300
660282602,21,46,56,64,59,33,24,8,311
660282603,19,47,75,75,54,31,16,11,328
660282604,23,31,43,54,39,26,8,17,241
660282605,23,42,50,52,48,27,11,13,266
660282606,35,39,57,67,60,35,15,11,319
660282607,17,48,110,142,74,35,18,19,463
660282608,15,44,107,104,82,49,22,24,447
660282609,15,61,76,107,70,68,24,37,458
660282610,19,38,81,101,90,71,35,28,463
660282611,31,35,66,80,67,59,20,36,394
660282612,51,35,66,92,81,73,45,46,489
660282613,15,32,98,97,81,63,20,29,435
660282614,21,50,62,103,80,69,32,43,460
660282615,13,31,53,66,58,49,26,37,333
660282616,19,23,58,63,51,39,29,34,316
660282617,33,63,68,85,95,60,30,15,449
660282618,8,44,90,99,51,33,8,9,342
660282619,17,36,67,87,63,46,24,28,368
660282620,15,37,52,89,58,47,16,20,334
660282701,29,35,44,44,34,25,18,24,253
660282702,8,31,63,79,37,13,6,17,254
660282703,20,38,59,64,57,48,20,29,335
660282704,40,51,59,68,55,25,20,36,354
660282705,35,43,54,51,41,36,12,26,298
660282706,18,39,40,50,40,29,12,16,244
660282707,18,24,34,42,43,33,23,20,237
660282708,23,28,26,50,49,35,26,22,259
660282709,18,32,41,53,56,40,27,22,289
660282710,20,44,40,39,43,40,10,19,255
660282711,30,48,59,45,42,42,17,26,309
660282712,34,47,51,53,52,37,19,28,321
660282713,43,52,69,81,51,39,25,35,395
660282714,25,50,69,45,43,38,15,31,316
660282715,41,41,58,50,56,39,18,45,348
660282801,23,40,37,41,34,21,8,5,209
660282802,18,39,34,38,34,17,9,9,198
660282803,21,46,51,56,30,20,8,6,238
660282804,47,62,53,44,29,7,3,3,248
660282805,33,64,71,93,37,21,5,6,330
660282806,38,48,77,90,77,49,26,15,420
660282807,34,60,61,68,40,29,14,26,332
660282808,25,53,54,49,52,32,18,15,298
660282809,46,66,96,121,75,62,15,24,505
660282810,39,52,64,77,56,34,33,48,403
660282811,23,44,71,63,64,33,18,27,343
660282812,10,45,55,50,36,36,24,40,296
660282813,32,66,69,94,65,47,27,43,443
660282814,36,40,54,41,30,25,7,19,252
660282815,15,30,45,56,29,21,10,22,228
660350101,15,8,10,12,10,3,0,5,63
660350102,24,27,39,44,31,21,8,8,202
660350103,41,35,38,25,28,28,12,16,223
660350104,2,7,5,0,2,1,0,0,17
660350105,25,18,30,28,18,6,5,14,144
660350106,75,55,51,52,34,39,13,40,359
660350107,8,6,0,4,2,5,1,7,33
660350108,27,26,28,28,21,16,8,19,173
660350109,55,54,75,85,77,47,16,50,459
660350110,18,37,53,74,39,32,10,22,285
660350111,32,50,47,37,50,29,15,17,277
660350112,28,55,70,55,39,26,11,10,294
660350113,30,46,56,53,29,28,20,21,283
660350114,35,34,43,51,39,23,17,40,282
660350115,28,45,37,30,27,18,9,18,212
660350116,20,47,54,55,45,40,23,29,313
660350117,36,62,72,55,65,54,21,41,406
660350118,11,27,28,44,38,28,11,35,222
660350119,8,16,29,38,29,23,14,17,174
660350120,20,29,37,49,47,41,23,41,287
660350121,17,22,24,38,26,22,11,29,189
660350122,19,44,85,69,56,32,9,8,322
660350123,35,38,74,72,49,42,16,17,343
660350124,28,51,73,91,56,35,5,8,347
660350201,16,26,55,62,61,53,21,39,333
660350202,50,32,30,30,24,25,16,15,222
660350203,64,32,44,16,17,15,6,16,210
660350204,5,4,2,2,1,1,0,0,15
660350205,15,5,6,5,5,2,1,6,45
660350206,18,29,33,41,49,31,18,27,246
660350207,25,8,14,12,10,14,4,4,91
660350208,21,24,21,17,25,21,13,21,163
660350209,34,43,61,50,39,28,19,22,296
660350210,33,53,50,59,54,40,17,39,345
660350211,31,44,52,46,37,31,10,19,270
660350212,48,48,58,61,48,48,19,30,360
660420101,40,23,4,14,5,7,0,5,98
660420102,20,11,7,4,3,2,1,3,51
660420103,40,32,37,49,34,18,18,24,252
660420104,69,64,70,60,65,50,27,37,442
660420105,29,20,11,22,16,11,9,20,138
660420106,29,19,22,33,30,23,7,27,190
660420107,13,5,20,16,1,6,8,2,71
660420108,20,32,39,43,27,28,13,27,229
660420109,33,42,43,53,45,19,15,27,277
660420110,29,28,35,38,27,14,13,20,204
660420111,32,33,45,44,45,22,15,27,263
660420201,15,10,22,24,17,11,10,16,125
660420202,19,22,32,31,25,20,7,26,182
660420203,34,41,63,80,55,31,23,36,363
660420204,1,2,0,1,0,0,0,0,4
660420205,53,60,75,94,53,62,21,33,451
660420206,43,43,63,79,64,56,13,45,406
660420207,33,53,63,62,59,31,15,20,336
660420208,38,53,69,66,58,39,17,31,371
660420209,35,45,44,31,34,23,11,27,250
660420210,40,38,40,45,30,20,17,16,246
660490101,7,5,4,2,2,2,1,1,24
660490102,15,13,5,5,3,8,5,4,58
660490103,31,16,15,32,17,13,11,8,143
660490104,53,61,64,70,54,41,16,32,391
660490105,21,46,66,79,55,41,22,44,374
660490106,36,34,57,50,44,24,14,28,287
660490107,36,52,71,56,46,25,15,28,329
660490201,20,16,10,10,7,7,4,20,94
660490202,6,5,2,6,3,1,1,1,25
660490203,8,1,1,0,0,0,0,0,10
660490204,17,9,8,2,6,1,0,3,46
660490205,9,11,16,24,15,6,4,1,86
660490206,12,9,3,7,2,4,2,5,44
660490207,9,2,3,2,1,1,0,0,18
660490208,13,8,4,3,3,2,0,0,33
660490209,3,6,4,0,3,3,2,6,27
660490210,1,4,4,0,3,0,1,0,13
660490211,13,24,57,49,38,26,7,9,223
660490212,8,19,45,42,48,23,14,15,214
660490213,29,31,54,65,56,41,17,50,343
660490214,14,26,34,50,31,35,8,27,225
660490215,7,26,29,46,38,34,16,25,221
660490216,14,17,32,35,30,23,17,19,187
660490217,21,44,62,77,46,26,29,21,326
660490301,40,17,35,30,21,20,6,15,184
660490302,22,28,36,44,36,27,15,20,228
660490303,5,6,2,5,8,1,2,2,31
660490304,30,26,33,40,32,19,15,18,213
660490305,41,59,67,72,49,33,20,31,372
660490306,11,19,37,36,31,17,11,38,200
660490307,15,18,48,49,31,19,13,25,218
660490308,28,34,59,50,28,14,9,9,231
660490309,23,30,39,35,32,23,15,13,210
660490401,28,78,70,62,40,24,9,7,318
660490402,16,32,50,65,25,24,13,21,246
660490403,30,44,65,56,65,46,21,33,360
660490404,47,49,66,61,32,36,7,22,320
660490405,48,57,66,49,31,43,14,12,320
660490406,29,35,43,36,30,21,10,12,216
660490407,25,25,39,44,37,25,10,10,215
660490408,60,51,58,42,20,23,4,13,271
660490409,37,41,57,54,43,39,16,20,307
660490410,31,44,68,90,77,48,32,55,445
660490411,33,50,45,55,31,24,11,19,268
660490412,26,44,52,54,29,23,10,24,262
660490413,52,61,72,50,38,12,7,5,297
660490414,32,36,38,37,17,25,9,14,208
660490415,24,32,50,36,35,26,9,28,240
660490416,37,52,53,44,35,32,14,26,293
660490417,50,57,44,50,29,16,2,0,248
660490418,46,50,58,50,34,20,10,9,277
660490419,29,31,39,39,29,17,9,15,208
660490420,29,35,40,23,26,24,6,11,194
660490421,23,28,32,54,18,32,9,16,212
660490422,31,35,37,51,27,16,6,6,209
660560101,7,4,5,4,0,4,3,5,32
660560102,38,37,42,60,48,36,19,31,311
660560103,24,32,39,32,27,26,8,26,214
660560104,15,2,2,2,1,1,0,0,23
660560105,18,29,56,63,41,47,10,28,292
660560106,25,38,74,77,57,58,16,42,387
660560107,17,19,40,54,61,25,14,10,240
660560108,22,21,46,54,31,11,9,9,203
660560109,22,39,36,45,36,30,14,37,259
660560110,39,48,58,45,37,15,6,6,254
660560111,22,43,38,38,28,26,4,24,223
660560112,69,78,91,92,73,48,14,28,493
660560113,13,17,27,31,21,19,4,16,148
660560114,28,33,46,48,33,28,20,40,276
660560115,16,15,39,31,40,36,21,24,222
660560116,9,13,21,24,12,21,8,14,122
660560117,21,28,40,54,36,31,16,22,248
660560118,34,25,37,47,54,43,8,24,272
660560119,34,38,63,57,50,48,11,37,338
660560120,8,20,33,21,20,28,13,25,168
660560201,9,7,8,6,7,11,3,6,57
660560202,17,15,24,24,22,9,3,5,119
660560203,34,45,49,42,36,43,20,50,319
660560204,26,24,30,44,30,43,25,67,289
660560205,24,13,16,17,13,17,4,14,118
660560206,8,8,7,2,5,4,2,16,52
660560207,9,9,4,4,2,10,0,3,41
660560208,15,9,18,14,17,18,7,24,122
660560209,12,7,17,11,20,10,8,16,101
660560210,32,57,66,57,49,36,9,14,320
660560211,23,33,40,43,36,29,18,14,236
660560212,30,28,46,48,25,26,11,9,223
660560213,67,60,76,76,54,28,15,21,397
660560214,25,36,52,36,17,13,6,8,193
660560215,37,32,32,34,20,23,8,9,195
660560216,14,29,34,36,35,17,16,29,210
660560217,32,26,51,32,23,14,4,8,190
660560218,40,47,64,56,46,40,11,15,319
660560301,40,26,34,34,32,31,16,24,237
660560302,29,31,34,34,29,28,10,38,233
660560303,18,28,21,18,22,9,4,12,132
660560304,24,17,27,20,32,24,9,18,171
660560305,13,7,13,23,29,46,11,90,232
660560306,36,53,62,41,44,71,7,16,330
660560307,21,28,21,29,33,61,18,37,248
660560401,22,27,19,25,18,17,4,16,148
660560402,39,38,39,33,28,19,5,21,222
660560403,33,31,27,28,16,12,2,9,158
660560404,2,2,1,0,0,1,0,0,6
660560405,13,33,70,55,50,33,10,26,290
660560406,10,11,11,8,9,13,0,1,63
660560407,11,10,22,20,11,9,2,3,88
660560408,31,36,49,45,29,20,8,10,228
660560409,20,24,36,20,19,22,12,7,160
660560410,32,30,51,39,35,44,12,40,283
660560411,22,25,41,28,24,18,13,9,180
660560501,1,5,5,1,0,6,0,0,18
660560502,15,6,6,4,6,2,0,0,39
660560503,9,18,14,9,13,12,5,6,86
660560504,28,31,30,30,32,36,19,28,234
660560505,29,35,31,40,43,26,10,19,233
660560601,17,2,2,2,2,0,1,0,26
660560602,9,11,16,5,10,6,5,17,79
660560603,27,25,18,28,14,16,8,20,156
660560604,17,15,5,9,3,3,3,1,56
660560605,11,13,9,11,8,6,2,8,68
660560606,8,7,7,15,3,10,3,4,57
660560607,10,7,9,6,2,2,2,3,41
660560608,28,31,29,33,34,27,27,57,266
660560609,4,3,7,8,11,7,3,1,44
660560610,14,6,4,1,0,4,2,3,34
660560611,14,22,30,19,30,26,13,21,175
660560612,26,38,41,47,41,29,11,20,253
660560613,31,37,46,52,49,39,11,31,296
660560614,32,60,77,53,55,34,13,26,350
660560615,31,42,50,63,51,52,19,39,347
660560616,35,47,54,53,72,66,20,62,409
660560617,40,41,46,56,32,25,14,40,294
660560618,46,57,83,74,67,49,21,30,427
660560619,44,45,46,30,34,16,5,9,229
660560620,35,40,30,48,30,15,7,21,226
660560621,37,39,49,48,32,42,13,30,290
660560622,54,69,66,59,34,19,6,4,311
660560623,25,37,30,51,14,19,6,8,190
660560624,48,51,59,52,82,78,42,103,515
660560625,24,23,32,30,25,11,4,7,156
660560626,18,25,41,47,49,38,28,39,285
660560627,22,33,39,40,28,23,11,22,218
660560628,16,26,39,45,19,32,11,31,219
660560629,20,27,33,34,20,27,9,11,181
660560630,18,18,14,25,12,13,12,12,124
660560701,42,57,86,98,70,71,26,58,508
660560702,25,28,47,59,45,43,20,23,290
660560703,31,23,55,62,52,24,17,27,291
660560704,12,31,53,69,42,18,5,2,232
660560705,19,40,46,69,46,34,9,12,275
660560706,24,51,84,65,58,31,17,19,349
660560707,6,8,7,10,7,2,2,4,46
660560708,46,47,64,77,68,42,33,32,409
660560709,17,30,57,53,33,26,15,17,248
660560710,30,68,55,85,48,50,24,38,398
660560711,41,71,49,53,32,20,10,11,287
660560712,56,49,43,15,23,13,3,5,207
660560713,54,74,71,51,36,11,5,10,312
660560714,27,55,48,49,40,27,9,17,272
660560715,45,34,47,62,61,59,24,44,376
660560801,40,40,55,45,40,22,20,30,292
660560802,21,33,68,49,47,30,18,35,301
660560803,32,40,52,50,34,26,8,12,254
660560804,34,56,48,47,35,19,9,17,265
660560805,44,60,46,36,18,7,2,2,215
660560806,48,49,34,34,17,6,3,0,191
660560807,20,35,27,19,19,5,1,2,128
660560808,41,46,28,26,15,20,3,3,182
660560809,33,49,36,36,18,10,5,3,190
660560810,38,48,52,45,27,16,3,5,234
660560811,29,36,33,24,18,6,4,2,152
660560812,53,67,54,52,36,26,2,7,297
660560813,46,44,42,36,38,25,7,8,246
660560814,26,26,45,56,51,44,17,38,303
660560815,34,35,48,50,57,53,9,38,324
660560901,4,6,14,19,9,2,2,1,57
660560902,59,51,53,40,23,15,6,12,259
660560903,44,48,61,42,30,10,6,3,244
660560904,33,61,53,51,37,22,7,5,269
660560905,43,45,59,54,49,22,9,18,299
660560906,30,38,59,53,41,25,14,22,282
660560907,50,26,48,54,52,38,20,32,320
660560908,33,36,64,71,48,47,14,31,344
660560909,53,95,90,98,77,49,22,22,506
660560910,26,25,34,47,32,29,9,14,216
660560911,64,63,81,69,54,40,18,19,408
660560912,23,50,46,56,38,33,6,13,265
660560913,47,63,60,60,37,30,9,18,324
660560914,36,52,50,43,29,18,8,16,252
660560915,64,84,84,63,62,29,5,25,416
660560916,32,48,63,61,46,39,18,20,327
660560917,40,57,76,79,66,56,34,40,448
660560918,16,27,39,57,32,35,16,31,253
660560919,23,36,51,59,33,32,10,22,266
660560920,48,54,63,50,36,29,13,15,308
660560921,22,34,42,50,28,19,6,12,213
660560922,20,46,55,68,31,28,10,16,274
660560923,26,37,53,62,55,33,11,13,290
660560924,22,22,53,70,52,28,14,23,284
660560925,30,32,56,63,45,31,18,27,302
660561001,18,33,44,57,39,22,13,8,234
660561002,36,39,59,68,67,47,22,26,364
660561003,36,43,45,62,58,31,13,21,309
660561004,39,57,53,49,33,15,5,9,260
660561005,35,42,52,50,38,35,13,12,277
660561006,41,38,57,51,25,21,9,4,246
660561007,15,42,56,54,37,18,9,6,237
660561008,28,47,52,38,33,12,11,15,236
660561009,33,28,44,35,22,16,5,7,190
660561010,52,58,61,49,39,27,14,22,322
660561011,40,60,50,55,41,27,11,16,300
660561012,28,34,46,38,39,16,9,17,227
660561013,24,32,55,65,44,36,17,16,289
660561014,32,25,27,25,24,8,7,11,159
660561015,13,23,58,48,34,10,7,5,198
660630101,8,1,5,2,0,2,2,2,22
660630102,3,0,2,1,1,0,0,0,7
660630103,5,3,0,0,0,0,0,0,8
660630104,8,8,4,1,4,1,1,0,27
660630105,9,4,2,0,2,1,1,1,20
660630106,5,0,2,0,0,0,0,0,7
660630107,33,10,9,13,14,6,5,2,92
660630108,12,15,9,16,9,4,3,2,70
660630109,7,5,5,2,3,0,0,1,23
660630110,40,38,40,28,23,20,16,21,226
660630111,34,47,28,37,29,16,10,22,223
660630201,9,7,5,5,2,3,0,4,35
660630202,33,24,23,10,12,6,2,2,112
660630203,7,8,10,6,0,1,0,2,34
660700101,3,2,4,0,2,2,1,3,17
660700102,19,15,14,13,11,8,9,17,106
660700103,4,2,2,1,1,2,3,4,19
660700104,2,0,2,1,1,1,1,4,12
660700105,7,9,4,5,8,1,3,9,46
660700106,4,5,5,2,3,0,1,1,21
660700107,12,12,6,3,7,10,4,7,61
660700201,16,8,12,11,7,7,2,5,68
660700202,7,4,3,6,1,1,1,1,24
660700203,24,27,17,17,14,11,3,9,122
660700204,21,20,10,17,14,12,7,8,109
660700205,58,51,35,35,40,26,15,17,277
660700301,12,5,5,2,2,2,1,5,34
660700302,1,2,3,1,0,3,0,1,11
660700303,2,2,1,0,4,1,1,6,17
660700401,1,4,3,4,3,3,1,5,24
660700402,4,2,1,2,1,0,1,2,13
660700403,3,2,8,0,1,0,0,1,15
660700404,11,1,0,4,0,1,1,3,21
660700405,3,3,0,0,0,1,0,0,7
660700406,1,0,1,1,1,0,0,2,6
660700407,4,2,3,4,7,4,1,2,27
660700501,5,2,1,0,0,1,0,0,9
660700502,1,1,0,0,0,2,1,0,5
660700503,4,6,2,0,0,0,0,0,12
660700504,16,11,14,7,10,14,2,7,81
660700505,2,1,0,0,0,0,0,0,3
660700506,4,5,2,1,1,1,2,2,18
660700507,22,28,20,20,10,17,6,17,140
660700508,33,20,20,31,34,17,11,13,179
660770101,5,3,3,3,3,0,1,1,19
660770102,12,11,2,8,3,5,3,2,46
660770103,21,15,11,11,4,6,0,1,69
660770104,25,43,31,37,16,13,3,5,173
660770105,17,28,53,48,30,19,7,13,215
660770106,23,33,41,42,27,19,3,8,196
660770107,24,27,32,26,31,21,7,20,188
660770108,31,43,32,60,30,23,11,10,240
660770109,25,23,36,41,28,15,9,6,183
660770201,5,7,2,4,1,0,0,1,20
660770202,10,1,1,1,2,0,0,0,15
660770203,7,3,4,0,0,1,1,0,16
660770204,40,48,49,36,37,17,13,12,252
660770205,31,43,36,62,38,35,21,25,291
660770301,6,5,1,1,0,0,1,0,14
660770302,5,1,2,0,0,0,1,0,9
660770303,24,26,16,20,10,8,1,0,105
660770304,13,8,5,6,3,0,1,1,37
660840101,26,15,16,15,11,7,9,4,103
660840102,32,22,15,19,23,12,8,7,138
660840103,2,3,2,2,0,2,0,1,12
660840104,6,2,4,1,1,2,0,0,16
660840105,7,5,1,0,1,0,1,1,16
660840106,42,22,36,33,34,21,15,21,224
660840107,45,48,46,38,28,14,6,19,244
660840108,22,22,30,42,35,15,9,21,196
660840109,30,34,39,45,30,15,10,22,225
660840201,6,3,5,1,3,5,2,4,29
660840202,7,5,8,7,3,2,1,2,35
660840203,8,11,6,8,11,2,1,3,50
660840204,10,0,4,2,4,0,1,0,21
660840205,30,20,23,28,20,14,10,15,160
660910101,3,5,0,1,1,3,0,2,15
660910102,1,4,7,4,3,2,9,3,33
660910103,7,6,4,3,3,4,2,3,32
660910104,9,11,3,6,1,3,1,4,38
660910105,14,3,3,6,2,5,3,3,39
660910201,2,4,3,3,3,1,0,3,19
660910202,5,7,2,5,3,2,2,0,26
660910203,3,5,1,0,1,2,1,3,16
660910204,16,10,3,3,7,8,3,8,58
660910205,29,29,14,21,19,9,7,19,147
660980101,23,25,24,43,20,18,10,15,178
660980102,28,14,10,13,12,2,4,3,86
660980103,22,13,6,6,3,5,1,1,57
660980104,16,5,4,2,3,0,0,1,31
660980105,68,65,57,52,37,42,23,37,381
660980106,62,69,66,68,56,50,33,36,440
660980201,9,2,2,2,1,1,0,1,18
660980202,1,0,0,0,1,0,0,0,2
660980203,17,11,12,7,5,11,5,3,71
660980204,6,7,4,1,2,0,0,2,22
660980205,25,19,14,19,15,6,7,8,113
660980206,1,1,1,0,1,0,0,0,4
660980207,5,4,3,4,4,2,3,3,28
660980208,34,36,40,25,24,22,9,21,211
660980209,30,29,30,41,41,24,9,23,227
661050101,0,0,0,0,0,0,0,0,0
661050102,0,0,0,0,0,0,0,0,0
661050103,0,3,0,0,0,0,0,0,3
661050104,10,4,7,8,10,5,1,6,51
661050201,21,4,3,2,3,2,1,0,36
661050202,21,12,14,13,10,8,10,12,100
661050203,21,12,4,6,5,1,3,2,54
661050204,4,4,3,2,1,1,1,2,18
661050205,0,1,1,0,0,9,1,2,14
661050206,2,3,0,0,0,0,0,0,5
661050207,3,0,0,0,0,0,0,0,3
661050208,3,3,0,1,0,0,0,0,7
661050209,29,28,23,44,24,23,17,51,239
661050210,26,28,25,16,18,26,9,25,173
661050211,20,18,26,26,16,14,8,28,156
661050212,31,18,13,27,20,16,10,18,153
661050213,29,27,22,43,31,23,24,39,238
661120101,27,12,6,4,9,0,1,6,65
661120102,5,0,2,1,1,0,0,0,9
661120103,9,2,4,2,3,2,0,0,22
661120104,16,14,10,8,2,1,0,0,51
661120105,40,26,48,45,42,22,8,22,253
661120106,20,19,15,11,7,11,10,12,105
661120107,20,11,9,4,5,6,6,4,65
661120108,17,10,12,19,9,9,3,3,82
661120109,36,43,38,48,36,44,20,43,308
661120110,21,15,22,15,12,6,5,7,103
661120201,26,15,14,16,16,10,6,11,114
661120202,17,7,4,3,0,0,0,0,31
661120203,7,2,0,0,0,0,0,0,9
661120204,12,12,5,4,2,1,1,2,39
661120205,26,13,14,7,10,6,4,5,85
661120206,10,11,12,10,5,8,3,9,68
661120207,4,11,6,3,3,3,0,0,30
661120208,29,25,31,22,19,11,7,15,159
661120209,26,41,29,42,24,15,7,21,205
661120210,26,25,28,22,17,12,6,8,144
661120211,14,9,9,5,5,2,3,2,49
661120212,28,52,56,48,40,24,16,13,277
661120213,48,47,61,60,50,35,21,25,347
661120214,41,48,81,82,56,41,17,38,404
661120215,23,48,51,65,38,33,10,14,282
661120301,45,48,41,61,32,39,17,26,309
661120302,20,43,55,48,41,29,5,13,254
661120303,36,31,41,29,27,16,12,12,204
661120304,28,30,40,33,20,19,18,14,202
661120305,34,35,42,45,43,21,20,40,280
661120306,35,50,45,53,44,23,12,21,283
661120307,28,39,27,43,14,12,9,9,181
661120308,27,46,37,28,22,9,5,5,179
661120309,20,41,41,34,38,26,9,14,223
661120310,33,45,54,74,47,42,25,26,346
661120311,20,30,31,36,30,25,13,29,214
661120312,47,58,62,69,42,21,14,33,346
661120313,34,60,48,44,32,24,11,14,267
661120401,39,47,66,61,53,45,13,31,355
661120402,31,24,29,37,17,18,7,16,179
661120403,29,41,26,28,19,18,6,5,172
661120404,49,57,47,41,26,18,6,4,248
661120405,79,62,58,50,33,25,12,17,336
661120406,43,42,46,47,28,19,14,9,248
661120407,29,32,27,36,23,22,7,11,187
661120408,15,31,39,39,22,19,11,23,199
661120409,32,57,86,74,50,47,24,54,424
661120410,15,21,28,38,30,24,11,15,182
661120411,33,69,51,62,38,23,12,11,299
661120412,41,54,63,73,44,31,13,26,345
661120413,44,52,48,71,51,39,14,41,360
661190101,7,7,3,4,5,7,4,17,54
661190102,37,29,42,32,25,37,20,84,306
661190103,40,26,30,16,19,8,14,9,162
661190104,9,10,9,8,7,10,5,5,63
661190105,13,15,16,6,8,12,1,7,78
661190201,4,4,2,3,0,1,2,2,18
661190202,7,8,6,4,7,3,3,10,48
661190203,16,14,18,12,19,24,5,22,130
661190204,13,12,7,10,2,7,8,12,71
661190205,51,31,36,42,31,27,17,26,261
661260101,7,4,3,4,8,4,1,4,35
661260102,73,39,84,71,47,41,17,25,397
661260103,44,23,22,22,18,15,3,6,153
661260104,10,16,31,49,31,16,19,21,193
661260105,25,25,55,53,35,33,12,24,262
661260201,25,18,15,7,6,7,1,0,79
661260202,27,15,6,10,9,4,2,3,76
661260203,53,32,28,22,20,18,11,15,199
661260204,20,4,2,1,1,0,3,4,35
661260205,58,45,31,47,28,18,8,11,246
661260206,26,30,58,84,76,46,24,58,402
661260207,15,21,43,66,43,27,12,9,236
661260208,14,36,57,57,65,39,11,10,289
661260209,55,48,96,84,72,42,20,22,439
661260210,23,23,42,61,50,40,25,27,291
661260211,45,44,68,58,29,23,14,10,291
661260212,33,32,42,39,47,23,16,21,253
661260213,20,46,63,77,59,31,24,22,342
661260214,25,36,48,71,51,25,10,16,282
661260215,31,35,62,87,47,34,20,13,329
661260216,38,39,65,65,40,24,5,9,285
661260217,28,44,76,92,64,57,42,66,469
661260218,9,22,52,43,24,22,13,39,224
661260301,9,7,10,8,5,8,6,6,59
661260302,18,27,28,22,22,22,15,16,170
661260303,34,38,50,44,36,45,15,23,285
661260304,22,13,27,34,26,25,14,32,193
661260401,20,27,25,30,32,30,17,43,224
661260402,27,12,27,26,19,13,12,24,160
661260403,3,7,2,7,4,1,1,2,27
661260404,4,8,3,9,9,7,4,7,51
661260405,10,3,2,1,2,2,2,1,23
661260406,13,10,18,18,23,12,3,11,108
661260407,11,7,3,2,3,5,2,3,36
661260408,12,16,22,24,33,30,18,34,189
661260409,9,15,12,28,29,25,9,53,180
661260410,53,72,97,76,56,44,20,42,460
661260411,28,33,38,67,51,44,21,49,331
661260412,33,47,73,56,54,51,25,41,380
661260413,18,37,29,51,40,38,24,55,292
661260414,32,35,42,46,34,29,9,39,266
661260415,41,54,65,69,40,26,8,14,317
661260416,38,46,68,74,57,44,9,21,357
661260417,7,14,35,34,23,14,6,13,146
661260418,12,26,45,48,36,25,14,23,229
661260501,8,4,1,1,0,0,0,0,14
661260502,25,26,64,51,36,26,15,23,266
661260503,0,2,0,0,1,1,1,0,5
661260504,27,30,59,54,45,27,14,20,276
661260505,6,24,43,63,52,34,14,17,253
661260506,11,25,38,38,33,31,22,27,225
661260507,35,50,79,73,59,37,13,13,359
661260508,26,46,48,65,53,41,13,23,315
661260509,47,60,73,59,52,36,23,28,378
661260510,31,39,34,50,35,35,19,40,283
661260511,43,41,45,36,48,30,26,27,296
661260601,42,34,42,45,23,22,13,18,239
661260602,39,8,5,3,6,5,1,3,70
661260603,69,40,26,26,21,16,4,20,222
661260604,25,7,1,1,0,6,0,2,42
661260605,13,12,13,4,6,9,7,3,67
661260606,5,6,6,5,0,3,0,2,27
661260607,4,3,5,3,3,4,1,1,24
661260608,2,3,3,0,0,0,0,0,8
661260609,26,36,46,37,43,40,35,92,355
661260610,21,30,37,55,44,40,39,85,351
661260611,27,28,48,54,44,71,29,85,386
661260612,13,16,21,35,43,35,15,60,238
661260613,19,40,62,50,39,46,13,33,302
661260614,29,41,38,45,46,38,27,53,317
661260615,43,41,63,52,34,31,13,27,304
661260616,29,29,35,54,37,33,24,40,281
661260617,40,43,49,38,25,17,10,16,238
661260618,15,25,49,56,40,19,13,15,232
661260619,29,38,60,62,55,42,22,50,358
661260620,20,59,58,69,58,40,14,35,353
661260621,24,33,44,36,31,16,6,10,200
661260622,14,30,24,33,35,21,11,28,196
661260623,14,24,31,26,19,15,3,4,136
661260624,45,39,52,44,32,29,14,21,276
661260625,16,26,26,42,21,17,9,19,176
661260701,34,38,48,60,54,56,23,58,371
661260702,14,29,36,36,43,50,31,72,311
661260703,15,14,30,38,47,37,18,59,258
661260704,11,41,58,70,35,30,16,11,272
661260705,22,34,38,42,33,11,14,15,209
661260706,34,43,54,67,42,24,9,17,290
661260707,25,43,55,64,56,35,16,23,317
661260708,25,37,67,55,58,41,18,36,337
661260709,32,49,79,77,86,63,29,40,455
661260710,29,39,37,33,40,21,7,13,219
661260711,31,42,35,45,26,17,8,8,212
661260712,30,42,43,43,29,15,6,5,213
661260713,13,20,36,53,48,56,33,61,320
661260714,26,33,32,54,42,44,24,40,295
661260715,35,42,39,42,19,15,3,4,199
661260716,58,45,28,27,21,10,2,0,191
661260717,42,59,57,48,43,23,6,18,296
661260718,40,53,62,55,34,19,9,10,282
661260719,21,25,28,40,20,17,4,11,166
661260720,26,32,49,48,49,32,19,32,287
661260721,28,73,59,58,30,28,10,16,302
661260722,29,34,44,39,31,22,9,10,218
661260723,35,35,42,44,53,39,12,29,289
661260801,28,38,53,47,54,46,23,71,360
661260802,35,61,53,44,35,30,8,12,278
661260803,33,36,29,23,20,10,1,2,154
661260804,30,38,31,27,23,19,5,9,182
661260805,36,43,33,33,24,17,8,6,200
661260806,39,47,46,35,17,15,6,2,207
661260807,28,26,45,37,20,17,9,11,193
661260808,25,31,38,35,30,24,12,15,210
661260809,25,34,71,91,65,54,21,58,419
661260810,22,26,29,34,41,22,15,17,206
661260811,27,23,37,34,36,29,13,32,231
661260812,22,28,35,66,64,62,32,70,379
661260813,26,40,56,58,52,51,22,53,358
661260814,49,64,64,63,48,38,32,32,390
661260815,37,65,43,57,53,21,12,28,316
661260816,46,74,62,57,34,29,9,16,327
661260817,53,48,65,54,55,48,11,24,358
661260818,55,65,92,82,68,77,33,49,521
661260819,27,34,61,58,50,43,20,32,325
661260820,25,34,25,32,21,12,3,0,152
661260821,40,51,75,69,55,28,20,24,362
661260822,39,58,62,78,49,34,13,25,358
661260823,31,45,43,44,48,30,20,30,291
661260824,38,42,83,86,46,49,32,39,415
661330101,65,58,114,82,97,101,33,112,662
661330102,35,55,76,86,61,61,25,48,447
661330103,31,17,14,18,18,21,4,8,131
661330104,15,21,31,17,10,7,7,8,116
661330105,10,11,9,9,10,7,2,6,64
661330106,30,32,37,37,28,41,16,30,251
661330107,44,48,53,56,63,43,26,52,385
661330108,61,55,72,81,44,58,16,42,429
661330201,6,7,2,6,2,5,2,3,33
661330202,9,4,2,4,3,1,0,5,28
661330203,6,16,18,13,15,13,4,16,101
661330204,6,3,4,4,5,3,2,6,33
661330205,9,4,4,4,3,1,2,1,28
661330206,8,5,6,2,7,3,2,5,38
661330207,7,4,7,3,2,2,0,1,26
661330208,14,31,41,19,24,28,6,10,173
661330209,6,11,10,8,11,4,2,4,56
661330210,28,12,8,16,20,7,2,5,98
661330211,13,13,6,11,7,8,5,7,70
661330212,12,13,16,10,8,5,2,6,72
661330213,4,6,3,7,4,7,2,7,40
661330214,47,33,18,18,15,20,8,4,163
661330215,10,2,4,6,2,0,1,3,28
661330216,30,39,40,41,28,25,13,27,243
661330217,11,6,4,7,2,3,0,2,35
661330218,7,9,8,6,4,10,2,9,55
661330219,13,21,22,22,22,13,4,11,128
661330220,38,36,47,34,28,27,20,21,251
661330221,29,39,46,48,40,39,16,16,273
661330222,27,26,20,24,16,17,3,6,139
661330223,26,41,35,34,31,32,6,6,211
661330224,30,43,34,32,25,31,12,31,238
661330301,33,30,29,26,14,34,9,13,188
661330302,25,20,16,12,14,7,5,12,111
661330303,4,6,4,6,5,6,1,2,34
661330304,28,27,33,29,35,23,8,37,220
661330305,17,24,25,23,28,16,12,23,168
661330306,41,32,25,37,36,37,10,17,235
661330307,13,4,8,11,3,4,1,5,49
661330308,5,8,12,11,14,11,7,16,84
661330309,31,22,37,46,39,24,15,17,231
661330310,29,37,41,41,42,23,16,22,251
661330311,40,34,50,40,31,33,11,17,256
661330312,50,39,45,39,36,29,15,29,282
661400101,4,8,3,3,0,2,0,1,21
661400102,10,3,7,4,5,3,1,2,35
661400103,10,7,5,6,8,3,2,2,43
661400104,2,2,1,3,0,1,0,0,9
661400105,14,11,3,5,1,0,0,0,34
661400106,12,6,5,2,0,1,1,0,27
661400107,7,11,7,9,6,2,0,0,42
661400108,29,13,13,12,10,13,6,6,102
661400109,1,4,0,1,0,0,0,0,6
661400110,16,13,14,7,9,6,4,3,72
661400111,19,2,7,5,1,0,1,1,36
661400112,12,7,6,3,1,4,1,2,36
661400113,21,15,12,7,11,3,4,1,74
661400114,6,14,7,13,5,4,3,1,53
661400115,10,16,7,6,2,2,2,4,49
661400116,25,34,42,52,39,37,18,19,266
661400117,47,44,65,68,62,43,18,23,370
661400118,7,34,44,62,44,21,9,11,232
661400119,25,46,49,69,48,36,10,15,298
661400120,18,50,50,55,44,32,19,23,291
661400121,27,62,108,112,76,49,25,34,493
661400201,5,6,2,1,1,1,0,0,16
661400202,2,7,1,7,0,0,1,1,19
661400203,10,9,9,3,1,6,1,2,41
661400204,14,11,8,6,0,3,1,2,45
661400205,9,17,14,13,4,0,1,0,58
661400301,7,15,4,6,1,0,0,0,33
661400302,3,3,5,2,3,3,1,0,20
661400303,8,1,2,0,0,0,0,0,11
661400304,20,12,12,10,14,10,5,13,96
661400305,2,4,3,0,0,3,0,0,12
661400306,3,2,1,1,0,0,2,1,10
661400307,7,6,6,3,1,2,2,0,27
661400308,8,3,1,0,2,1,0,0,15
661400309,7,2,3,2,1,2,0,0,17
661400310,27,22,16,14,24,18,7,4,132
661400311,31,22,23,13,17,14,8,5,133
661400312,18,28,23,30,23,11,6,6,145
661400401,45,69,56,64,47,18,7,8,314
661400402,61,47,55,48,41,18,8,23,301
661400403,42,70,54,52,31,12,6,6,273
661400404,24,58,48,42,25,11,4,6,218
661400405,37,34,47,44,37,39,12,24,274
661400406,35,44,42,34,25,17,5,9,211
661400407,43,46,38,34,24,10,2,7,204
661400408,49,65,51,36,20,7,5,3,236
661400409,56,53,60,50,52,30,15,38,354
661400410,44,71,65,58,45,32,13,15,343
661400411,28,50,55,66,41,24,7,16,287
661400412,50,47,62,36,34,21,8,13,271
661400413,53,56,42,39,29,12,7,5,243
661400414,44,58,69,70,39,29,16,18,343
661400415,47,49,58,53,43,42,13,20,325
661400416,19,38,28,39,27,18,5,13,187
661470101,2,3,4,2,5,2,3,7,28
661470102,5,5,4,9,0,2,1,8,34
661470103,6,7,7,2,4,4,1,3,34
661470104,13,6,11,2,3,3,4,4,46
661470105,15,1,5,3,9,2,2,4,41
661470201,9,3,4,1,3,4,2,5,31
661470202,18,7,4,10,6,2,0,1,48
661470203,4,3,1,3,1,5,1,2,20
661470204,0,2,3,1,2,0,2,2,12
661470205,13,8,2,1,5,2,1,6,38
661470301,3,2,3,1,1,5,1,5,21
661470302,14,5,9,3,4,6,2,4,47
661470303,7,2,0,1,0,2,0,0,12
661470304,3,4,1,0,0,0,0,1,9
661470305,12,10,2,3,2,2,0,1,32
661470306,29,28,26,10,14,7,7,13,134
661470307,100,69,79,99,84,57,31,45,564
661470308,5,0,0,0,0,0,1,1,7
661470309,1,1,1,2,3,3,1,1,13
661470310,1,2,0,2,1,1,0,0,7
661470311,36,38,49,58,45,29,26,35,316
661470312,46,45,49,45,40,49,20,31,325
661470313,39,32,33,23,19,16,8,15,185
661470314,20,30,28,24,13,13,4,12,144
661470315,40,54,68,74,64,43,21,53,417
661470316,25,42,59,73,49,36,22,30,336
661470317,29,28,50,46,53,48,24,57,335
661470401,54,56,46,45,34,30,16,20,301
661470402,40,24,18,19,20,23,11,25,180
661470403,24,16,10,10,8,7,5,17,97
661470404,24,16,17,12,14,13,5,21,122
661470405,20,11,7,5,6,6,4,3,62
661470406,0,3,1,0,0,1,0,0,5
661470407,26,56,45,70,67,62,41,88,455
661470408,37,37,51,64,50,45,29,58,371
661470409,59,47,37,42,37,28,9,18,277
661470501,29,25,35,38,28,25,13,28,221
661470502,14,21,23,55,41,28,20,24,226
661470503,9,10,35,52,25,33,16,39,219
661470504,33,53,53,60,37,40,15,26,317
661470505,23,26,43,52,26,27,13,15,225
661470506,27,40,39,56,26,23,16,18,245
661470507,30,43,46,45,33,35,4,22,258
661470508,18,18,36,44,26,23,16,18,199
661470509,53,47,55,50,24,25,12,19,285
661470510,25,55,54,60,48,40,14,39,335
661470511,39,54,52,65,59,29,21,35,354
661470512,35,32,38,35,13,14,3,3,173
661470513,30,29,47,50,40,25,14,39,274
661470514,37,38,47,56,44,31,17,24,294
661470515,26,23,32,46,42,27,22,19,237
661540101,3,1,7,2,4,8,3,7,35
661540102,13,5,7,7,6,10,6,15,69
661540103,7,5,7,2,2,2,1,1,27
661540104,0,0,1,0,0,0,0,0,1
661540105,22,17,27,17,25,20,12,23,163
661540106,33,22,31,25,23,13,17,22,186
661540201,25,12,7,5,8,1,1,2,61
661540202,8,3,4,3,2,0,2,0,22
661540203,12,5,5,8,5,4,4,6,49
661540204,6,8,4,3,0,1,2,2,26
661540205,3,2,2,2,0,0,1,1,11
661540206,9,4,5,3,4,3,2,9,39
661540207,21,12,6,6,4,2,0,3,54
661540208,16,19,16,15,8,9,8,13,104
661540209,37,41,34,44,34,24,26,37,277
661540210,34,49,53,49,31,35,18,31,300
661540211,37,36,28,41,27,30,16,13,228
661610101,14,13,12,8,5,2,3,6,63
661610102,34,23,22,31,24,36,16,27,213
661610103,37,28,36,28,24,27,16,47,243
661610104,10,15,7,5,5,8,2,4,56
661610105,22,24,22,18,15,16,5,20,142
661610106,9,6,7,6,5,4,3,8,48
661610107,16,19,6,5,9,6,2,4,67
661610108,11,7,10,9,4,5,3,3,52
661610109,15,11,7,16,8,16,4,13,90
661610110,61,39,54,46,34,32,8,24,298
661610201,19,15,17,15,9,9,5,4,93
661610202,20,16,18,9,9,13,4,8,97
661610203,13,11,11,16,9,7,4,4,75
661610204,12,6,10,7,5,3,2,5,50
661610205,40,37,50,50,30,34,9,12,262
661610301,20,13,12,4,9,11,4,5,78
661610302,21,16,11,15,17,13,6,13,112
661610303,12,10,6,5,5,1,1,1,41
661610304,20,20,35,33,28,18,11,17,182
661610305,11,6,5,5,3,3,4,15,52
661610306,40,37,30,44,30,18,16,16,231
700070101,29,49,71,60,67,34,10,10,330
700070102,38,69,97,80,57,25,11,12,389
700070103,32,57,55,65,38,24,15,17,303
700070104,37,48,50,54,34,23,9,8,263
700070201,25,29,55,44,65,24,19,25,286
700070202,25,33,54,47,34,22,10,11,236
700070203,23,37,42,53,28,10,10,8,211
700070204,18,40,74,92,74,53,34,45,430
700070205,53,76,92,78,65,42,22,25,453
700070206,25,50,57,65,49,44,17,16,323
700070207,15,24,23,37,21,21,10,10,161
700070301,34,37,60,85,57,42,26,42,383
700070302,14,36,45,49,38,19,9,11,221
700070303,15,20,19,23,14,18,4,7,120
700070304,18,33,44,36,21,28,10,7,197
700070305,6,5,9,14,9,7,3,4,57
700070306,25,36,46,43,46,22,16,24,258
700070307,19,33,49,71,50,39,23,25,309
700070308,25,41,50,63,30,25,16,21,271
700070401,14,33,27,34,22,13,11,5,159
700070402,18,21,18,18,19,13,12,18,137
700070403,30,60,60,69,43,37,14,12,325
700070501,4,10,8,3,4,5,1,6,41
700140101,16,19,20,19,17,16,7,6,120
700140102,24,21,23,21,28,9,7,7,140
700140103,35,58,60,76,50,48,11,15,353
700140104,19,33,36,46,30,23,13,17,217
700140105,27,37,39,49,31,29,16,13,241
700140106,25,66,67,71,50,13,11,14,317
700140107,37,37,94,85,76,37,22,29,417
700140201,9,13,16,11,8,9,2,6,74
700140202,9,16,25,25,14,10,8,14,121
700140301,3,2,0,1,2,6,0,1,15
700210101,19,15,15,15,7,3,4,10,88
700210201,30,50,68,59,37,25,9,19,297
700210202,9,5,11,8,6,7,3,2,51
700210203,41,34,51,47,40,19,19,18,269
700210204,9,5,11,5,6,7,2,9,54
700210205,4,2,3,3,1,0,0,0,13
700210301,16,12,14,16,17,15,4,3,97
700210302,32,50,50,31,27,28,10,22,250
700210401,44,36,56,57,34,18,4,15,264
700210402,4,7,7,5,9,2,4,1,39
700210403,34,54,60,56,50,31,4,10,299
700210404,30,52,43,76,50,27,17,30,325
700210405,3,3,6,7,7,3,5,6,40
700210501,6,0,1,2,1,0,0,1,11
700210601,6,3,1,0,0,0,0,0,10
700210701,3,2,1,0,0,1,2,0,9
700210702,1,0,0,0,0,0,0,0,1
700280101,59,88,53,52,23,7,2,1,285
700280102,79,76,39,26,12,4,3,1,240
700280103,65,81,39,31,16,7,3,0,242
700280104,47,76,40,35,17,7,0,0,222
700280105,33,32,26,11,10,1,0,1,114
700280106,46,69,51,48,20,11,1,2,248
700280107,44,55,20,18,14,5,1,1,158
700280108,78,80,30,23,4,3,0,0,218
700280109,58,49,24,22,3,0,2,0,158
700280110,69,74,44,28,14,1,3,2,235
700280111,56,76,35,24,12,3,1,0,207
700280112,59,53,60,36,18,3,2,1,232
700280113,40,48,23,21,10,3,1,0,146
700280114,87,77,37,20,10,4,1,0,236
700280115,61,38,19,17,7,2,0,0,144
700280116,62,57,33,35,8,8,1,2,206
700280117,66,34,33,16,8,4,1,1,163
700280118,66,62,28,17,4,2,0,0,179
700280201,25,57,43,65,33,23,9,8,263
700280202,25,65,64,64,42,11,9,11,291
700280203,24,56,74,98,62,21,9,6,350
700280204,15,33,26,51,35,13,4,1,178
700280205,28,38,44,43,32,16,3,2,206
700280206,36,64,42,33,22,12,3,3,215
700280207,27,43,40,54,21,9,2,4,200
700280208,25,37,55,32,16,9,5,8,187
700280209,37,44,54,57,24,11,5,1,233
700280210,41,56,62,56,38,11,2,0,266
700280211,36,58,30,30,13,11,2,5,185
700280212,26,34,33,22,15,4,1,3,138
700280213,32,46,44,28,15,7,3,6,181
700280301,23,34,38,44,30,26,17,12,224
700280302,26,40,58,31,30,19,12,10,226
700280303,28,62,60,61,43,38,15,18,325
700280304,36,50,60,77,42,29,13,16,323
700280305,43,74,55,46,37,20,3,9,287
700280306,63,73,76,47,32,6,2,2,301
700280307,26,49,50,30,17,16,6,1,195
700280308,36,60,41,57,37,21,6,4,262
700280309,52,75,58,53,31,13,5,4,291
700280310,27,42,43,29,22,10,8,2,183
700280311,37,36,34,36,28,11,9,7,198
700280312,44,51,28,26,17,8,3,2,179
700280313,46,67,70,54,36,26,8,11,318
700280314,32,50,39,41,24,13,2,5,206
700280315,43,46,24,20,16,3,0,1,153
700280316,72,90,66,40,18,13,5,4,308
700280317,28,57,43,33,17,6,2,2,188
700280318,24,52,44,61,44,31,14,23,293
700280319,50,49,46,30,23,8,0,3,209
700280320,28,49,43,24,12,4,1,1,162
700280321,50,51,32,27,15,7,0,2,184
700280401,30,38,22,21,10,4,5,1,131
700280402,34,41,41,28,22,5,6,3,180
700280403,35,66,63,29,27,5,1,2,228
700280404,33,38,40,38,9,7,0,1,166
700280405,55,75,63,43,28,16,6,4,290
700280406,78,99,52,33,20,12,4,3,301
700280407,50,69,44,42,20,12,1,2,240
700280408,46,65,61,53,34,15,8,2,284
700280409,20,50,46,33,16,14,5,3,187
700280410,21,44,58,55,42,17,6,5,248
700280411,18,40,50,34,20,9,2,3,176
700280412,54,97,62,49,41,22,10,3,338
700280413,14,45,69,60,37,15,3,4,247
700280414,25,46,49,78,58,18,5,3,282
700280501,67,79,52,46,32,15,2,2,295
700280502,57,81,67,51,29,15,2,3,305
700280503,27,48,41,30,10,7,1,0,164
700280504,50,92,61,46,35,19,3,1,307
700280505,39,35,34,19,13,3,3,1,147
700280506,38,98,76,55,36,21,5,0,329
700280507,33,37,42,28,29,12,2,0,183
700280508,30,51,44,35,50,10,4,2,226
700280509,17,51,40,45,20,12,0,0,185
700280510,27,41,42,43,34,9,3,1,200
700280511,30,91,75,50,39,12,2,1,300
700280512,60,53,45,28,18,4,5,0,213
700280513,37,45,46,57,24,13,4,1,227
700280514,33,42,33,20,19,5,1,0,153
700280515,30,38,29,39,22,18,4,12,192
700280516,14,49,51,49,22,5,2,0,192
700280601,30,39,52,56,39,35,22,37,310
700280602,14,40,52,84,58,30,8,6,292
700280603,35,52,43,31,26,16,7,4,214
700280604,34,47,53,41,28,16,12,6,237
700280605,36,86,71,67,33,16,5,1,315
700280606,24,37,45,24,22,12,5,5,174
700280607,38,49,55,43,22,18,7,7,239
700280608,48,67,62,61,46,14,4,3,305
700280609,65,73,56,46,28,14,5,2,289
700280610,33,56,32,28,17,14,1,3,184
700280611,30,59,60,55,38,14,6,7,269
700280612,55,90,61,45,20,5,3,1,280
700280613,66,84,75,49,22,8,2,3,309
700280614,40,57,42,35,26,11,3,3,217
700280615,23,43,62,52,30,23,11,5,249
700280616,16,26,32,28,17,14,4,7,144
700280617,21,34,59,96,54,22,7,8,301
700280618,13,40,43,51,43,35,18,22,265
700280619,38,42,27,30,16,6,0,0,159
700280701,72,107,46,63,28,13,7,6,342
700280702,82,66,37,36,11,9,2,0,243
700280703,41,61,54,56,36,22,9,7,286
700280704,60,89,55,64,34,14,10,5,331
700280705,57,81,54,38,22,21,10,6,289
700280706,45,73,62,43,27,9,4,3,266
700280707,47,62,56,59,45,28,6,6,309
700280708,50,72,62,49,30,21,9,10,303
700280709,58,67,62,49,36,28,9,13,322
700280710,33,59,48,47,38,18,13,11,267
700280711,41,60,58,61,48,32,5,11,316
700280712,39,73,75,60,48,30,14,8,347
700280713,30,42,42,44,25,18,8,7,216
700280714,38,61,52,65,40,29,9,11,305
700280715,46,62,53,50,29,9,1,2,252
700280716,44,41,28,22,14,5,2,0,156
700280801,13,36,50,58,33,20,4,12,226
700280802,26,40,44,40,22,14,1,4,191
700280803,32,54,37,37,33,10,3,5,211
700280804,25,39,34,34,17,14,2,7,172
700280805,25,57,51,45,29,19,8,4,238
700280806,35,90,50,52,28,8,2,1,266
700280807,40,69,52,44,30,12,2,2,251
700280808,60,49,32,33,12,4,4,2,196
700280809,84,89,54,55,26,16,2,1,327
700280810,59,84,72,43,32,17,5,6,318
700280811,33,51,35,30,18,8,7,2,184
700280901,70,90,60,71,31,9,6,4,341
700280902,71,77,53,39,34,10,6,3,293
700280903,48,41,49,38,21,12,1,2,212
700280904,40,24,41,32,19,7,3,4,170
700280905,49,73,54,39,28,9,3,2,257
700280906,48,53,34,22,10,4,0,0,171
700280907,40,59,43,39,17,8,0,5,211
700280908,41,66,71,85,42,18,5,6,334
700280909,33,41,61,55,33,10,7,4,244
700280910,47,61,66,51,26,11,5,1,268
700280911,12,17,12,21,14,3,1,4,84
700280912,38,28,25,39,18,9,5,5,167
700280913,28,39,40,29,24,8,1,2,171
700280914,35,44,39,31,15,10,1,1,176
700280915,38,85,58,47,41,21,8,6,304
700280916,30,76,59,53,45,19,17,8,307
700350101,22,47,64,68,45,43,16,33,338
700350102,26,49,53,48,49,36,16,24,301
700350103,22,45,73,48,49,27,20,33,317
700350104,36,45,44,38,42,27,14,25,271
700350105,34,49,67,75,39,35,15,30,344
700350106,30,44,43,71,49,32,11,16,296
700350107,12,39,38,47,34,22,11,28,231
700350108,30,67,45,47,44,24,21,22,300
700350109,32,45,48,45,32,24,20,16,262
700350110,36,62,64,33,22,18,16,8,259
700350111,46,82,73,45,34,23,5,4,312
700350112,47,83,50,54,38,25,11,12,320
700350113,35,38,51,50,36,22,14,7,253
700350114,50,98,71,62,31,20,7,9,348
700350201,23,44,35,47,41,15,13,14,232
700350202,13,15,15,29,18,20,7,9,126
700350203,25,37,48,36,33,32,19,18,248
700350204,18,22,31,35,18,13,13,17,167
700350205,13,23,61,51,22,4,0,1,175
700350301,23,30,34,48,41,22,23,31,252
700350302,25,20,43,50,32,30,23,26,249
700350401,14,14,22,7,15,9,8,15,104
700350402,12,49,40,40,39,25,14,20,239
700350403,13,31,31,40,32,24,8,29,208
700350501,17,16,12,19,21,13,7,10,115
700350502,12,6,11,12,7,10,5,5,68
700350503,10,18,15,18,11,6,8,9,95
700350601,6,2,3,4,3,1,2,3,24
700350602,14,13,13,7,6,8,3,11,75
700350701,30,25,30,37,32,28,13,18,213
700350702,39,79,85,85,61,60,19,23,451
700350703,20,39,46,49,35,27,10,20,246
700350704,33,38,44,47,28,19,13,12,234
700350705,29,52,67,65,58,21,8,8,308
700350706,12,28,32,54,47,21,4,9,207
700350707,16,28,49,51,46,25,19,29,263
700350708,7,32,32,56,48,27,12,7,221
700350709,17,39,37,81,59,31,10,10,284
700350710,49,41,33,36,37,17,15,17,245
700350711,15,34,35,45,39,29,25,29,251
700420101,12,29,39,37,35,18,10,10,190
700420102,23,49,70,77,62,52,27,22,382
700420103,25,44,50,57,37,30,8,8,259
700420104,25,63,65,77,68,46,16,15,375
700420105,19,41,48,93,46,49,18,8,322
700420106,29,61,81,86,45,40,22,20,384
700420107,17,41,41,45,29,19,8,9,209
700420108,24,36,39,51,43,31,17,15,256
700420109,15,36,58,36,45,31,19,8,248
700420110,18,46,55,60,40,27,9,18,273
700420111,10,12,26,29,40,38,20,28,203
700420112,10,32,38,31,34,22,19,20,206
700420201,26,51,74,93,69,43,10,5,371
700420202,14,25,28,38,45,33,12,15,210
700420203,20,42,59,68,71,42,27,36,365
700420204,34,76,89,79,82,58,20,44,482
700420205,21,52,62,60,57,18,7,10,287
700420206,21,39,70,80,55,40,8,14,327
700420207,39,68,94,104,87,70,22,22,506
700420208,19,32,38,43,38,30,12,12,224
700420209,26,57,65,84,66,46,16,12,372
700420210,12,46,65,65,71,37,9,8,313
700420211,21,33,38,52,31,22,11,10,218
700420212,19,43,73,106,62,57,29,14,403
700420213,27,58,64,79,58,53,8,14,361
700420214,30,56,54,52,32,32,16,12,284
700420215,21,38,32,48,32,24,13,12,220
700420216,14,43,80,76,69,38,20,25,365
700420217,24,49,50,75,69,42,15,26,350
700420301,16,26,39,53,53,32,12,37,268
700420302,29,47,65,58,42,48,20,14,323
700420303,23,45,60,63,51,37,14,18,311
700420304,7,9,15,5,5,4,1,2,48
700420401,14,31,62,65,49,33,11,16,281
700420402,21,49,92,112,89,60,26,42,491
700420403,16,35,41,50,38,27,8,12,227
700420404,35,49,72,63,55,41,19,25,359
700420405,14,45,52,64,49,39,27,20,310
700420406,8,23,41,86,62,42,44,53,359
700420407,13,29,46,102,67,44,14,19,334
700420408,6,18,38,62,47,38,28,28,265
700420409,7,37,43,53,41,26,9,22,238
700420410,28,34,32,51,49,29,15,12,250
700420411,10,25,42,60,44,29,9,11,230
700420412,34,70,65,72,51,49,17,9,367
700420413,29,74,75,68,45,25,24,20,360
700420414,28,46,78,82,68,39,22,47,410
700420415,22,52,60,63,50,20,13,9,289
700420416,26,49,65,84,64,22,10,1,321
700420417,47,75,92,88,75,34,12,24,447
700420418,24,37,29,43,35,15,8,10,201
700420419,23,34,29,33,39,13,8,5,184
700420501,43,83,75,86,55,30,14,18,404
700420502,20,48,70,73,58,35,12,14,330
700420503,21,48,55,56,35,27,6,5,253
700420504,21,31,66,70,64,24,19,20,315
700420505,28,46,60,82,73,58,16,36,399
700420506,18,59,57,75,56,36,23,23,347
700420507,13,35,49,90,52,72,30,20,361
700420508,32,60,73,60,51,24,11,20,331
700420509,27,62,79,66,37,24,11,19,325
700420510,30,87,103,93,63,29,12,11,428
700420511,17,54,56,59,34,19,4,9,252
700420512,20,49,61,77,46,23,6,8,290
700420513,30,56,60,60,41,21,15,19,302
700420514,28,65,80,89,67,42,14,35,420
700420515,29,42,50,55,24,29,7,15,251
700490101,17,20,20,11,12,9,6,3,98
700490102,2,7,4,6,7,1,2,1,30
700490201,23,21,16,12,18,13,2,8,113
700490202,18,22,40,31,14,23,9,14,171
700490203,26,49,41,63,35,24,6,12,256
700490204,32,46,50,51,36,17,6,15,253
700490205,15,31,26,39,24,15,7,11,168
700490206,16,9,9,18,10,8,3,10,83
700490207,37,46,43,38,28,22,12,12,238
700490301,6,13,11,17,15,8,6,11,87
700490302,16,26,34,43,20,19,8,6,172
700490303,7,9,18,13,9,6,7,7,76
700490401,3,3,0,1,1,0,0,0,8
700560101,18,21,33,35,23,24,7,14,175
700560102,28,40,43,57,19,40,17,26,270
700560103,28,29,21,29,20,11,12,13,163
700560104,22,30,40,33,22,21,15,24,207
700560105,25,59,71,64,57,22,18,31,347
700560106,12,10,24,25,21,9,8,7,116
700560107,6,17,17,19,11,15,6,6,97
700560108,7,20,29,30,22,13,10,12,143
700560109,9,32,44,42,24,9,7,9,176
700560201,29,40,37,59,44,20,12,17,258
700560202,32,48,64,42,31,26,9,10,262
700560203,49,57,55,60,38,27,11,10,307
700560204,19,36,23,30,9,8,5,4,134
700560205,31,55,50,53,29,23,12,11,264
700560206,25,45,53,64,36,28,9,6,266
700560207,19,32,44,39,32,12,11,9,198
700560208,28,49,56,66,43,26,8,8,284
700560209,25,43,40,45,39,15,9,8,224
700560210,3,10,10,8,8,5,5,9,58
700560211,33,62,69,70,36,25,12,11,318
700560212,33,35,48,46,28,14,14,4,222
700560213,14,47,43,39,26,11,5,3,188
700560301,26,17,20,21,19,11,8,10,132
700560302,32,42,34,43,36,29,9,20,245
700560401,6,5,3,3,2,0,0,3,22
700560501,4,1,1,0,1,1,0,1,9
700560601,13,10,5,8,7,3,6,13,65
700560701,26,33,31,23,17,15,7,6,158
700560702,14,16,9,6,5,2,2,3,57
700630101,8,23,17,21,22,18,7,5,121
700630102,12,23,34,35,27,23,11,16,181
700630103,31,45,64,86,56,37,18,30,367
700630104,5,7,15,11,18,9,4,4,73
700630105,4,2,10,4,6,2,2,4,34
700630106,19,28,37,62,43,42,22,16,269
700630201,9,5,8,9,7,4,1,1,44
700630202,13,29,59,77,57,46,24,21,326
700630203,26,54,54,70,45,25,13,15,302
700630204,26,34,37,49,32,28,19,15,240
700630205,26,52,51,58,35,26,6,10,264
700700101,17,39,54,49,37,31,12,16,255
700700102,32,72,68,76,60,40,27,24,399
700700103,34,63,67,75,67,47,28,21,402
700700104,20,43,53,75,53,25,6,13,288
700700105,21,59,50,69,44,26,20,19,308
700700106,23,44,51,50,48,26,12,20,274
700700107,13,37,54,61,45,32,12,12,266
700700108,25,43,59,45,42,27,11,12,264
700700109,34,53,68,49,38,13,3,10,268
700700110,44,42,38,39,19,10,7,3,202
700700111,23,54,30,49,27,19,2,7,211
700700112,32,50,67,49,40,31,11,6,286
700700113,18,66,67,74,60,30,9,9,333
700700114,51,82,84,74,49,40,15,36,431
700700115,13,62,83,87,52,23,8,6,334
700700201,4,9,11,16,12,9,8,4,73
700700202,11,16,13,20,16,14,5,13,108
700700203,58,66,64,52,42,45,6,16,349
700700204,16,32,32,35,36,19,13,25,208
700700205,31,36,46,45,36,28,11,12,245
700700206,49,92,106,92,102,51,18,19,529
700700207,42,100,103,106,99,48,29,22,549
700700301,19,25,35,42,28,15,6,17,187
700700302,27,35,40,40,37,26,12,19,236
700700303,23,32,39,39,34,27,16,16,226
700700304,32,56,56,49,46,21,17,17,294
700700305,15,28,26,20,16,12,5,7,129
700700401,7,8,2,11,2,4,2,3,39
700700501,24,34,44,60,50,32,19,32,295
700700502,18,46,40,62,46,19,4,9,244
700700503,9,31,54,73,43,22,16,15,263
700700504,11,20,32,32,30,30,6,16,177
700700505,16,23,26,58,51,31,17,13,235
700700506,14,23,39,74,54,40,24,25,293
700700507,6,29,49,55,57,58,15,13,282
700700508,35,54,48,64,37,37,12,17,304
700700509,19,61,69,58,39,22,12,14,294
700700510,14,33,33,81,73,34,10,22,300
700700511,40,54,72,91,79,42,31,37,446
700700512,26,45,61,97,58,48,21,20,376
700700513,23,64,64,80,51,29,15,17,343
700700514,27,65,78,74,58,47,14,16,379
700700515,29,68,70,77,41,35,13,15,348
700700516,12,35,88,88,72,45,16,21,377
700700517,11,29,55,62,67,40,15,20,299
700700518,19,43,33,53,31,15,5,7,206
700770101,16,33,38,38,22,9,4,2,162
700770102,27,66,100,98,76,69,21,25,482
700770103,1,0,0,0,0,0,0,2,3
700770104,13,27,28,67,62,44,20,34,295
700770105,8,21,35,49,37,31,25,26,232
700770106,17,34,38,55,41,29,16,20,250
700770201,36,58,72,77,53,27,18,13,354
700770202,35,49,77,71,71,31,20,20,374
700770203,23,65,63,72,49,35,19,20,346
700770204,38,70,69,76,55,31,19,18,376
700770205,38,69,58,66,49,32,16,17,345
700770206,20,48,74,91,66,32,7,6,344
700770207,23,69,73,63,40,34,17,10,329
700770208,32,78,82,82,55,47,20,17,413
700770209,28,52,69,69,52,26,10,2,308
700770210,23,28,47,32,20,20,5,4,179
700770211,16,38,59,63,59,25,6,3,269
700770212,13,27,43,50,41,21,16,18,229
700770213,19,36,64,76,58,35,11,13,312
700770301,28,68,55,35,37,17,11,11,262
700770302,41,62,53,56,39,19,7,6,283
700770303,26,54,54,58,31,27,12,11,273
700770304,36,70,66,71,45,33,17,16,354
700770305,26,52,56,50,38,22,15,13,272
700770306,45,63,80,61,53,34,15,12,363
700770307,52,67,77,74,54,43,11,13,391
700770308,19,47,49,51,40,14,5,7,232
700770309,33,63,61,63,59,24,10,13,326
700770310,42,76,72,70,50,21,13,13,357
700770311,42,68,74,64,49,24,13,8,342
700770312,16,69,38,37,36,22,7,8,233
700770313,37,42,47,50,35,22,8,9,250
700770401,33,38,33,39,27,17,10,8,205
700770402,25,33,48,43,20,14,0,5,188
700770403,24,45,41,49,28,15,8,8,218
700770404,39,50,50,52,38,18,4,9,260
700770405,39,57,65,42,28,19,7,7,264
700770406,29,68,70,66,46,16,7,4,306
700770407,25,48,66,85,46,20,4,1,295
700770408,33,52,57,55,27,13,4,5,246
700770409,26,46,33,39,26,16,9,6,201
700770410,55,86,64,61,52,22,10,9,359
700770411,21,42,45,38,34,14,7,7,208
700770412,42,68,79,69,47,30,7,10,352
700770413,25,56,34,41,24,10,2,5,197
700770414,17,43,43,43,30,17,4,10,207
700770415,20,45,43,37,24,33,10,9,221
700770416,14,31,42,37,32,27,11,14,208
700770501,24,53,58,71,34,19,9,8,276
700770502,34,62,44,62,62,28,15,27,334
700770503,12,37,57,54,31,21,5,5,222
700770504,15,24,26,31,19,22,2,9,148
700770505,17,30,46,63,41,20,7,4,228
700770506,9,20,32,40,21,13,6,6,147
700770507,13,36,54,76,56,26,16,9,286
700770508,14,43,31,49,44,19,7,11,218
700770509,6,13,37,42,23,18,9,8,156
700770510,12,40,65,68,59,40,24,19,327
700770511,19,54,90,88,63,30,18,13,375
700770512,12,35,46,90,72,37,4,3,299
700770601,32,67,74,63,38,30,14,10,328
700770602,28,51,57,56,31,26,10,17,276
700770603,8,22,30,34,17,16,4,4,135
700770701,26,44,34,33,35,24,12,19,227
700770702,15,29,47,45,18,14,9,4,181
700770703,14,24,20,27,25,18,7,9,144
700770801,27,34,31,40,19,19,6,8,184
700770802,24,34,38,41,35,25,9,8,214
700770803,42,79,90,73,61,38,8,11,402
700770804,21,42,45,44,35,29,14,12,242
700770805,31,50,65,58,35,36,20,24,319
700770806,30,44,80,83,81,53,20,20,411
700770807,19,27,48,44,28,29,15,13,223
700770808,10,38,47,58,57,22,11,19,262
700770809,38,56,67,72,55,44,15,16,363
700770810,19,55,71,88,77,57,28,10,405
700770811,7,23,45,53,38,26,25,34,251
700770812,16,43,60,70,43,28,17,12,289
700770813,41,76,90,105,66,42,21,18,459
700770814,29,49,66,54,47,31,8,9,293
700770815,24,45,53,69,43,26,9,15,284
700770901,43,80,55,55,32,13,13,8,299
700770902,42,59,47,46,26,20,8,9,257
700770903,31,59,66,52,32,18,11,6,275
700770904,27,66,66,58,52,20,16,13,318
700770905,20,36,43,54,90,65,35,55,398
700770906,21,27,46,60,46,30,14,26,270
700770907,8,38,49,53,36,38,13,20,255
700770908,18,35,50,42,37,30,22,16,250
700770909,4,16,29,51,46,43,18,35,242
700770910,36,43,57,58,62,36,15,19,326
700770911,48,69,59,73,56,16,4,15,340
700770912,31,57,64,52,42,25,11,5,287
700771001,23,42,47,37,25,14,5,6,199
700771002,45,85,85,82,54,31,19,19,420
700771003,34,54,33,38,27,13,6,7,212
700771004,32,54,61,63,48,32,6,9,305
700771005,25,38,71,81,42,20,15,9,301
700771006,21,64,81,55,36,40,12,6,315
700771007,21,62,59,68,65,37,10,20,342
700771008,24,47,41,47,34,18,14,8,233
700771009,19,40,40,47,33,17,4,7,207
700771010,35,90,61,56,36,20,3,7,308
700771011,27,45,56,56,32,13,2,2,233
700771012,12,38,44,50,30,23,8,7,212
700771013,17,44,67,87,69,27,10,12,333
700840101,1,3,2,2,0,1,1,3,13
700840102,9,7,13,18,10,8,1,1,67
700840201,13,29,62,63,36,40,14,20,277
700840202,14,29,26,41,45,26,11,15,207
700840203,21,35,55,54,44,33,6,14,262
700840204,14,52,59,87,67,42,11,5,337
700840205,28,37,47,53,49,25,9,9,257
700840206,22,39,51,61,44,12,4,0,233
700840207,24,55,43,57,37,13,7,8,244
700840208,20,49,73,102,53,16,2,3,318
700840209,29,55,50,73,29,22,1,2,261
700840210,29,56,59,98,65,21,4,2,334
700840211,44,77,76,74,63,13,5,12,364
700840212,52,82,92,72,56,20,7,9,390
700840213,22,50,53,48,25,18,7,6,229
700840214,26,43,64,30,26,14,6,8,217
700840215,39,43,78,64,47,22,16,9,318
700840216,32,44,61,64,53,34,3,11,302
700840217,33,51,54,40,37,13,7,3,238
700840301,23,62,61,89,54,35,12,27,363
700840302,26,57,81,64,55,27,7,5,322
700840303,28,55,57,67,43,26,9,17,302
700840304,43,58,61,58,35,32,16,24,327
700840305,58,87,96,111,91,24,6,9,482
700840306,61,85,70,68,45,24,12,11,376
700840307,60,104,76,62,55,35,14,12,418
700840308,46,84,78,70,50,25,13,9,375
700840309,58,57,73,57,55,27,17,12,356
700840310,27,62,80,73,52,39,14,12,359
700840311,36,73,74,48,42,36,15,19,343
700840312,37,68,70,63,44,35,19,9,345
700840313,25,42,61,58,42,20,9,2,259
700840314,19,36,60,59,43,24,13,12,266
700840315,36,49,78,73,37,36,7,7,323
700840316,40,62,48,62,38,19,11,14,294
700840317,21,36,47,55,33,23,7,20,242
700840318,45,42,55,51,27,11,6,8,245
700840319,27,40,61,59,42,20,8,5,262
700840320,33,71,53,58,30,21,2,2,270
700840401,64,89,118,80,61,45,15,14,486
700840402,14,54,46,42,38,18,4,2,218
700840403,31,84,68,58,42,13,6,3,305
700840404,22,51,58,51,25,12,3,1,223
700840405,47,82,94,81,55,27,17,7,410
700840406,15,35,44,31,34,26,4,4,193
700840407,24,41,48,42,42,19,10,13,239
700840408,28,58,65,49,32,25,6,6,269
700840409,27,51,53,63,44,34,18,21,311
700840410,34,62,62,57,21,21,6,4,267
700840411,22,51,40,37,33,8,4,4,199
700840412,44,76,75,80,53,28,13,16,385
700840413,15,47,56,38,35,15,1,1,208
700840414,25,34,41,42,34,21,8,10,215
700840415,31,54,47,47,25,21,8,12,245
700840416,17,50,50,46,44,13,4,2,226
700840417,24,35,41,39,50,16,5,3,213
700840501,36,57,61,69,47,21,14,24,329
700840502,18,28,49,65,48,11,8,1,228
700840503,26,45,70,79,68,56,30,54,428
700840504,47,87,114,153,90,46,10,12,559
700840505,2,24,33,37,36,34,19,27,212
700840506,5,14,28,36,50,29,16,22,200
700840601,29,61,61,61,51,26,15,19,323
700840602,29,60,78,95,70,44,20,21,417
700840603,15,36,50,70,34,14,4,7,230
700840604,23,61,65,72,73,25,11,3,333
700840605,31,66,61,49,27,15,7,3,259
700840606,29,51,65,84,40,15,2,3,289
700840607,24,36,63,84,41,15,1,0,264
700840608,22,31,80,73,48,18,3,5,280
700840609,22,51,57,86,54,28,4,1,303
700840610,26,61,109,98,73,53,23,32,475
700840611,17,28,51,53,64,40,13,30,296
700840612,20,42,44,48,64,35,18,21,292
700840613,13,37,33,34,38,14,7,8,184
700910101,27,27,38,42,29,29,9,17,218
700910102,18,31,33,62,27,35,10,14,230
700910103,12,13,21,18,11,15,9,4,103
700910104,18,43,48,58,63,40,11,26,307
700910105,9,12,10,9,10,7,4,8,69
700910106,9,13,26,21,18,10,7,5,109
700910107,7,11,26,31,15,24,9,14,137
700910108,13,8,14,18,11,16,4,5,89
700910109,19,42,51,53,50,39,15,11,280
700910110,12,13,13,15,11,10,6,7,87
700910111,7,24,34,26,20,25,9,5,150
700910112,40,57,67,67,46,34,15,16,342
700910113,14,43,48,55,41,23,15,10,249
700910114,25,42,54,55,40,36,16,22,290
700910201,1,2,4,0,4,3,0,1,15
700980101,17,48,50,56,45,31,22,21,290
700980102,10,23,32,43,43,21,22,21,215
700980103,20,35,47,64,40,30,12,13,261
700980104,27,57,61,74,41,19,13,9,301
700980105,39,57,41,44,36,31,19,14,281
700980106,33,59,91,84,59,45,24,17,412
700980107,27,47,58,60,39,43,16,15,305
700980108,33,56,61,53,42,21,3,6,275
700980109,44,77,65,60,49,34,13,15,357
700980110,24,51,63,63,49,26,20,15,311
700980111,31,80,62,62,38,20,15,13,321
700980112,38,73,54,53,42,27,5,8,300
700980113,59,65,47,33,20,7,4,3,238
700980114,19,25,43,54,39,28,11,13,232
700980115,31,45,58,51,25,20,8,5,243
700980116,26,67,90,92,79,39,15,20,428
700980117,18,35,33,41,26,18,6,11,188
700980118,25,41,65,71,44,25,10,13,294
700980201,18,47,62,88,47,35,18,28,343
700980202,12,35,30,35,23,18,13,14,180
700980203,8,33,45,39,45,33,14,20,237
700980204,25,37,43,34,38,24,11,14,226
700980205,37,54,77,89,59,29,16,31,392
700980206,32,62,77,65,48,34,13,35,366
700980207,34,54,65,76,59,37,16,15,356
700980301,41,61,91,117,71,23,14,11,429
700980302,30,49,56,70,47,24,8,6,290
700980303,17,29,38,36,24,20,7,5,176
700980304,42,62,62,56,43,31,14,15,325
700980305,20,58,56,81,48,29,15,17,324
700980306,25,50,44,46,36,26,11,13,251
700980307,44,76,84,82,40,33,6,11,376
700980308,33,44,59,67,60,26,9,10,308
700980401,57,110,94,72,54,21,8,7,423
700980402,32,65,52,57,24,8,4,1,243
700980403,49,66,59,56,33,19,5,3,290
700980404,33,94,60,60,51,19,6,8,331
700980405,32,40,48,40,37,22,3,10,232
700980406,27,58,66,55,31,13,6,1,257
700980407,23,31,37,33,21,13,1,3,162
700980408,15,25,30,39,27,9,4,2,151
700980409,22,46,52,51,36,18,1,1,227
700980410,17,36,41,46,24,10,2,2,178
700980411,27,34,41,49,30,16,13,10,220
700980412,20,48,39,34,18,12,6,2,179
701050101,10,13,19,17,17,9,7,9,101
701050102,21,18,29,35,25,22,10,10,170
701050103,13,9,17,22,15,11,6,7,100
701050104,27,20,25,19,16,11,6,4,128
701050105,21,18,26,27,17,18,8,10,145
701050106,23,24,40,54,31,25,23,20,240
701050107,41,52,49,73,61,55,15,27,373
701050108,36,37,53,57,52,51,14,25,325
701050201,40,52,79,82,66,58,31,37,445
701050202,45,67,65,85,65,63,36,46,472
701050203,20,25,30,39,32,25,11,20,202
701050301,39,59,46,56,52,30,8,17,307
701050302,42,85,93,87,55,53,23,38,476
701050303,42,48,67,82,72,38,23,40,412
701050304,13,10,30,36,27,34,10,39,199
701050305,18,38,48,42,37,38,18,27,266
701050306,40,54,49,69,47,41,9,16,325
701050307,30,41,61,66,48,29,13,14,302
701050308,23,40,34,44,42,26,11,16,236
701120101,26,30,37,31,27,14,9,7,181
701120102,30,57,76,82,57,33,17,15,367
701120103,23,17,26,25,18,8,4,6,127
701120104,22,53,41,39,41,23,10,18,247
701120105,21,29,42,82,55,29,18,17,293
701120201,5,5,2,1,1,0,0,1,15
701190101,18,11,11,7,6,5,2,1,61
701190102,9,18,19,11,11,8,6,8,90
701190103,10,3,8,3,1,3,2,2,32
701190201,39,40,55,51,39,29,11,19,283
701190202,41,75,101,89,56,44,15,21,442
701190203,10,9,6,10,9,7,2,3,56
701190204,2,5,3,5,3,4,2,4,28
701190205,26,23,19,14,13,11,5,7,118
701190206,34,45,58,37,34,13,5,10,236
701190207,29,45,51,38,20,13,7,9,212
701190301,8,19,14,7,7,4,2,6,67
701190302,14,13,11,7,10,6,1,5,67
701190303,27,32,29,26,16,15,7,24,176
701260101,32,56,51,72,53,46,22,30,362
701260102,28,30,49,43,31,29,11,24,245
701260103,18,31,39,41,37,36,15,31,248
701260104,27,36,47,50,43,46,21,36,306
701260105,14,33,29,26,30,19,19,22,192
701260106,29,50,38,50,21,21,7,6,222
701260107,17,35,42,61,58,24,13,16,266
701260201,29,53,57,60,51,46,15,29,340
701260202,21,33,40,49,43,34,24,30,274
701260203,25,33,49,73,45,31,15,14,285
701260204,19,24,28,31,31,31,13,17,194
701260205,15,21,14,23,17,14,2,13,119
701260206,18,46,33,44,28,19,16,11,215
701260207,10,23,34,26,21,18,14,16,162
701260208,20,29,51,33,27,30,8,17,215
701260301,45,25,35,40,50,29,17,29,270
701260401,23,7,10,8,7,3,0,0,58
701330101,14,26,33,24,28,9,8,13,155
701330102,38,56,102,125,78,72,26,36,533
701330103,45,78,83,71,59,48,14,21,419
701330104,15,21,17,16,6,4,2,4,85
701330201,1,3,0,0,0,0,0,0,4
740070101,14,10,6,8,4,1,2,2,47
740070102,22,17,11,7,6,4,2,2,71
740070201,12,20,14,7,6,2,2,4,67
740070202,20,11,7,10,4,1,0,3,56
740070203,14,17,11,6,2,3,1,1,55
740070301,0,3,1,2,2,2,0,1,11
740070302,4,5,4,2,6,2,0,1,24
740070303,13,7,7,5,7,4,1,2,46
740070304,54,57,70,73,45,26,11,36,372
740070305,47,72,59,56,45,26,17,17,339
740070306,10,8,9,6,3,3,1,3,43
740070307,4,2,2,4,1,1,1,0,15
740070401,24,20,26,16,18,14,3,6,127
740070402,45,60,40,59,36,30,13,19,302
740070403,24,19,35,19,30,12,7,11,157
740070404,38,51,47,34,26,29,8,15,248
740070405,46,56,54,51,35,17,5,8,272
740070406,38,50,41,38,22,16,9,10,224
740070407,35,51,47,29,30,13,9,6,220
740070408,45,61,59,41,31,17,6,6,266
740070409,23,35,36,32,29,12,4,3,174
740070410,29,34,44,29,27,30,7,14,214
740070411,25,14,12,6,3,0,3,3,66
740070412,1,2,3,1,0,0,0,1,8
740070413,72,82,48,30,41,13,8,8,302
740070414,66,74,64,56,30,23,7,11,331
740070501,5,4,2,2,3,2,2,3,23
740070502,5,1,5,3,3,2,1,3,23
740070503,1,4,3,2,1,0,0,1,12
740070504,25,26,22,19,7,8,7,3,117
740070505,26,16,7,6,9,6,2,5,77
740070506,14,21,8,12,7,8,2,4,76
740070507,66,86,68,59,35,31,17,12,374
740070508,60,81,55,43,32,17,8,4,300
740070509,45,65,69,40,25,7,6,8,265
740070510,46,50,34,39,16,12,4,9,210
740140101,2,3,2,0,1,0,0,0,8
740140102,8,11,9,9,5,5,0,0,47
740140103,9,6,2,5,1,3,0,0,26
740140201,7,4,1,1,1,0,0,1,15
740140202,7,4,3,4,0,0,1,1,20
740140203,13,5,6,1,1,0,0,0,26
740140204,6,4,0,1,1,0,0,2,14
740140301,18,10,2,0,3,1,0,3,37
740140302,11,11,9,3,1,1,0,1,37
740140303,25,6,6,3,3,2,0,2,47
740140304,13,15,7,0,10,4,2,1,52
740140401,11,12,4,1,3,1,0,0,32
740140402,18,18,6,8,6,2,2,1,61
740140403,32,35,47,41,27,14,4,8,208
740140404,46,46,16,23,12,6,2,6,157
740140405,48,57,24,24,10,7,5,7,182
740140406,12,9,2,1,1,1,0,2,28
740140501,12,4,8,4,4,2,1,2,37
740140502,10,2,5,5,4,4,1,5,36
740140503,34,21,35,21,23,16,7,8,165
740140504,7,3,3,0,0,0,1,0,14
740140505,15,9,6,7,4,3,0,1,45
740210101,9,6,2,1,1,1,0,0,20
740210102,20,18,15,8,8,3,2,5,79
740210103,18,13,6,5,2,2,1,1,48
740210104,8,8,3,3,0,2,1,1,26
740210105,28,12,10,10,5,3,2,3,73
740210106,8,11,11,4,5,2,3,2,46
740210107,20,23,8,12,3,5,4,4,79
740210108,15,27,10,11,8,3,1,0,75
740210109,36,31,24,27,5,10,3,6,142
740210110,18,23,12,13,9,8,3,4,90
740210111,22,14,14,5,11,9,4,5,84
740210112,21,22,12,12,12,6,2,5,92
740210113,3,5,0,2,2,1,1,1,15
740210201,13,12,6,9,5,9,0,2,56
740210202,17,8,11,2,3,0,1,0,42
740210203,25,19,23,9,12,7,8,10,113
740210204,20,9,5,16,8,3,3,0,64
740210301,4,6,3,2,1,0,0,0,16
740210302,8,8,9,4,7,1,0,0,37
740210303,67,67,50,42,28,22,6,5,287
740210304,61,64,52,50,25,16,9,4,281
740210305,66,92,93,104,45,23,11,7,441
740210306,34,53,57,60,27,20,11,7,269
740210307,66,79,75,67,48,24,8,9,376
740210308,65,81,89,65,42,28,9,13,392
740210309,31,25,41,40,30,13,5,4,189
740210310,15,14,5,3,4,0,1,1,43
740210311,5,7,5,5,5,1,1,0,29
740210401,25,13,12,16,12,4,2,3,87
740210402,3,5,1,1,0,1,0,1,12
740210403,5,6,5,4,2,2,1,1,26
740210404,12,10,9,4,5,3,3,1,47
740210405,40,45,70,72,28,33,10,10,308
740210406,16,9,6,8,2,1,0,0,42
740210407,10,9,4,2,1,3,0,0,29
740280101,14,9,11,11,4,2,1,0,52
740280102,36,55,77,67,51,28,11,5,330
740280103,57,63,55,69,25,14,8,3,294
740280104,26,28,43,39,23,13,2,1,175
740280105,29,45,32,37,14,11,4,4,176
740280106,60,57,57,30,20,17,5,4,250
740280107,53,80,62,63,34,20,11,9,332
740280108,11,18,12,11,6,2,2,1,63
740280109,8,22,12,9,11,8,1,3,74
740280110,16,10,4,4,2,1,0,2,39
740280201,19,14,17,16,4,2,1,0,73
740280202,29,52,25,27,22,10,5,7,177
740280203,56,64,38,48,25,12,7,8,258
740280204,14,23,20,16,13,2,2,2,92
740280205,29,32,24,29,14,7,2,0,137
740280206,40,46,44,28,14,12,2,2,188
740280301,19,24,28,29,18,6,4,1,129
740280302,15,18,8,13,8,5,4,2,73
740280303,5,2,3,2,0,0,0,0,12
740280304,25,17,7,13,2,11,0,0,75
740280305,12,13,4,5,4,2,0,0,40
740280306,42,49,45,54,18,22,4,1,235
740280307,7,6,2,4,2,1,1,0,23
740280308,54,55,53,64,37,15,3,7,288
740280309,28,42,52,56,31,16,5,6,236
740280310,47,55,60,55,34,12,5,6,274
740280311,28,51,55,56,35,13,9,3,250
740280401,3,5,5,1,1,1,0,2,18
740280402,22,26,32,33,27,12,6,8,166
740280403,65,80,64,60,33,12,5,2,321
740280404,68,95,66,51,32,9,2,3,326
740280405,55,78,76,88,49,19,6,5,376
740280406,18,27,26,41,32,14,7,11,176
740280407,63,52,51,62,31,17,8,4,288
740280408,48,61,48,42,35,20,7,7,268
740280409,16,19,15,6,6,3,1,0,66
740280410,10,18,9,8,2,2,2,0,51
740280411,7,3,1,2,0,0,1,2,16
740350101,8,1,0,0,1,1,0,0,11
740350102,1,3,4,5,0,0,0,0,13
740350103,16,21,15,15,10,3,2,3,85
740350104,5,4,3,4,1,0,1,0,18
740350201,0,3,4,2,0,1,0,0,10
740350202,1,1,0,0,3,1,0,0,6
740350203,4,5,8,2,3,1,2,1,26
740350204,6,6,5,1,2,1,0,0,21
740350205,2,4,1,1,1,3,1,0,13
740350301,2,10,4,3,4,0,0,1,24
740350302,10,7,6,4,6,3,0,0,36
740350303,4,6,3,1,3,2,1,0,20
740350304,12,20,12,11,9,1,0,1,66
740350305,4,8,6,2,0,1,0,0,21
740350401,6,8,4,3,1,0,0,1,23
740350402,9,9,4,1,2,1,1,0,27
740350403,17,5,10,6,3,1,0,0,42
740350404,8,9,6,7,10,4,1,5,50
740350405,4,4,1,1,0,1,0,1,12
740350406,7,5,1,1,1,1,1,0,17
740350407,43,24,31,23,15,22,3,6,167
740350501,9,15,5,4,2,0,0,0,35
740350502,8,3,3,3,3,2,0,0,22
740350601,15,13,15,12,4,9,2,3,73
740350602,10,19,21,8,9,6,4,1,78
740350603,12,12,3,1,4,0,1,1,34
740350604,5,1,3,2,0,1,1,0,13
740350605,6,5,0,1,1,0,0,0,13
740350701,3,4,6,3,5,1,2,2,26
740350702,37,35,56,58,30,30,11,7,264
740350703,56,40,62,56,34,27,13,9,297
740350704,21,48,39,34,21,22,12,9,206
740350705,49,41,37,47,20,15,6,3,218
740350706,35,45,49,42,24,20,10,9,234
740350707,58,57,52,40,21,13,6,12,259
740350708,36,69,49,60,38,22,10,15,299
740350709,25,38,51,34,39,14,8,15,224
740350710,43,63,60,76,51,25,10,15,343
740350711,29,49,43,40,36,25,8,16,246
740350712,47,73,61,37,20,11,5,9,263
740350713,82,104,75,49,30,17,7,8,372
740350714,61,84,52,44,19,9,1,2,272
740350715,56,50,40,23,14,14,6,2,205
740350716,65,88,49,27,19,5,5,4,262
740350801,32,44,68,59,38,36,8,11,296
740350802,21,19,30,24,18,21,11,13,157
740350803,1,0,0,1,0,0,0,0,2
740350804,26,36,47,74,59,41,29,35,347
740350805,31,32,48,65,69,36,21,37,339
740350806,20,24,36,46,35,19,7,8,195
740350807,16,33,29,22,23,14,10,8,155
740350808,60,67,55,34,22,12,6,5,261
740350809,48,51,46,44,26,17,13,13,258
740350810,30,49,51,57,39,26,8,13,273
740350811,38,51,71,81,55,42,19,24,381
740350812,34,52,32,37,27,11,7,12,212
740350813,44,53,36,39,15,8,6,5,206
740350814,59,81,66,51,32,13,6,3,311
740350815,57,79,52,45,23,10,4,4,274
740350816,34,72,46,45,27,8,6,4,242
740350817,71,84,67,58,37,22,10,8,357
740350818,39,62,58,68,37,26,7,9,306
740350819,28,45,60,87,62,22,6,7,317
740350820,29,35,44,41,23,15,4,2,193
740350821,3,4,4,2,7,2,1,2,25
740350901,46,74,71,34,20,10,4,2,261
740350902,64,76,53,46,19,7,5,4,274
740350903,43,60,71,43,31,18,6,4,276
740350904,38,44,66,57,35,31,5,13,289
740350905,5,4,4,11,7,7,1,6,45
740350906,28,37,50,59,30,20,9,10,243
740350907,60,112,77,51,35,12,6,7,360
740350908,49,94,63,41,17,12,4,2,282
740350909,80,89,45,23,16,7,0,2,262
740350910,63,97,75,60,21,8,4,2,330
740350911,68,104,61,50,17,13,1,4,318
740350912,80,72,49,25,16,3,1,1,247
740350913,69,82,53,29,23,12,4,2,274
740350914,44,71,77,62,24,14,5,2,299
740350915,18,52,42,57,45,23,7,5,249
740350916,52,59,51,51,26,14,4,8,265
740350917,28,50,46,64,46,24,5,12,275
740351001,47,79,95,112,66,38,7,11,455
740351002,31,52,37,42,24,9,4,4,203
740351003,39,61,53,30,32,12,3,1,231
740351004,37,71,76,49,29,5,6,3,276
740351005,49,89,88,119,48,22,10,7,432
740351006,49,79,91,102,52,21,6,2,402
740351007,40,56,69,81,39,26,8,3,322
740351008,33,52,60,67,40,21,3,8,284
740351009,27,48,55,59,50,12,2,4,257
740351010,32,41,42,33,21,13,3,6,191
740351011,52,76,68,54,22,13,3,1,289
740351012,40,67,47,29,6,8,1,3,201
740351013,44,66,52,32,17,13,3,5,232
740351014,46,49,32,17,13,6,0,0,163
740351015,51,57,44,26,15,7,0,0,200
740351016,71,85,65,56,36,18,8,8,347
740351017,32,44,49,35,29,16,8,8,221
740351018,13,42,54,55,30,20,6,8,228
740351019,37,52,76,91,66,21,9,5,357
740351020,5,9,12,10,3,5,0,1,45
740351101,6,12,14,19,3,3,1,3,61
740351102,15,27,32,51,33,26,13,20,217
740351103,49,49,46,53,40,10,8,8,263
740351104,40,56,54,46,19,10,5,7,237
740351105,36,45,28,24,20,9,6,1,169
740351106,55,71,32,30,20,5,1,0,214
740351107,58,60,41,18,6,2,0,0,185
740351108,47,69,25,19,13,2,1,0,176
740351109,55,43,27,20,15,5,0,0,165
740351110,63,69,64,58,31,15,3,3,306
740351111,51,69,86,67,36,23,21,15,368
740351112,30,43,67,70,61,47,22,30,370
740351113,24,47,29,39,31,23,10,15,218
740351114,45,64,59,56,33,19,12,28,316
740351201,55,89,60,36,25,13,3,2,283
740351202,38,47,50,57,37,18,7,9,263
740351203,39,37,43,42,21,11,9,7,209
740351204,34,41,51,38,23,19,5,5,216
740351205,73,98,68,47,23,6,3,2,320
740351206,25,31,48,51,34,25,8,12,234
740351207,25,37,56,50,35,31,8,4,246
740351208,31,48,52,48,40,25,14,20,278
740351209,49,61,69,63,45,22,16,10,335
740351210,61,78,74,55,44,20,2,3,337
740351211,38,50,25,19,6,7,1,1,147
740351212,58,50,45,16,9,3,0,0,181
740351213,24,29,21,28,23,20,6,9,160
740351214,49,49,48,60,39,42,22,30,339
740351215,26,34,49,40,29,33,18,23,252
740351216,19,28,37,51,42,29,13,16,235
740351217,14,27,33,38,24,16,8,9,169
740351218,11,17,16,23,20,14,4,6,111
740351301,45,43,70,79,29,13,2,0,281
740351302,5,0,0,0,0,0,0,0,5
740351303,61,49,84,82,50,13,7,5,351
740351304,47,64,78,93,40,25,4,4,355
740351305,41,65,95,93,35,19,7,3,358
740351306,30,46,52,68,31,9,3,3,242
740351307,9,7,7,12,2,2,0,2,41
740351308,51,70,84,81,40,14,4,3,347
740351309,38,66,76,87,47,21,10,3,348
740351310,43,47,59,75,34,22,4,8,292
740351311,42,46,72,67,35,18,9,7,296
740351401,37,79,84,89,49,24,10,17,389
740351402,3,2,4,3,2,2,0,0,16
740351403,38,57,61,58,40,31,16,3,304
740351404,40,63,71,60,37,14,8,1,294
740351405,21,30,41,52,37,20,8,8,217
740351406,38,66,82,96,67,15,5,3,372
740351407,22,49,61,86,51,25,13,8,315
740351408,27,50,76,97,71,29,10,5,365
740351409,22,51,51,61,56,20,14,10,285
740351410,45,58,63,96,48,20,7,2,339
740351501,2,4,0,4,1,0,0,0,11
740351502,28,22,23,33,18,7,3,1,135
740351503,11,13,4,13,6,5,2,1,55
740351504,11,10,25,21,10,4,1,1,83
740351505,0,0,2,1,0,0,0,0,3
740351506,4,0,1,1,1,0,0,0,7
740351507,7,2,4,6,0,1,1,1,22
740351601,31,41,41,36,29,10,14,8,210
740351602,55,52,31,21,23,14,5,9,210
740351603,40,48,40,40,20,5,0,2,195
740351604,43,66,51,26,24,12,4,4,230
740351605,40,39,25,30,20,22,6,10,192
740351606,30,31,37,49,33,31,13,24,248
740351607,49,53,35,42,34,15,3,7,238
740351608,47,50,41,46,26,11,9,5,235
740351609,45,56,45,42,39,12,8,7,254
740351610,46,54,67,60,50,39,22,20,358
740351611,28,42,49,49,34,20,14,12,248
740351612,27,61,51,56,30,16,13,10,264
740351701,8,13,6,16,7,5,2,3,60
740351702,17,10,15,13,7,2,1,0,65
740351703,1,9,2,2,3,2,0,1,20
740351704,9,16,8,4,10,2,3,3,55
740351705,13,19,6,7,9,1,0,0,55
740351801,21,11,9,3,5,1,1,1,52
740351802,5,10,6,6,7,1,0,2,37
740351803,9,10,7,2,3,0,1,2,34
740351804,9,4,1,3,0,0,0,0,17
740351805,5,10,1,5,2,2,3,1,29
740351806,6,2,6,2,3,1,0,0,20
740420101,7,2,0,2,3,3,1,0,18
740420102,5,10,8,5,1,4,8,5,46
740420103,12,8,7,3,1,2,0,2,35
740420201,8,5,5,2,3,3,1,0,27
740420202,23,22,27,6,8,10,5,5,106
740420203,7,6,3,3,0,0,0,0,19
740420204,17,19,17,20,21,14,10,4,122
740420205,30,21,17,15,6,2,0,1,92
740420206,12,17,17,15,8,6,6,3,84
740420207,57,52,65,63,43,34,16,20,350
740420208,46,69,72,64,47,18,20,17,353
740420301,1,3,2,0,0,0,0,0,6
740420302,15,11,9,10,12,7,2,1,67
740420303,12,4,2,4,0,0,0,1,23
740420304,52,35,46,40,29,15,5,13,235
740420305,8,8,6,6,2,1,0,0,31
740420306,64,62,70,82,52,20,16,15,381
740420307,24,13,5,6,2,2,1,0,53
740420308,35,46,33,30,19,17,4,6,190
740420401,5,5,3,1,2,3,1,0,20
740420402,10,11,20,13,5,2,1,0,62
740420403,72,59,69,52,30,20,5,4,311
740420404,79,89,83,61,36,11,13,16,388
740420405,7,12,19,17,8,5,4,2,74
740420406,3,3,8,2,2,0,0,0,18
740420501,10,12,1,3,0,2,0,0,28
740420502,2,1,3,1,0,0,0,0,7
740420601,18,1,3,0,1,0,0,0,23
740420602,11,6,5,4,4,0,1,0,31
740420603,58,63,54,60,34,20,7,12,308
740490101,8,8,3,2,3,2,1,2,29
740490102,11,6,9,6,10,2,1,3,48
740490103,17,23,23,17,11,9,7,8,115
740490104,20,17,8,9,5,6,4,4,73
740490105,7,5,9,7,6,1,1,5,41
740490106,0,8,8,8,9,6,4,3,46
740490107,1,5,3,1,0,0,0,0,10
740490201,8,19,12,9,7,4,5,2,66
740490202,9,16,6,8,3,7,4,6,59
740490203,14,10,10,6,6,4,0,1,51
740490204,45,49,52,54,36,11,4,8,259
740490205,35,51,41,30,22,11,3,2,195
740490206,39,42,48,55,32,22,5,10,253
740490207,32,47,42,40,29,19,1,5,215
740490208,43,60,40,29,14,7,2,5,200
740490209,63,48,60,44,26,10,1,3,255
740490210,34,39,40,29,23,8,10,4,187
740490211,19,22,26,18,21,18,5,3,132
740490212,7,13,7,10,3,2,2,0,44
740490213,24,28,14,5,5,4,3,1,84
740490301,14,23,16,18,15,11,3,2,102
740490302,10,11,8,8,3,2,1,0,43
740490303,83,112,78,61,54,20,7,8,423
740490304,56,72,64,45,30,10,3,6,286
740490305,53,61,41,37,23,7,5,3,230
740490306,31,50,30,50,27,15,5,6,214
740490401,77,107,83,78,45,24,7,10,431
740490402,61,101,52,51,28,16,3,2,314
740490403,33,56,42,35,17,8,4,2,197
740490404,30,39,27,33,27,13,1,2,172
740490405,64,97,105,87,57,30,9,10,459
740490406,90,120,78,85,34,18,8,4,437
740490407,62,56,50,43,18,12,1,1,243
740490408,61,44,31,20,16,6,2,2,182
740490409,37,52,38,37,26,6,3,1,200
740490410,58,101,54,30,19,6,0,2,270
740490411,66,89,56,54,29,12,3,6,315
740490412,36,74,41,36,21,7,2,1,218
740490413,82,115,72,65,19,12,1,1,367
740490414,51,60,71,43,24,6,3,4,262
740490415,77,82,104,82,53,37,7,24,466
740490416,51,59,61,55,30,11,0,1,268
740490417,22,36,46,50,20,14,6,6,200
740490418,25,57,39,29,24,7,3,2,186
740490419,42,65,25,36,7,8,2,1,186
740560101,8,7,8,5,3,2,0,1,34
740560102,1,5,5,2,1,0,2,1,17
740560103,21,14,6,9,2,1,1,2,56
740560104,16,17,8,11,8,2,4,7,73
740560105,40,33,31,23,20,15,6,7,175
740560201,26,10,10,9,3,3,0,1,62
740560202,18,13,14,16,11,9,2,2,85
740560203,25,24,20,11,11,5,3,5,104
740560204,100,84,107,86,53,37,19,13,499
740560205,32,23,42,29,14,7,4,4,155
740560206,53,52,61,60,40,39,11,18,334
740560301,2,3,4,0,0,0,0,0,9
740560302,47,51,49,36,18,5,1,0,207
740560303,21,20,28,30,17,8,1,4,129
740560304,5,12,35,69,28,25,7,11,192
740560305,23,42,53,44,28,9,9,3,211
740560306,42,68,67,81,40,12,12,7,329
740560307,40,55,51,59,41,11,7,2,266
740560308,40,52,78,68,30,13,1,1,283
740560309,0,0,0,0,0,0,0,0,0
740560310,45,62,64,90,38,19,9,5,332
740560311,45,67,82,83,41,17,7,9,351
740560312,27,57,75,82,43,17,6,3,310
740560313,30,51,61,95,53,30,8,8,336
740560314,29,65,63,73,32,17,3,3,285
740560315,40,45,47,62,37,12,4,5,252
740560316,34,67,67,71,62,23,9,6,339
740560317,0,0,0,0,0,0,0,0,0
740560318,1,6,1,0,0,0,0,0,8
740560401,18,8,12,9,9,3,1,1,61
740560402,16,23,14,15,5,7,4,0,84
740560403,31,41,26,24,11,10,4,9,156
740560404,22,36,32,33,15,7,1,3,149
740560405,30,51,22,23,14,3,3,0,146
740560406,59,65,43,54,40,16,7,12,296
740560407,41,53,37,30,26,15,8,5,215
740560408,9,10,7,13,9,5,1,1,55
740560501,24,26,41,27,14,16,4,5,157
740560502,50,88,69,70,46,19,4,1,347
740560503,17,17,22,20,5,8,7,6,102
740560504,48,31,51,58,17,4,3,0,212
740560505,44,59,33,39,21,9,1,0,206
740560506,41,44,49,61,42,22,10,15,284
740560507,36,45,41,55,33,7,2,3,222
740560508,32,66,71,70,34,22,10,5,310
740560509,57,93,91,79,44,34,5,3,406
740560510,36,54,41,71,44,11,2,3,262
740560511,33,41,25,21,4,2,1,0,127
740560512,62,65,72,92,52,32,13,9,397
740560513,61,67,69,89,43,21,6,3,359
740560514,34,52,52,57,44,22,5,11,277
740560515,6,2,4,7,6,2,3,2,32
740560601,4,3,1,0,0,0,0,0,8
740560602,8,18,11,8,9,5,0,3,62
740560603,30,52,49,47,32,16,3,19,248
740560604,27,36,48,40,26,20,14,13,224
740560605,65,68,76,57,48,21,16,11,362
740560606,54,65,89,97,50,30,9,19,413
740560607,37,73,50,46,22,5,6,6,245
740560608,27,39,31,37,14,11,0,0,159
740560609,44,87,59,44,37,18,5,9,303
740560610,42,61,51,62,50,30,17,18,331
740560611,32,40,58,50,46,36,18,13,293
740560612,41,54,61,54,37,23,17,9,296
740560613,45,73,50,50,27,21,14,9,289
740560614,53,56,51,36,31,19,4,3,253
740560615,50,50,66,82,53,23,11,17,352
740560616,53,70,42,42,20,11,5,7,250
740560617,93,89,73,63,32,21,9,4,384
740560701,31,34,50,57,38,36,12,15,273
740560702,25,34,70,71,68,45,11,17,341
740560703,3,4,6,5,1,3,3,0,25
740560704,33,67,93,98,88,43,20,31,473
740560705,39,53,70,86,90,56,33,46,473
740560706,47,80,81,108,79,50,30,29,504
740560707,5,27,26,28,30,13,8,4,141
740560708,45,80,75,63,46,33,7,8,357
740560709,36,84,70,62,18,20,5,3,298
740560710,48,67,78,61,45,40,16,21,376
740560711,17,25,27,27,23,12,7,3,141
740560712,45,52,61,74,40,30,8,14,324
740560713,42,63,82,86,64,55,16,23,431
740560714,22,30,38,67,42,37,11,6,253
740560715,14,33,49,57,46,24,12,12,247
740560716,30,63,70,60,37,30,7,6,303
740560717,23,56,64,76,36,35,13,28,331
740560718,34,46,43,40,24,15,2,1,205
740560719,43,54,59,48,33,21,15,13,286
740560720,63,63,56,59,30,21,11,5,308
740560721,66,99,89,64,38,18,8,9,391
740560722,36,50,42,57,29,13,8,5,240
740560723,33,36,38,26,18,6,4,7,168
740560724,33,54,54,33,24,17,2,7,224
740560725,39,51,43,42,29,18,4,7,233
740560726,54,68,77,77,37,17,9,6,345
740560801,17,32,34,48,48,38,24,29,270
740560802,26,24,49,64,55,51,32,42,343
740560803,30,33,54,58,34,14,2,3,228
740560804,35,43,54,44,42,12,5,6,241
740560805,26,50,35,72,32,12,8,5,240
740560806,10,16,17,21,16,11,3,5,99
740560807,26,33,50,67,34,24,9,4,247
740560808,29,37,51,70,51,25,6,2,271
740560809,29,47,47,58,39,17,4,1,242
740560810,42,44,54,80,50,21,7,3,301
740560811,31,33,31,51,22,5,3,1,177
740560812,38,44,54,69,55,20,7,4,291
740560813,11,39,55,70,33,21,5,5,239
740560814,30,34,39,63,40,13,6,4,229
740560815,40,57,43,48,36,9,1,2,236
740560901,51,40,59,39,35,21,7,8,260
740560902,23,42,31,55,54,38,11,13,267
740560903,22,32,68,73,45,22,7,4,273
740560904,24,30,29,36,29,11,2,0,161
740560905,24,37,38,40,38,25,9,5,216
740560906,28,48,37,79,39,19,7,5,262
740560907,22,29,36,49,48,33,21,8,246
740560908,20,39,54,72,43,31,11,18,288
740560909,28,56,51,48,35,12,11,5,246
740560910,29,45,53,87,59,24,4,6,307
740560911,22,47,53,59,21,16,4,5,227
740560912,25,20,32,37,27,9,8,3,161
740560913,6,14,12,26,7,1,1,0,67
740560914,18,44,61,54,28,12,4,5,226
740560915,44,52,54,68,38,21,4,1,282
740560916,10,26,31,39,24,6,0,0,136
740561001,82,96,72,36,23,9,3,4,325
740561002,41,52,36,31,29,11,4,1,205
740561003,70,89,82,58,30,15,4,6,354
740561004,50,52,65,52,28,15,5,8,275
740561005,65,72,67,59,55,26,14,12,370
740561006,26,69,67,74,48,16,12,9,321
740561007,30,50,64,82,53,28,6,7,320
740561008,19,57,35,58,30,13,1,4,217
740561009,17,11,31,29,19,20,3,3,133
740561010,34,72,64,63,39,19,4,6,301
740561011,48,82,99,66,55,25,4,11,390
740561012,62,76,78,102,45,30,10,11,414
740561013,50,57,68,58,29,18,7,1,288
740561014,40,75,54,49,23,10,6,4,261
740561015,40,80,64,55,30,17,1,4,291
740561016,66,79,55,46,16,10,3,3,278
740561017,91,85,60,38,24,14,4,1,317
740561018,102,103,54,46,18,10,5,3,341
740561101,21,46,54,44,36,28,10,15,254
740561102,45,68,95,74,41,18,9,10,360
740561103,62,82,85,59,34,15,5,10,352
740561104,80,63,58,31,22,13,5,6,278
740561105,84,89,47,23,11,4,1,3,262
740561106,108,93,32,18,7,5,1,1,265
740561107,139,130,63,27,10,6,1,3,379
740561108,99,79,35,27,10,5,4,0,259
740561109,46,45,32,24,14,5,4,4,174
740561110,79,55,32,25,12,2,1,0,206
740561111,91,55,32,13,7,4,0,2,204
740561112,95,57,37,19,12,7,0,1,228
740561113,100,75,35,13,10,1,1,1,236
740561114,35,38,24,11,8,3,1,1,121
740561115,56,53,21,18,7,3,0,0,158
740561116,64,56,27,13,6,1,1,0,168
740561117,66,67,38,28,16,9,1,0,225
740561118,96,77,74,60,43,27,11,8,396
740561119,27,25,40,37,38,23,3,17,210
740561120,15,48,29,56,33,20,3,12,216
740561121,39,47,49,42,33,17,6,4,237
740561122,49,50,68,52,45,26,19,13,322
740561201,43,61,93,90,87,38,25,52,489
740561202,13,43,45,49,59,41,17,29,296
740561203,39,65,62,96,72,47,22,23,426
740561204,30,41,76,97,56,44,20,29,393
740561205,25,37,40,43,34,30,11,15,235
740561206,26,31,44,59,34,22,6,19,241
740561207,44,59,57,28,20,8,5,7,228
740561208,46,50,31,23,16,11,7,3,187
740561209,50,49,32,46,23,9,8,11,228
740561210,34,41,45,36,30,11,6,3,206
740561211,22,40,44,39,24,10,7,6,192
740561212,40,42,41,40,26,20,11,10,230
740561213,45,63,59,58,50,32,11,14,332
740561214,27,55,48,56,27,47,10,23,293
740561215,57,74,83,77,50,42,21,26,430
740561216,35,52,78,75,63,40,20,29,392
740561217,14,12,26,31,27,19,10,5,144
740561218,7,6,4,3,3,5,3,2,33
740561219,34,41,29,43,22,22,10,9,210
740561220,59,57,36,44,36,29,7,12,280
740561301,49,60,37,20,11,4,2,0,183
740561302,26,44,29,27,10,15,2,4,157
740561303,99,69,31,24,13,7,2,4,249
740561304,70,60,36,31,16,5,0,1,219
740561305,74,67,46,33,12,2,2,2,238
740561306,28,40,28,18,12,7,3,0,136
740561307,53,65,60,51,20,11,6,3,269
740561308,30,62,44,42,33,19,9,10,249
740561309,80,107,68,38,19,15,5,2,334
740561310,43,57,36,36,19,14,4,4,213
740561311,75,90,66,59,31,16,4,11,352
740561312,31,54,57,46,32,9,5,7,241
740561401,87,88,31,16,4,3,1,0,230
740561402,82,65,28,20,9,3,0,1,208
740561403,74,82,52,48,28,12,5,1,302
740561404,103,100,55,55,16,8,3,4,344
740561405,67,102,82,62,39,7,0,1,360
740561406,75,79,76,50,33,21,2,6,342
740561407,24,40,52,44,22,6,10,7,205
740561408,46,49,55,46,34,26,7,9,272
740561409,57,68,73,40,27,10,8,7,290
740561410,50,55,38,25,7,4,2,2,183
740561411,34,41,37,31,19,13,0,0,175
740561412,38,73,49,38,18,10,3,5,234
740561413,53,94,47,44,28,13,3,3,285
740561414,28,55,57,64,41,30,17,21,313
740561415,39,69,79,81,50,23,5,2,348
740561416,35,66,68,81,56,20,10,5,341
740561417,43,60,67,84,50,28,12,11,355
740561418,24,44,56,61,46,37,16,32,316
740561501,14,28,45,43,30,26,12,8,206
740561502,10,27,36,53,46,31,13,11,227
740561503,17,36,51,58,56,58,12,19,307
740561504,5,12,24,21,20,15,4,11,112
740561505,29,37,51,68,38,26,6,4,259
740561506,26,52,72,70,51,24,10,7,312
740561507,21,55,60,59,53,27,16,23,314
740561508,20,45,52,76,59,35,14,20,321
740561509,19,34,45,62,43,26,7,10,246
740561510,7,33,34,52,41,25,12,21,225
740561511,18,47,48,59,46,27,15,17,277
740561512,19,40,48,76,47,30,17,14,291
740561513,22,37,57,64,60,44,9,17,310
740561514,6,25,36,50,53,36,20,20,246
740561515,11,18,21,23,20,10,6,9,118
740561601,20,6,16,20,11,13,6,2,94
740561602,13,18,13,2,12,2,0,0,60
740561603,20,11,5,1,5,2,1,2,47
740561701,8,4,11,4,1,3,1,2,34
740561702,2,1,0,1,0,0,0,0,4
740561703,7,2,1,0,1,0,0,0,11
740561704,3,1,3,4,4,1,0,2,18
740561705,7,3,3,4,2,4,0,1,24
740561706,2,0,1,2,0,0,0,0,5
740561707,39,41,39,52,23,23,8,21,246
740561801,1,2,0,0,1,0,0,0,4
740561802,17,11,8,12,5,6,3,3,65
740561803,3,4,1,2,1,0,0,2,13
740561804,4,4,2,1,2,0,0,0,13
740561805,1,0,0,1,2,1,0,0,5
740561901,6,6,1,5,2,2,1,5,28
740561902,11,14,10,5,5,4,0,4,53
740561903,1,0,1,3,0,0,0,0,5
740561904,0,1,1,0,1,0,0,0,3
740630101,21,25,9,12,6,8,2,0,83
740630102,40,61,47,39,18,6,6,7,224
740630201,10,14,11,11,11,11,2,4,74
740630202,26,26,24,30,14,8,5,7,140
740630301,40,38,29,19,16,6,6,5,159
740630302,15,10,15,10,4,2,3,1,60
740630303,25,14,9,11,7,8,3,3,80
740630304,15,17,9,5,6,3,3,2,60
740630305,14,13,7,11,10,8,3,1,67
740630401,48,24,17,12,7,5,3,3,119
740630402,31,40,34,20,15,7,2,0,149
740630501,10,10,6,6,2,2,0,3,39
740630502,4,4,2,1,0,3,1,1,16
740630503,33,31,28,24,12,6,3,4,141
740630504,34,35,18,16,8,1,3,4,119
780070101,8,7,3,1,0,0,0,0,19
780070201,17,7,4,1,1,0,1,0,31
780070301,10,2,0,0,0,0,0,0,12
780070302,12,1,1,0,0,0,0,0,14
780070401,47,6,3,1,2,1,1,0,61
780070501,34,80,74,70,32,17,6,7,320
780070502,99,121,112,73,51,21,5,6,488
780070503,100,84,98,91,46,25,5,6,455
780070504,52,43,29,27,14,5,1,0,171
780070505,65,101,104,104,80,37,12,14,517
780070601,56,66,64,34,20,5,2,2,249
780070602,72,135,111,113,51,31,11,4,528
780070603,68,77,62,55,32,8,4,6,312
780070604,39,71,66,64,39,16,5,4,304
780140101,23,5,0,2,0,0,0,0,30
780140102,19,7,3,1,0,0,0,0,30
780140103,113,94,122,66,52,22,14,12,495
780140104,88,79,100,118,65,38,14,12,514
780140105,64,55,86,59,45,13,2,5,329
780140106,79,86,125,120,132,44,20,20,626
780140107,54,58,90,107,56,16,7,8,396
780140108,91,78,113,88,54,47,6,15,492
780140109,92,124,148,175,87,44,13,12,695
780140201,16,12,6,2,1,0,0,0,37
780140202,52,50,71,71,44,29,12,8,337
780140203,89,80,150,128,63,36,13,15,574
780140204,42,78,86,84,49,45,17,18,419
780140205,81,107,72,60,49,36,10,11,426
780140206,43,70,78,89,64,37,15,12,408
780140207,46,62,77,67,48,20,3,3,326
780140208,47,64,79,85,75,53,32,28,463
780140209,75,45,34,31,20,7,2,2,216
780140210,41,77,66,78,48,42,10,14,376
780140211,54,63,82,101,71,55,27,25,478
780140212,69,85,113,111,78,48,21,21,546
780140213,72,77,99,91,57,34,13,10,453
780140214,43,39,77,68,35,21,5,7,295
780140215,1,0,1,5,0,1,0,0,8
780140216,17,58,105,106,89,47,21,11,454
780140217,39,44,59,72,45,17,1,6,283
780140218,47,49,97,97,51,24,8,9,382
780140219,67,71,117,91,65,34,10,11,466
780140220,51,80,87,78,35,20,7,1,359
780140221,46,64,102,115,67,42,12,7,455
780140222,15,40,96,133,71,39,10,7,411
780140301,18,7,0,0,0,0,0,0,25
780140302,10,8,1,3,0,0,0,0,22
780140303,26,10,13,6,11,4,1,3,74
780140304,23,42,78,101,67,34,7,5,357
780140305,34,70,117,144,83,45,19,17,529
780140401,19,8,1,0,0,0,0,0,28
780140402,31,18,16,18,4,10,2,3,102
780140403,17,24,24,21,12,4,3,2,107
780140501,18,4,1,1,2,1,2,0,29
780140502,14,5,6,0,1,0,0,0,26
780140503,15,2,1,2,0,1,2,1,24
780140504,9,23,46,64,29,15,7,8,201
780140505,87,114,120,128,77,37,27,16,606
780140506,23,25,57,80,55,38,7,11,296
780140507,42,75,72,84,56,33,8,12,382
780140601,11,3,1,0,1,0,0,1,17
780140701,10,2,0,0,0,1,0,3,16
780140801,68,54,42,21,15,6,4,4,214
780140802,136,130,88,63,28,20,5,7,477
780140803,78,112,86,71,42,17,4,4,414
780140804,75,87,96,84,35,23,7,3,410
780140805,41,70,76,83,60,25,11,4,370
780140901,69,100,102,148,78,55,11,12,575
780140902,105,91,118,84,52,27,9,4,490
780140903,39,76,56,49,27,21,7,2,277
780140904,56,55,52,38,31,9,3,3,247
780140905,122,84,81,49,18,13,6,2,375
780140906,110,104,99,94,53,22,8,5,495
780140907,45,65,55,50,22,16,5,4,262
780140908,77,117,95,74,58,30,18,16,485
780140909,40,74,74,67,36,17,12,5,325
780140910,70,69,88,65,43,33,6,9,383
780140911,46,75,66,69,42,28,12,3,341
780140912,35,55,94,80,57,31,20,10,382
780140913,71,53,91,66,52,18,10,13,374
780140914,63,64,61,60,45,23,6,2,324
780141001,42,49,53,46,32,20,4,5,251
780141101,106,104,114,111,39,22,3,1,500
780141102,72,94,64,56,23,9,4,2,324
780141103,36,40,20,28,13,8,2,2,149
780141104,76,91,50,35,19,15,4,1,291
780141105,48,51,22,30,11,7,1,0,170
780141106,67,65,44,35,13,5,2,3,234
780141107,35,72,61,32,8,3,4,4,219
780141108,90,131,83,68,52,22,7,4,457
780141109,57,88,56,48,20,12,2,5,288
780141110,39,54,56,57,23,11,3,6,249
780141111,58,65,96,70,43,42,13,21,408
780141112,83,92,85,63,33,17,6,6,385
780141113,53,84,86,66,33,13,7,3,345
780141114,79,74,82,64,29,22,3,7,360
780141115,117,113,105,58,24,12,7,5,441
780141116,60,80,68,36,20,8,5,5,282
780141117,53,70,54,53,10,15,4,3,262
780141118,30,32,34,23,10,5,4,1,139
780141119,64,55,46,36,16,6,2,1,226
780141120,101,111,104,102,55,17,9,2,501
780141121,59,79,65,46,19,13,6,0,287
780141122,34,50,54,51,19,23,10,1,242
780141123,42,60,39,49,22,10,5,7,234
780141124,47,56,35,34,16,12,2,4,206
780141125,42,55,43,37,25,12,4,1,219
780141201,52,62,70,65,30,9,6,9,303
780141202,61,84,86,46,33,24,5,2,341
780141203,77,90,83,97,62,34,14,16,473
780141204,49,50,79,48,20,16,7,7,276
780141205,56,65,53,29,23,11,2,1,240
780141206,99,106,68,62,31,18,5,5,394
780141207,76,74,52,51,19,18,8,2,300
780141208,77,82,75,55,31,20,5,6,351
780210101,52,10,9,1,1,2,1,1,77
780210102,16,1,3,2,0,0,0,0,22
780210201,20,5,1,3,0,0,0,0,29
780210301,77,8,2,0,1,0,0,0,88
780210401,71,19,7,11,4,4,1,0,117
780210402,17,7,9,7,5,3,0,1,49
780210403,14,9,9,10,3,1,0,1,47
780210404,0,0,0,1,0,0,0,0,1
780210405,93,89,82,71,48,29,11,7,430
780210406,7,11,6,11,4,4,0,1,44
780210501,21,7,2,2,1,2,0,0,35
780210601,14,10,9,9,2,3,2,3,52
780210701,31,12,11,5,8,6,2,5,80
780210702,20,28,12,11,8,4,3,4,90
780210703,3,1,2,0,0,1,0,0,7
780210704,25,31,30,24,20,7,5,1,143
780210705,3,0,1,2,1,0,0,1,8
780210706,12,9,7,21,12,1,1,2,65
780210801,51,69,74,68,45,25,10,8,350
780210802,93,134,131,115,79,47,18,14,631
780210803,2,4,2,2,1,1,0,0,12
780210804,60,71,52,47,20,8,2,5,265
780210805,58,71,74,61,31,17,12,3,327
780210806,75,90,95,57,36,23,8,13,397
780210807,41,69,99,103,79,48,21,23,483
780210901,114,108,94,85,54,33,13,12,513
780210902,95,117,146,110,82,39,19,15,623
780210903,29,79,94,105,78,65,32,25,507
780211001,35,61,49,46,38,6,7,2,244
780211002,80,110,95,72,41,22,6,3,429
780211003,47,74,53,37,16,4,2,2,235
780211004,78,60,46,28,19,6,1,0,238
780211005,43,60,32,27,11,6,3,0,182
780211006,73,63,40,31,12,7,2,0,228
780211007,49,56,31,15,8,8,0,1,168
780211008,53,103,70,51,32,12,5,2,328
780211009,27,36,48,21,18,5,2,6,163
780211010,54,55,63,72,48,28,21,14,355
780211011,58,77,83,56,33,17,8,10,342
780211012,67,89,74,49,25,18,2,7,331
780211013,45,64,55,23,21,10,2,2,222
780211014,54,100,82,45,18,19,5,10,333
780211015,59,59,37,24,6,3,2,2,192
780211016,48,68,47,31,19,11,4,5,233
780211101,62,75,51,29,20,6,2,1,246
780211102,46,54,38,29,18,10,2,1,198
780211103,73,111,60,67,35,15,6,4,371
780211104,54,49,20,21,10,1,1,1,157
780211105,74,92,94,67,43,17,6,8,401
780211106,70,91,44,37,14,0,1,0,257
780211107,73,84,45,19,9,2,0,0,232
780211108,57,58,30,23,12,3,3,0,186
780211109,74,94,57,36,28,5,3,1,298
780211110,29,52,42,34,15,5,0,2,179
780211111,57,71,47,44,15,9,0,1,244
780211112,38,60,64,56,40,17,6,11,292
780211113,29,49,63,63,32,18,3,4,261
780211114,41,53,62,52,38,16,3,1,266
780211115,58,88,79,49,24,15,5,3,321
780211116,45,57,37,31,13,6,3,2,194
780211117,40,54,40,20,15,1,1,1,172
780211118,22,44,51,60,42,11,2,3,235
780211119,38,33,18,18,6,4,0,1,118
780211120,49,88,53,58,24,8,4,1,285
780211121,33,56,55,43,15,5,9,3,219
780211122,42,71,71,55,39,30,3,5,316
780211123,36,60,69,57,44,17,9,10,302
780211201,76,109,80,59,39,6,5,7,381
780211202,39,49,46,40,21,9,1,1,206
780211203,51,67,44,46,16,16,0,2,242
780211204,43,63,64,49,31,20,10,5,285
780211205,78,122,107,78,34,15,2,1,437
780211206,35,39,33,32,10,7,3,2,161
780211207,51,82,87,59,46,23,13,10,371
780211208,40,83,88,83,30,23,9,10,366
780211209,44,91,53,64,41,18,9,5,325
780211210,16,22,40,72,47,20,7,5,229
780211211,30,68,45,55,25,9,1,3,236
780211212,69,90,90,75,40,26,9,2,401
780211213,28,38,43,35,33,16,3,5,201
780211214,41,53,67,50,29,8,5,4,257
780211215,27,61,57,37,20,18,2,4,226
780211216,39,48,45,52,25,25,5,14,253
780211217,25,48,43,42,39,18,1,6,222
780211218,35,45,45,40,21,9,3,3,201
780211219,24,33,53,56,31,9,4,6,216
780211220,41,88,87,85,47,17,11,10,386
780211221,24,60,108,158,112,64,20,11,557
780211301,42,69,81,73,39,12,9,3,328
780211302,33,34,46,46,30,17,4,3,213
780211303,26,12,31,43,25,29,1,9,176
780211304,77,101,113,80,53,14,3,2,443
780211305,46,79,101,114,68,35,7,13,463
780211306,37,85,100,127,82,50,22,28,531
780211307,45,75,86,96,84,52,28,20,486
780211308,41,72,78,90,69,47,28,23,448
780211309,48,44,61,74,62,29,6,9,333
780211310,44,45,71,82,36,24,8,12,322
780211311,16,40,63,54,43,27,13,14,270
780211312,30,83,120,142,98,60,29,21,583
780211313,43,35,39,36,21,9,3,3,189
780211314,29,33,43,52,44,30,11,10,252
780211315,21,68,88,121,71,47,13,17,446
780211316,13,13,11,10,5,0,2,1,55
780211317,64,74,114,101,68,42,14,20,497
780211318,33,45,44,41,15,8,2,0,188
780211319,16,32,37,30,25,13,4,2,159
780211320,71,81,120,121,88,66,15,19,581
780211321,44,63,54,74,58,29,8,8,338
780211322,24,53,71,97,57,35,13,10,360
780211401,47,67,71,85,52,39,19,11,391
780211402,60,80,78,57,43,19,2,1,340
780211403,38,58,44,47,33,31,7,11,269
780211404,40,52,44,41,25,16,8,10,236
780211405,36,59,43,30,29,19,4,5,225
780211406,78,93,71,55,35,14,8,10,364
780211407,81,108,94,68,41,17,3,9,421
780211408,64,75,61,69,33,20,9,8,339
780211409,51,54,78,53,27,14,11,6,294
780211410,65,77,66,53,33,34,12,15,355
780211411,39,39,50,42,25,27,9,8,239
780211412,25,44,63,38,32,10,4,5,221
780211413,27,35,30,28,16,5,5,2,148
780211414,50,88,73,97,45,34,8,9,404
780211415,43,71,66,41,25,18,9,5,278
780280101,8,6,2,1,0,0,0,0,17
780280102,13,7,2,2,0,1,0,0,25
780280103,148,126,91,68,32,12,2,2,481
780280201,7,2,0,0,0,0,0,0,9
780280301,11,1,0,0,0,0,0,0,12
780280401,14,5,1,0,2,0,1,1,24
780280402,22,24,18,6,14,2,0,0,86
780280501,5,7,6,0,2,2,0,0,22
780280502,7,7,0,0,0,0,0,0,14
780280503,98,124,94,97,36,18,4,2,473
780280504,109,176,161,145,87,40,31,14,763
780280505,12,16,12,23,13,15,8,4,103
780280506,20,23,27,21,6,2,1,1,101
780280507,1,1,2,0,0,0,0,0,4
780280508,3,3,3,3,2,1,0,1,16
780280509,14,7,4,4,4,4,1,2,40
780280510,82,89,79,36,19,7,3,1,316
780280511,3,4,5,3,0,0,0,0,15
780280512,12,9,2,3,0,2,1,0,29
780280513,106,130,122,133,61,41,11,8,612
780280514,56,68,99,100,63,24,9,5,424
780280601,16,1,1,1,0,0,0,0,19
780280701,55,58,32,32,11,5,2,3,198
780280702,82,69,70,36,24,12,0,3,296
780280703,73,88,61,71,40,17,6,7,363
780280704,126,153,93,70,37,10,4,5,498
780280705,40,83,63,38,34,9,0,5,272
780280706,59,68,76,42,16,14,4,1,280
780350101,12,3,0,0,0,0,0,0,15
780350102,9,3,1,0,1,0,0,0,14
780350201,14,3,4,0,0,0,0,0,21
780350301,16,4,1,0,1,0,0,0,22
780350401,21,6,2,2,0,0,0,0,31
780350402,64,66,46,35,25,11,1,2,250
780350403,76,87,97,76,46,25,10,8,425
780350404,63,80,74,70,44,28,12,8,379
780350501,5,3,0,3,0,0,0,2,13
780350601,52,42,43,26,22,10,5,8,208
780350602,81,113,82,63,36,19,10,6,410
780350603,65,75,83,77,54,28,11,11,404
780350604,47,57,64,49,23,19,8,8,275
780350605,28,22,20,17,10,2,1,4,104
780420101,18,7,3,2,0,1,1,1,33
780420201,9,2,2,1,1,0,0,0,15
780420202,25,21,37,57,32,8,8,2,190
780420203,0,18,29,48,27,11,12,0,145
780420301,62,60,61,68,28,16,3,9,307
780420302,115,111,82,45,30,13,5,1,402
780420303,34,37,23,18,8,5,0,1,126
780420304,88,60,56,40,29,15,3,3,294
780420305,84,111,85,62,34,26,10,10,422
780420306,79,127,133,98,58,20,11,12,538
780420307,38,82,66,74,47,17,7,4,335
780490101,25,8,2,3,0,1,0,1,40
780490102,7,1,3,1,1,0,0,0,13
780490103,19,17,22,17,8,3,1,1,88
780490201,16,12,1,0,1,0,0,0,30
780490301,8,3,4,2,1,0,0,2,20
780490401,6,0,0,1,0,0,0,1,8
780490501,83,91,98,127,61,34,15,20,529
780490502,96,114,90,80,45,18,8,7,458
780490503,53,41,53,50,25,16,3,2,243
820070101,13,23,16,14,6,2,1,2,77
820070102,19,18,30,26,12,10,2,1,118
820070103,82,90,78,84,39,16,4,8,401
820070104,12,17,9,21,6,2,2,2,71
820070201,73,74,83,67,23,11,0,1,332
820070202,76,86,92,60,43,13,5,4,379
820070203,70,88,54,54,24,13,1,0,304
820070204,34,55,82,97,52,30,6,14,370
820070205,53,81,85,65,42,21,5,11,363
820070206,54,84,54,47,17,12,3,0,271
820070207,53,67,49,43,18,10,2,1,243
820070208,67,110,122,110,63,30,14,4,520
820070209,16,25,17,23,11,4,0,2,98
820070210,36,47,68,73,40,23,5,2,294
820070211,40,84,97,76,54,28,7,6,392
820070212,11,28,14,22,15,5,2,0,97
820070213,64,68,45,35,19,11,2,2,246
820070214,49,70,46,38,22,5,0,2,232
820070215,47,68,39,40,13,7,1,2,217
820070216,24,50,62,66,69,29,17,13,330
820070217,50,63,51,39,24,18,2,2,249
820070301,56,96,57,58,17,12,2,4,302
820070302,78,99,77,88,31,16,4,3,396
820070303,99,96,80,60,31,9,1,0,376
820070304,94,99,75,55,21,6,2,1,353
820070305,44,94,93,85,48,22,8,6,400
820070306,51,70,47,88,58,22,6,11,353
820070307,8,23,22,21,10,10,2,1,97
820070308,64,66,50,36,19,23,1,3,262
820070309,15,14,19,20,9,5,2,0,84
820070310,99,129,91,87,44,25,6,7,488
820070311,67,97,64,65,21,10,0,0,324
820070312,79,101,96,84,31,15,2,1,409
820070313,52,67,51,57,24,5,3,5,264
820070314,32,58,59,59,20,11,2,2,243
820070315,46,80,63,77,39,14,2,2,323
820070401,47,61,43,49,26,16,6,6,254
820070402,55,55,31,31,15,8,1,2,198
820070403,90,90,64,49,23,8,2,0,326
820070404,42,50,40,37,24,16,3,1,213
820070405,79,72,50,49,17,5,1,2,275
820070406,63,58,70,61,31,11,2,1,297
820070407,76,77,77,65,35,19,7,5,361
820070408,57,76,71,63,34,13,14,7,335
820070409,69,83,84,99,61,35,17,18,466
820070410,47,53,63,43,22,9,3,2,242
820070411,70,61,47,32,19,7,0,0,236
820070412,58,65,88,85,49,30,7,9,391
820070413,50,42,56,52,36,24,14,20,294
820070414,57,76,77,48,27,22,4,4,315
820140101,82,96,106,75,42,19,4,4,428
820140102,78,98,86,79,46,20,6,6,419
820140103,49,71,59,63,28,7,2,2,281
820140104,50,79,33,48,15,5,0,0,230
820140105,64,92,51,59,20,6,1,0,293
820140106,81,104,77,72,28,9,0,0,371
820140107,53,75,67,74,29,20,4,4,326
820140108,53,65,58,53,28,15,4,1,277
820140109,114,126,90,85,26,10,0,0,451
820140110,88,118,77,102,34,12,0,1,432
820140111,64,88,72,62,30,17,7,5,345
820140112,80,124,76,79,36,13,0,2,410
820140113,56,65,80,69,27,11,0,5,313
820140114,75,95,85,70,33,12,3,1,374
820140115,100,118,99,77,39,16,6,5,460
820140116,42,60,56,44,27,10,3,8,250
820140117,55,74,54,57,24,10,2,2,278
820140118,2,1,2,1,0,1,0,0,7
820140119,5,7,2,4,4,0,1,0,23
820140120,3,10,8,8,5,1,0,0,35
820140121,7,13,6,14,5,0,0,0,45
820140122,4,4,1,4,1,2,0,1,17
820140123,0,2,3,1,0,0,0,0,6
820140124,5,11,9,3,0,1,0,0,29
820140125,4,7,6,2,1,0,0,0,20
820140126,9,14,11,10,2,3,0,0,49
820140127,7,5,9,6,2,3,0,0,32
820140128,8,17,18,10,7,3,1,0,64
820140129,5,19,5,6,4,3,2,2,46
820140130,51,77,56,62,14,3,3,0,266
820140201,15,17,7,6,6,2,1,0,54
820140202,3,4,11,9,3,3,0,0,33
820140203,71,78,66,59,23,3,2,2,304
820140204,76,106,103,96,67,28,7,8,491
820140205,65,85,65,39,35,7,1,0,297
820140206,37,80,84,86,26,5,1,3,322
820140207,59,91,75,64,28,5,4,1,327
820140208,55,75,56,53,15,7,2,0,263
820140209,46,69,49,39,17,5,1,0,226
820140210,108,111,55,43,15,5,1,0,338
820140211,69,69,43,38,17,3,1,0,240
820140212,36,44,39,30,18,9,0,1,177
820140213,57,59,49,24,9,5,0,0,203
820140214,59,65,42,31,7,3,1,0,208
820140215,63,55,37,19,11,1,0,0,186
820140216,54,69,45,30,7,5,0,1,211
820140217,51,70,58,37,15,1,1,1,234
820140218,43,71,96,100,52,22,6,8,398
820140219,44,50,52,64,24,13,6,8,261
820140301,52,88,38,36,10,3,1,0,228
820140302,85,72,47,38,12,5,0,0,259
820140303,151,129,75,45,27,6,0,1,434
820140304,53,74,28,37,17,2,2,0,213
820140305,62,89,60,46,17,12,3,0,289
820140306,15,18,20,22,8,7,1,3,94
820140307,83,74,88,95,59,42,13,19,473
820140308,31,59,53,51,34,18,7,6,259
820140309,62,74,60,40,29,16,1,0,282
820140310,84,92,62,42,20,10,1,2,313
820140311,82,81,42,47,16,12,8,10,298
820140312,10,11,7,4,5,2,0,0,39
820140401,48,67,63,55,26,10,8,6,283
820140402,67,92,80,61,18,9,3,1,331
820140403,75,89,62,68,37,13,0,2,346
820140404,61,88,68,60,33,11,4,3,328
820140405,60,98,65,51,21,9,3,2,309
820140406,80,86,85,75,45,17,7,3,398
820140407,55,67,68,46,23,20,3,8,290
820140408,75,77,78,69,38,24,9,7,377
820140409,49,66,54,46,13,1,1,1,231
820140410,46,52,68,65,31,13,3,7,285
820140411,92,78,55,63,22,9,6,2,327
820140412,58,79,74,66,31,19,9,4,340
820140413,7,7,1,3,0,0,1,0,19
820140414,1,1,3,0,0,0,0,0,5
820140415,22,17,16,20,12,4,5,1,97
820140416,24,22,22,11,12,5,4,1,101
820140417,13,14,10,10,5,4,0,0,56
820140418,12,22,11,22,8,2,1,2,80
820140419,84,87,79,58,18,17,5,4,352
820140420,70,77,52,51,18,6,1,1,276
820140501,4,6,5,2,0,0,0,0,17
820140502,13,17,7,7,5,1,1,0,51
820140503,83,109,77,72,39,17,5,1,403
820140504,71,111,69,80,23,9,1,0,364
820140505,23,17,20,11,8,6,1,2,88
820140506,72,98,83,69,34,5,4,2,367
820140507,62,95,54,73,16,4,2,0,306
820140508,99,111,52,48,22,9,0,1,342
820140509,45,69,48,37,20,6,4,2,231
820140510,76,133,62,60,21,5,0,1,358
820140511,54,82,64,73,41,11,3,0,328
820140512,3,5,6,1,0,1,0,1,17
820140513,59,53,44,39,26,5,4,1,231
820140514,56,86,69,59,25,20,8,3,326
820140515,5,8,7,2,2,0,0,0,24
820140516,4,5,4,8,1,1,0,0,23
820140517,100,99,76,58,34,12,3,7,389
820140518,50,55,40,35,23,5,1,1,210
820140519,64,73,57,49,16,11,3,0,273
820140520,2,2,2,2,2,0,0,0,10
820140521,1,1,1,2,0,0,0,0,5
820140522,1,2,4,1,1,0,0,0,9
820140523,77,72,45,51,17,3,2,2,269
820140524,27,53,35,31,17,6,4,1,174
820140601,79,102,159,176,92,84,36,37,765
820140602,77,109,104,95,40,15,4,7,451
820140603,65,67,37,39,11,4,1,0,224
820140604,59,81,86,86,26,11,2,5,356
820140605,74,81,96,91,50,30,12,25,459
820140606,44,55,50,52,32,20,5,4,262
820140607,79,117,94,84,37,8,7,5,431
820140608,86,75,81,61,29,13,4,8,357
820140609,70,67,87,66,52,42,11,8,403
820140610,5,6,2,1,2,0,0,0,16
820140611,5,8,7,3,3,1,0,0,27
820149001,2,7,5,4,3,1,1,0,23
820210101,13,15,13,5,6,2,1,0,55
820210102,2,3,7,2,3,3,1,0,21
820210103,61,107,85,76,47,22,6,22,426
820210104,85,94,59,49,21,16,5,3,332
820210105,64,62,36,36,24,12,2,2,238
820210106,82,110,59,37,22,12,2,8,332
820210107,65,97,55,38,23,10,2,3,293
820210108,6,22,18,27,12,8,6,8,107
820210109,6,3,11,6,7,2,1,0,36
820210110,94,79,59,86,39,22,7,2,388
820210111,5,21,18,19,9,8,7,1,88
820210112,18,22,28,30,18,14,10,5,145
820210113,11,19,12,13,6,2,0,1,64
820210114,12,8,10,7,10,2,2,2,53
820210115,75,54,43,22,19,9,2,7,231
820210116,21,17,17,21,19,6,3,5,109
820210117,14,8,14,14,17,8,5,2,82
820210118,50,66,46,43,23,13,4,4,249
820210119,106,118,85,103,46,25,9,14,506
820210120,9,8,18,14,12,7,3,7,78
820210121,5,11,13,9,7,3,4,1,53
820210122,5,6,12,8,9,7,4,1,52
820210123,15,25,15,15,9,6,2,1,88
820210124,77,96,67,77,34,31,8,10,400
820210125,1,6,10,1,3,2,1,1,25
820210126,3,10,10,13,8,4,5,2,55
820210127,5,6,7,14,7,1,0,1,41
820210128,7,18,19,25,19,7,3,6,104
820210129,0,5,12,7,8,4,2,1,39
820210130,9,9,13,11,11,4,1,2,60
820210131,4,5,13,9,7,14,4,1,57
820210132,9,18,11,19,14,6,3,4,84
820210133,78,101,63,49,43,17,6,3,360
820210134,74,79,61,57,37,25,10,5,348
820210201,93,117,82,66,34,20,10,3,425
820210202,82,114,71,64,33,17,0,1,382
820210203,100,129,69,51,30,4,3,3,389
820210204,90,128,85,80,37,8,2,2,432
820210205,76,103,85,91,59,25,10,7,456
820210206,48,108,57,63,35,6,1,1,319
820210207,70,90,76,89,39,22,9,4,399
820210208,105,125,50,51,26,8,3,0,368
820210209,102,113,83,69,43,10,1,1,422
820210210,90,103,76,51,27,9,4,4,364
820210211,67,71,57,59,24,19,9,3,309
820210212,48,91,105,98,48,16,14,8,428
820210213,51,65,38,36,11,3,1,1,206
820210214,74,89,68,61,34,10,7,0,343
820210215,82,110,116,193,66,20,9,4,600
820210216,59,84,56,77,43,10,1,4,334
820210217,35,67,99,126,72,38,13,17,467
820210218,48,74,87,69,55,27,10,9,379
820210301,4,5,8,2,1,0,0,0,20
820210302,97,119,117,124,47,21,13,7,545
820210303,5,14,9,15,9,8,6,1,67
820210304,21,22,19,16,12,11,0,2,103
820210305,87,113,90,69,34,26,16,9,444
820210306,6,14,15,11,12,5,1,5,69
820210307,11,7,13,19,7,5,0,2,64
820210308,17,27,16,18,4,5,2,2,91
820210309,3,0,1,3,1,1,1,0,10
820210310,13,25,21,33,23,12,5,5,137
820210311,36,33,51,36,23,15,4,4,202
820210312,11,7,8,7,6,1,0,0,40
820210313,55,107,63,60,41,9,3,3,341
820210314,11,18,24,27,11,4,1,2,98
820210315,10,18,11,11,5,7,2,1,65
820210316,7,5,7,4,2,3,1,2,31
820210317,82,106,54,72,28,21,6,4,373
820210318,82,118,66,49,28,10,6,7,366
820210319,4,15,9,14,11,8,4,3,68
820210320,30,30,13,17,13,3,1,0,107
820210321,100,105,80,77,37,16,4,8,427
820210322,15,22,15,21,13,6,1,5,98
820210323,0,5,3,10,13,1,4,1,37
820210324,3,5,6,3,6,3,3,2,31
820210325,5,1,4,9,7,1,1,1,29
820210326,1,8,7,7,4,5,1,2,35
820210327,18,34,30,39,37,20,4,2,184
820210328,6,11,10,3,6,7,2,2,47
820210329,2,7,12,6,10,6,5,1,49
820210330,2,7,11,9,7,5,1,1,43
820210331,1,7,11,13,8,6,0,1,47
820210332,16,24,21,15,9,2,0,2,89
820210333,23,26,29,34,18,4,5,5,144
820210401,79,119,111,97,58,32,7,7,510
820210402,71,70,65,40,34,11,2,5,298
820210403,36,61,52,47,15,4,0,1,216
820210404,77,92,63,61,30,16,6,1,346
820210405,36,71,54,35,24,9,0,2,231
820210406,50,100,77,121,48,22,4,4,426
820210407,34,46,28,21,9,6,2,1,147
820210408,91,103,80,55,15,10,6,2,362
820210409,88,107,61,51,27,9,2,4,349
820210410,54,42,27,16,14,5,2,0,160
820210411,89,99,64,30,22,6,3,2,315
820210412,67,82,38,39,13,6,0,2,247
820210413,71,78,44,42,16,10,0,1,262
820210414,93,96,62,50,11,6,1,1,320
820210415,79,102,62,48,22,12,4,2,331
820210416,82,149,155,233,141,87,42,36,925
820210417,21,33,85,84,76,43,18,34,394
820210418,34,78,85,100,74,28,17,19,435
820210419,48,61,83,86,71,25,11,19,404
820210420,46,54,49,41,27,14,9,6,246
820210421,32,64,33,39,23,11,4,1,207
820210422,57,97,171,263,166,115,46,60,975
820210501,33,50,58,54,51,29,19,25,319
820210502,52,55,73,61,49,32,8,25,355
820210503,66,82,80,85,44,23,5,6,391
820210504,58,56,67,41,33,9,7,6,277
820210505,105,107,88,92,58,27,15,15,507
820210506,53,93,80,54,36,11,3,3,333
820210507,61,71,55,33,11,7,3,1,242
820210508,99,113,61,55,23,10,3,1,365
820210509,100,83,31,20,12,2,1,2,251
820210510,62,75,26,27,13,3,0,1,207
820210511,75,91,40,42,24,1,3,1,277
820210512,50,63,72,87,47,46,16,18,399
820210513,54,100,105,119,59,48,18,28,531
820210514,44,68,104,90,76,29,16,19,446
820210601,31,65,76,65,37,27,16,17,334
820210602,101,109,70,55,16,9,2,0,362
820210603,92,92,58,25,18,6,1,0,292
820210604,84,83,55,37,20,7,2,0,288
820210605,69,104,97,60,32,8,3,1,374
820210606,102,101,66,35,14,10,0,1,329
820210607,109,143,84,71,27,9,2,4,449
820210608,91,98,71,75,39,17,3,6,400
820210609,74,97,90,76,58,21,7,4,427
820210610,43,97,72,85,48,14,5,6,370
820210611,18,66,73,77,50,33,19,14,350
820210612,61,99,85,95,41,13,7,2,403
820210613,36,68,65,54,38,12,2,3,278
820210614,51,89,101,82,41,14,2,0,380
820210615,18,26,18,46,19,2,3,1,133
820210616,139,245,211,249,103,29,4,4,984
820210617,46,72,54,49,25,10,1,2,259
820210618,63,103,109,97,47,13,8,1,441
820210619,54,78,100,115,75,16,7,7,452
820210620,55,78,77,97,60,17,12,10,406
820210701,39,78,48,38,13,12,4,2,234
820210702,61,73,87,96,102,58,25,28,530
820210703,10,15,8,8,3,0,1,0,45
820210704,4,8,10,10,9,3,4,3,51
820210705,4,6,11,5,2,3,0,2,33
820210706,53,54,52,30,17,10,3,7,226
820210707,64,64,60,50,35,9,5,3,290
820210708,0,1,0,1,1,2,0,0,5
820210709,1,7,7,11,3,2,1,2,34
820210710,52,79,50,46,27,10,2,3,269
820210711,6,7,6,7,7,1,1,2,37
820210712,56,77,73,49,33,14,4,5,311
820210713,48,69,39,45,23,8,2,3,237
820210714,11,9,13,15,3,4,3,1,59
820210715,8,5,6,3,3,3,0,1,29
820210716,4,4,5,4,6,5,0,1,29
820210717,58,84,74,83,52,43,13,13,420
820210718,30,79,69,81,51,23,11,13,357
820210719,25,38,36,54,36,23,7,20,239
820210720,58,75,65,57,21,6,7,5,294
820210721,32,41,46,51,35,24,10,9,248
820210722,67,90,110,121,81,57,18,23,567
820210723,1,3,1,0,1,0,1,0,7
820210724,34,50,44,53,40,20,8,6,255
820210725,31,41,50,47,17,16,6,5,213
820210726,48,37,50,69,50,27,8,16,305
820210801,65,62,34,26,10,4,0,1,202
820210802,115,107,50,44,18,8,0,0,342
820210803,75,61,60,39,24,7,2,2,270
820210804,83,117,55,42,19,5,0,0,321
820210805,69,101,50,54,19,10,1,1,305
820210806,44,63,38,35,15,5,4,1,205
820210807,40,65,90,96,54,37,13,5,400
820210808,31,68,68,52,25,16,6,5,271
820210809,58,69,66,59,37,19,3,7,318
820210810,72,87,80,48,47,21,3,6,364
820210811,94,97,79,62,22,10,4,0,368
820210812,47,72,32,23,19,5,0,0,198
820210813,48,37,49,51,48,24,5,22,284
820210814,58,92,80,76,44,15,14,7,386
820210815,34,57,59,52,35,24,11,13,285
820210901,104,132,90,65,28,9,1,3,432
820210902,73,103,76,60,28,14,2,2,358
820210903,87,102,88,60,27,10,2,3,379
820210904,58,108,108,140,65,25,6,9,519
820210905,54,76,46,44,25,10,2,1,258
820210906,72,79,41,37,22,4,0,0,255
820210907,92,101,61,49,30,12,1,0,346
820210908,20,19,8,6,4,1,0,0,58
820210909,83,72,42,49,13,3,1,1,264
820210910,35,55,45,32,17,3,2,2,191
820210911,69,79,88,81,41,17,3,5,383
820210912,69,88,91,105,50,15,3,4,425
820210913,46,61,60,41,30,9,4,2,253
820210914,68,79,60,57,25,8,1,0,298
820211001,13,19,8,10,16,7,1,1,75
820211002,47,57,32,31,23,10,3,2,205
820211003,4,10,12,27,11,1,3,1,69
820211004,3,17,8,5,6,4,1,0,44
820211005,5,12,18,7,3,6,0,1,52
820211006,119,116,87,89,37,9,2,3,462
820211007,75,113,78,67,28,12,3,4,380
820211008,77,119,100,85,32,15,7,4,439
820211009,79,132,86,69,33,9,4,3,415
820211010,1,5,4,3,1,2,0,0,16
820211011,7,9,10,11,8,5,0,0,50
820211012,13,17,18,13,10,4,2,3,80
820211013,51,85,99,101,55,30,15,14,450
820211014,66,104,78,54,23,15,9,9,358
820211015,101,120,71,47,42,12,1,3,397
820211016,86,76,41,49,20,6,2,0,280
820211017,89,109,70,61,26,7,3,2,367
820211018,78,108,55,42,25,8,4,0,320
820280101,116,143,90,113,52,13,4,4,535
820280102,62,72,42,37,16,7,1,1,238
820280103,60,45,50,42,15,6,2,0,220
820280104,91,95,106,88,36,15,11,9,451
820280105,125,122,121,105,61,35,13,13,595
820280106,7,3,2,5,3,0,0,0,20
820280107,23,41,27,33,17,4,2,1,148
820280108,35,60,58,49,28,20,6,2,258
820280109,46,51,56,40,21,1,1,1,217
820280110,9,15,21,21,7,3,2,3,81
820280111,8,14,12,8,5,2,1,0,50
820280112,79,87,83,64,27,12,4,4,360
820280113,95,98,72,58,26,8,3,0,360
820280114,69,80,49,47,27,6,12,4,294
820280115,4,4,1,4,0,0,0,0,13
820280116,8,8,3,2,0,0,0,0,21
820280117,73,86,75,57,28,10,0,5,334
820280118,0,6,5,5,3,1,0,0,20
820280119,16,8,8,5,3,2,0,0,42
820280120,40,49,38,31,11,3,0,1,173
820280121,48,61,47,43,17,7,2,0,225
820280122,48,63,65,51,20,9,5,2,263
820280123,53,63,39,29,13,5,0,2,204
820280124,46,58,40,43,27,11,1,5,231
820280201,102,142,131,110,58,29,13,7,592
820280202,15,5,6,6,6,1,1,4,44
820280203,40,34,27,16,12,8,1,2,140
820280204,76,97,67,53,19,7,4,0,323
820280205,96,120,124,75,34,24,10,7,490
820280206,10,9,7,7,4,1,1,0,39
820280207,64,85,54,52,20,7,2,3,287
820280208,15,15,21,24,5,2,1,1,84
820280209,26,23,26,16,11,8,2,2,114
820280210,6,10,2,3,2,0,0,0,23
820280211,70,87,59,84,30,6,5,1,342
820280212,50,65,58,46,26,11,7,3,266
820280213,6,4,0,4,1,0,0,0,15
820280214,46,64,39,39,20,9,2,3,222
820280215,1,8,5,3,4,1,0,0,22
820280216,63,71,37,43,12,4,3,2,235
820280217,5,3,6,9,3,2,0,0,28
820280218,2,3,4,3,1,0,0,0,13
820280219,3,6,2,1,2,0,0,0,14
820280220,80,63,52,39,26,5,1,1,267
820280221,74,84,54,46,23,3,0,1,285
820280301,83,80,117,95,83,77,27,39,601
820280302,67,90,82,63,26,7,4,4,343
820280303,70,75,63,75,41,22,5,8,359
820280304,63,116,73,46,17,5,6,3,329
820280305,36,80,71,53,19,6,2,1,268
820280306,58,62,79,118,60,22,8,11,418
820280307,52,98,76,80,35,17,2,4,364
820280308,75,83,68,55,30,9,5,2,327
820280309,82,120,150,171,110,53,19,24,729
820280310,17,16,9,7,5,3,2,1,60
820280311,39,71,64,48,33,13,4,4,276
820280312,10,22,17,25,14,19,3,1,111
820280313,39,32,24,32,21,7,3,0,158
820280314,38,50,37,25,15,2,6,0,173
820280315,10,15,14,13,7,2,1,1,63
820280316,52,62,53,36,17,6,2,1,229
820280317,6,10,6,5,7,3,0,0,37
820280318,45,67,94,74,33,13,2,5,333
820280319,30,44,23,34,15,5,1,0,152
820280320,45,51,47,38,21,12,5,7,226
820280321,53,66,38,42,15,8,5,1,228
820280322,30,24,35,39,28,22,10,10,198
820280323,13,10,10,12,4,4,0,0,53
820280324,24,49,47,55,48,19,14,8,264
820280325,8,10,7,10,1,0,2,0,38
820280326,72,112,124,106,67,28,10,9,528
820280327,17,33,27,12,5,8,1,2,105
820280401,67,72,71,80,47,12,7,7,363
820280402,60,76,46,56,22,14,5,4,283
820280403,73,78,67,78,30,20,10,7,363
820280404,69,108,62,68,41,17,9,5,379
820280405,65,77,70,77,37,24,11,7,368
820280406,61,86,38,49,10,2,1,1,248
820280407,77,109,75,46,23,8,3,2,343
820280408,52,80,45,45,13,14,3,1,253
820280409,67,104,65,65,21,4,1,0,327
820280410,92,118,104,99,47,15,8,8,491
820280411,48,88,74,45,22,6,3,3,289
820280412,59,96,64,88,34,13,2,1,357
820280413,54,79,87,105,37,13,4,3,382
820280414,42,95,90,94,38,27,4,6,396
820280415,36,69,88,68,28,20,5,1,315
820280501,32,50,54,63,42,28,12,16,297
820280502,56,61,50,36,19,9,5,2,238
820280503,69,69,64,54,28,8,2,2,296
820280504,50,79,75,67,22,6,6,1,306
820280505,78,103,104,102,52,15,12,10,476
820280506,69,93,136,125,85,27,10,8,553
820280507,35,87,69,62,35,11,5,5,309
820280508,55,94,87,81,61,27,12,8,425
820280509,44,74,79,73,49,28,12,7,366
820280510,45,57,46,50,17,13,2,0,230
820280511,75,109,101,104,38,15,7,8,457
820280512,60,89,94,105,90,35,26,23,522
820280513,25,83,102,107,47,24,10,17,415
820280514,34,55,79,87,36,33,8,15,347
820280515,35,55,79,88,60,36,12,22,387
820280516,33,76,65,39,18,20,4,3,258
820280517,38,89,77,88,54,51,16,23,436
820289201,4,12,15,10,7,2,0,0,50
820350101,20,15,20,14,9,15,3,5,101
820350102,36,47,46,43,29,16,12,20,249
820350103,18,13,9,6,11,2,2,3,64
820350104,1,2,3,2,0,1,0,0,9
820350105,5,3,3,4,0,0,0,1,16
820350106,30,24,43,30,22,21,13,30,213
820350107,12,6,3,5,1,0,1,0,28
820350108,17,18,23,11,13,5,3,10,100
820350109,15,12,13,17,10,5,2,3,77
820350110,30,23,31,22,12,17,4,12,151
820350111,65,77,73,69,43,29,11,14,381
820350112,30,32,40,30,31,32,13,32,240
820350113,48,64,66,47,45,24,17,16,327
820350114,70,69,61,64,40,25,9,10,348
820350115,5,6,3,1,1,4,1,0,21
820350116,14,25,24,28,18,19,7,9,144
820350117,55,54,50,55,29,15,2,15,275
820350201,0,1,2,2,0,0,0,0,5
820350202,80,115,108,100,49,46,26,32,556
820350203,5,6,10,6,3,2,0,0,32
820350204,5,4,2,3,1,1,0,2,18
820350205,13,11,8,6,6,4,2,0,50
820350206,21,22,25,24,12,10,4,10,128
820350207,41,54,63,57,40,30,10,9,304
820350208,12,19,9,16,16,6,4,2,84
820350209,66,62,47,55,39,21,18,17,325
820350210,72,89,74,66,40,17,9,8,375
820350211,95,105,106,118,66,30,13,13,546
820350212,66,72,73,86,44,26,7,8,382
820350213,64,57,64,55,23,20,10,18,311
820420101,13,16,8,3,3,0,0,0,43
820420102,60,51,37,37,25,11,4,1,226
820420103,56,72,70,57,18,6,2,2,283
820420104,19,26,24,15,16,5,3,2,110
820420105,11,12,4,6,1,1,0,0,35
820420106,11,11,11,10,8,4,1,1,57
820420107,56,58,58,80,26,28,10,6,322
820420108,88,96,100,86,45,14,4,6,439
820420109,71,111,91,83,37,11,6,1,411
820420110,27,33,36,33,15,8,1,5,158
820420111,71,86,72,65,26,13,7,4,344
820420112,57,116,60,37,26,7,2,4,309
820420113,8,13,11,13,6,2,1,0,54
820420115,68,79,53,52,18,0,1,1,272
820420116,18,20,19,14,15,6,1,3,96
820420117,15,27,20,31,13,8,3,4,121
820420118,11,16,13,11,5,5,1,0,62
820420119,25,30,16,17,13,7,2,4,114
820420120,9,21,11,6,2,2,1,0,52
820420121,24,24,20,15,7,4,4,0,98
820420122,71,86,61,49,34,15,6,1,323
820420123,57,63,46,41,19,15,8,2,251
820420124,29,20,17,26,12,5,1,2,112
820420201,59,19,10,8,6,2,2,2,108
820420202,24,35,34,40,16,5,1,3,158
820420203,8,18,13,7,8,1,1,2,58
820420204,21,20,20,17,4,0,1,0,83
820420205,78,87,73,60,35,11,5,3,352
820420206,51,76,48,73,45,22,9,14,338
820420207,58,80,38,46,21,2,2,0,247
820420208,62,71,48,37,12,8,2,3,243
820420209,12,8,6,2,3,4,0,0,35
820420210,28,37,32,29,23,9,7,4,169
820420211,19,24,23,12,11,12,4,2,107
820420212,65,83,35,56,23,6,4,10,282
820420213,94,71,58,48,25,5,3,1,305
820420214,67,99,79,68,56,21,12,5,407
820420215,94,118,90,86,34,11,7,8,448
820420216,26,26,20,16,10,3,2,3,106
820420217,22,23,19,21,8,3,1,3,100
820420218,15,32,28,23,13,6,4,1,122
820420219,63,76,83,78,49,25,4,2,380
820420220,66,102,59,70,27,7,3,2,336
820420221,75,119,100,75,34,12,6,4,425
820420222,54,79,61,59,31,16,3,7,310
820420301,17,17,15,9,6,1,0,2,67
820420302,45,35,35,30,12,8,2,2,169
820420303,21,19,16,8,5,1,1,0,71
820420304,16,15,17,11,5,6,2,0,72
820420305,28,22,15,15,16,9,3,2,110
820420306,23,17,18,15,7,1,2,1,84
820420307,9,11,8,7,5,6,0,0,46
820420308,41,48,40,35,22,7,4,1,198
820420309,42,54,19,21,9,5,4,3,157
820420310,50,60,42,39,30,8,2,1,232
820420311,62,64,52,58,31,8,6,3,284
820420312,64,77,77,58,44,23,5,14,362
820420313,129,121,111,98,61,24,5,3,552
820420314,69,63,54,61,39,12,9,8,315
820420315,54,77,65,66,24,13,4,1,304
820420316,93,137,82,71,31,19,5,2,440
820420317,49,88,43,44,17,6,3,1,251
820420318,85,85,76,68,40,19,9,9,391
820420319,38,54,32,28,17,4,3,2,178
820420320,6,9,4,2,4,2,0,0,27
820420321,4,5,3,6,7,2,0,2,29
820420322,5,9,4,4,2,2,0,0,26
820420323,68,71,49,50,24,12,6,7,287
820420324,56,61,42,32,23,8,1,0,223
820420401,88,131,85,70,28,14,1,1,418
820420402,101,101,102,107,68,43,16,23,561
820420403,61,87,99,95,64,41,11,15,473
820420404,79,105,95,79,50,20,7,3,438
820420405,58,73,37,27,17,5,2,0,219
820420406,101,113,43,47,25,6,0,2,337
820420407,63,91,32,33,14,4,0,1,238
820420408,51,83,85,112,48,9,1,1,390
820420409,86,90,54,38,16,2,0,0,286
820420410,70,66,35,34,8,4,1,0,218
820420411,34,55,22,29,13,4,1,1,159
820420412,43,66,42,40,13,8,1,0,213
820420413,62,89,77,71,48,20,10,3,380
820420414,49,67,65,42,28,7,3,1,262
820420415,60,75,84,71,29,15,4,3,341
820420416,47,64,34,29,17,6,2,1,200
820420417,82,141,102,110,30,10,0,2,477
820420418,47,86,63,58,26,11,5,2,298
820420419,38,43,63,47,38,19,9,16,273
820420420,6,5,7,11,7,1,0,0,37
820420421,70,115,100,70,34,13,2,1,405
820420501,73,102,100,86,33,14,10,4,422
820420502,75,107,89,74,24,4,2,0,375
820420503,64,104,100,97,50,32,6,6,459
820420504,52,61,35,26,10,2,1,1,188
820420505,95,84,40,43,16,0,0,1,279
820420506,53,107,62,66,33,10,3,5,339
820420507,77,128,55,40,21,9,1,4,335
820420508,95,100,103,79,49,15,5,10,456
820420509,38,59,37,30,16,5,4,4,193
820420601,62,73,58,64,32,15,3,0,307
820420602,46,65,48,42,39,15,8,6,269
820420603,78,107,80,64,25,16,6,8,384
820420604,75,98,77,70,36,17,4,5,382
820420605,69,82,65,66,31,12,1,2,328
820420606,75,107,81,67,49,15,3,3,400
820420607,86,105,51,57,19,7,3,1,329
820420608,112,110,52,37,28,7,0,2,348
820420609,24,47,21,23,6,3,0,0,124
820420610,103,128,79,75,29,11,3,3,431
820420611,104,125,64,36,14,6,0,1,350
820420612,90,101,55,41,18,2,0,0,307
820420613,85,85,62,50,27,7,2,2,320
820420614,67,69,55,48,16,5,1,1,262
820420615,22,36,18,12,5,4,2,0,99
820420616,57,64,52,60,21,5,2,1,262
820420617,40,45,50,50,24,13,5,6,233
820420618,40,58,56,49,37,18,4,3,265
820420619,58,65,50,60,33,32,8,8,314
820420620,71,95,63,67,42,9,3,2,352
820420621,40,70,51,56,25,4,0,0,246
820420622,29,83,52,47,15,2,1,0,229
820420701,41,52,54,62,45,21,4,4,283
820420702,34,59,54,48,44,11,5,7,262
820420703,31,50,48,36,25,17,3,1,211
820420704,66,97,74,80,44,33,8,9,411
820420705,76,97,91,94,52,15,12,3,440
820420706,66,131,87,61,34,7,1,0,387
820420707,105,139,61,50,21,12,1,2,391
820420708,63,97,45,24,12,7,2,1,251
820420709,76,89,42,36,18,5,3,0,269
820420710,79,118,53,51,25,6,2,0,334
820420711,23,69,70,66,48,8,3,7,294
820420712,86,108,63,45,20,9,2,2,335
820420713,65,100,34,29,14,4,0,1,247
820420714,85,124,69,60,31,5,2,0,376
820420715,63,76,78,88,58,47,13,18,441
820420716,62,105,108,91,41,26,2,6,441
820420717,47,99,70,100,43,27,7,15,408
820420718,47,78,63,40,23,6,0,1,258
820420719,38,68,40,45,8,8,1,1,209
820420720,38,51,53,55,23,5,7,3,235
820420721,31,57,64,40,21,14,4,1,232
820420801,68,87,51,52,27,8,2,2,297
820420802,100,123,66,47,24,3,0,1,364
820420803,93,82,29,26,8,2,1,0,241
820420804,94,106,29,28,9,2,1,2,271
820420805,141,110,74,59,19,5,2,0,410
820420806,107,106,71,47,21,8,3,1,364
820420807,89,100,38,29,5,4,0,1,266
820420808,110,95,50,27,16,3,1,0,302
820420809,81,107,68,50,21,3,3,0,333
820420810,88,116,64,48,20,5,1,2,344
820420811,27,62,61,81,47,14,1,3,296
820420901,59,96,102,88,46,29,15,9,444
820420902,34,74,60,57,35,26,2,4,292
820420903,89,133,114,109,47,17,5,6,520
820420904,57,60,33,47,16,7,6,3,229
820420905,54,98,75,67,38,14,2,4,352
820420906,75,88,120,116,65,42,14,25,545
820420907,100,118,80,59,27,10,1,5,400
820420908,66,76,48,45,12,5,0,1,253
820420909,125,146,58,53,15,8,2,1,408
820420910,62,77,27,19,9,0,0,0,194
820420911,51,87,39,48,18,4,3,1,251
820420912,57,95,44,43,14,4,0,0,257
820420913,49,83,50,39,14,5,1,2,243
820420914,55,85,76,37,16,6,3,1,279
820420915,49,86,42,31,13,3,2,0,226
820420916,72,145,126,97,52,22,7,4,525
820420917,40,57,86,83,49,16,11,7,349
820420918,97,103,45,33,17,7,1,1,304
820420919,54,80,68,66,49,27,17,11,372
820420920,42,59,67,75,42,19,8,4,316
820420921,63,119,112,111,44,23,5,4,481
820420922,45,49,85,100,60,43,17,18,417
820420923,74,143,110,96,53,28,9,5,518
820420924,47,81,54,35,9,4,1,1,232
820420925,60,103,63,45,13,7,1,1,293
820420926,57,64,65,42,18,6,3,3,258
820421001,60,74,52,47,20,11,3,2,269
820421002,83,102,109,75,54,22,9,8,462
820421003,80,105,53,51,29,8,3,3,332
820421004,86,88,93,53,22,8,8,5,363
820421005,28,51,50,51,48,18,5,11,262
820421006,46,80,52,36,29,12,1,5,261
820421007,63,92,85,54,25,12,5,3,339
820421008,56,81,81,89,51,29,9,22,418
820421009,35,40,44,46,31,17,8,6,227
820421010,52,68,93,71,58,48,14,18,422
820421011,53,95,148,171,100,62,27,28,684
820421012,42,70,62,82,34,13,8,2,313
820421013,47,69,76,47,33,8,7,3,290
820421014,46,60,54,31,26,5,1,5,228
820421015,46,94,79,65,38,27,5,9,363
820421016,47,53,87,81,85,49,20,21,443
820421102,4,8,2,3,2,1,0,0,20
820421103,13,29,23,31,10,7,0,2,115
820421104,2,6,5,2,3,2,0,0,20
820421105,92,90,65,46,25,9,2,3,332
820421106,76,78,75,74,35,15,1,1,355
820421107,4,15,9,4,1,1,0,0,34
820421108,57,49,41,52,22,10,2,3,236
820421109,77,91,55,61,18,8,1,0,311
820421110,53,52,47,17,15,6,1,3,194
820421111,28,61,46,39,18,11,0,1,204
820421112,46,50,51,36,25,7,1,3,219
820421113,60,86,52,41,18,2,2,4,265
820421114,79,94,48,45,14,3,0,0,283
820421115,73,108,60,54,15,5,1,1,317
820421116,89,94,64,69,22,13,5,7,363
820421117,18,26,13,16,11,4,1,2,91
820421118,68,75,60,61,28,6,6,3,307
820421119,59,63,49,49,19,10,3,1,253
820421120,36,62,68,55,27,11,1,2,262
820421121,38,49,52,45,23,5,3,5,220
820421201,28,24,21,14,12,3,0,0,102
820421202,6,28,20,10,8,2,0,0,74
820421203,82,97,97,74,58,26,10,11,455
820421204,59,81,75,56,25,18,6,5,325
820421205,66,86,54,62,16,11,2,1,298
820421206,68,97,50,36,19,3,3,0,276
820421207,82,87,49,39,19,10,2,0,288
820421208,81,125,82,72,34,12,4,5,415
820421209,27,47,12,19,9,3,1,2,120
820421210,76,119,91,94,49,31,6,11,477
820421211,66,118,72,55,19,8,2,2,342
820421212,65,102,88,80,31,16,4,4,390
820421213,67,79,64,67,27,10,2,0,316
820421214,72,114,94,73,25,11,3,2,394
820421215,7,9,6,6,2,1,0,0,31
820421216,92,91,62,64,22,8,4,2,345
820429101,2,4,5,4,0,0,0,0,15
820490101,53,54,78,67,56,51,26,49,434
820490102,69,132,128,137,81,53,17,45,662
820490103,27,27,21,27,26,14,9,6,157
820490104,8,3,2,0,0,0,0,0,13
820490105,20,18,10,15,11,9,4,7,94
820490106,6,11,2,0,6,1,3,2,31
820490107,21,36,31,48,28,26,12,12,214
820490108,61,102,92,84,44,30,12,13,438
820490109,56,65,76,57,44,22,21,19,360
820490110,21,29,44,32,33,31,8,18,216
820490111,12,13,14,11,10,3,3,2,68
820490112,50,79,82,77,63,31,19,29,430
820490113,6,9,5,2,11,3,1,3,40
820490114,13,13,9,19,14,10,6,9,93
820490115,10,4,7,7,2,5,3,6,44
820490116,66,98,132,154,124,76,34,66,750
820490117,49,91,78,75,46,21,9,9,378
820490118,49,84,97,60,57,29,6,9,391
820490119,43,53,72,60,40,16,8,4,296
820490120,2,4,5,3,2,0,0,0,16
820490121,75,112,137,145,72,65,21,44,671
820490122,9,9,15,12,10,8,0,4,67
820490123,99,90,115,118,71,54,27,57,631
820490124,79,75,105,70,34,20,5,6,394
820490125,47,59,67,62,35,22,12,11,315
820490126,15,16,9,17,7,6,1,0,71
820490127,25,48,45,36,15,11,9,15,204
820490128,44,60,88,85,45,20,13,20,375
820490201,50,50,57,44,29,17,6,8,261
820490202,71,74,71,51,25,10,8,6,316
820490203,13,4,4,3,5,2,1,2,34
820490204,1,0,1,0,0,1,0,1,4
820490205,6,3,4,3,4,5,3,1,29
820490206,2,1,3,3,1,0,0,0,10
820490207,4,3,4,0,0,0,0,0,11
820490208,2,5,2,1,2,0,0,0,12
820490209,4,7,4,4,5,4,0,0,28
820490210,10,15,11,4,10,5,0,2,57
820490211,1,1,2,3,1,0,0,0,8
820490212,11,6,4,4,0,0,0,0,25
820490213,30,45,51,55,28,23,5,10,247
820490301,63,59,67,64,37,30,8,16,344
820490302,43,72,100,61,36,27,10,5,354
820490303,59,80,73,61,27,5,8,3,316
820490304,73,88,60,52,21,13,3,1,311
820490305,68,114,116,78,41,22,12,17,468
820490306,60,71,78,61,36,13,7,8,334
820490307,11,17,22,27,10,4,5,7,103
820490308,90,150,144,135,95,61,29,46,750
820490309,2,3,1,1,2,1,0,0,10
820490310,9,15,12,15,18,7,3,9,88
820490311,33,40,45,30,25,10,7,18,208
820490312,6,6,4,7,4,5,2,2,36
820490313,23,17,27,22,12,9,3,4,117
820490314,4,12,5,3,7,0,0,1,32
820490315,9,21,26,16,16,8,4,7,107
820490316,2,2,3,2,1,1,0,1,12
820490317,4,5,6,2,0,3,0,3,23
820490318,3,6,2,4,4,2,0,1,22
820490319,5,10,10,7,9,6,1,3,51
820490320,8,10,4,1,0,0,0,0,23
820490321,6,10,6,4,1,2,1,1,31
820490322,8,4,3,6,0,1,0,1,23
820490323,17,16,22,12,13,5,2,5,92
820490324,23,23,32,27,12,8,7,13,145
820490325,2,7,9,5,5,2,1,4,35
820490326,65,105,136,147,87,49,21,28,638
820490327,16,20,14,13,13,9,1,1,87
820490328,19,23,27,19,11,11,2,1,113
820490329,54,80,81,70,40,17,4,2,348
820490330,58,96,64,59,28,10,2,2,319
820490331,75,96,72,42,26,13,2,1,327
820490332,68,81,78,57,28,13,2,8,335
820490333,42,62,72,74,36,27,13,12,338
820490334,41,51,73,60,40,23,12,10,310
820490401,8,6,10,2,6,5,3,2,42
820490402,14,24,20,12,11,7,3,6,97
820490403,16,35,36,20,14,9,7,8,145
820490404,14,24,20,27,14,8,1,5,113
820490405,13,10,19,11,1,5,2,2,63
820490406,38,68,42,45,22,11,4,2,232
820490407,2,4,7,7,9,2,1,1,33
820490408,44,55,66,58,41,19,12,15,310
820490409,10,12,14,14,11,10,4,5,80
820490410,26,25,24,19,14,7,1,4,120
820490411,22,22,21,17,18,13,8,11,132
820490412,24,23,22,21,17,10,4,13,134
820490413,5,18,19,10,10,8,6,4,80
820490414,2,3,2,0,0,2,0,1,10
820490415,9,24,12,9,4,3,1,5,67
820490416,14,39,42,36,15,16,9,25,196
820490417,1,2,1,3,1,0,0,0,8
820490418,14,17,28,20,9,10,1,9,108
820490419,0,1,0,0,0,1,1,0,3
820490501,4,5,0,7,2,1,3,1,23
820490502,7,11,12,11,12,9,8,6,76
820490503,3,16,10,9,6,2,0,1,47
820490504,15,29,24,22,18,12,10,5,135
820490505,12,6,19,14,12,6,4,4,77
820490506,9,16,17,12,12,2,1,9,78
820490507,13,21,24,14,13,2,3,3,93
820490508,13,9,11,11,7,6,3,0,60
820490509,36,55,74,73,42,15,6,5,306
820490510,47,100,142,174,129,87,49,76,804
820490511,49,71,84,70,41,16,2,7,340
820490512,28,55,70,64,35,25,18,14,309
820490513,77,117,82,75,28,3,2,0,384
820490514,52,79,136,126,92,57,34,31,607
820490515,33,66,67,68,35,13,5,6,293
820490516,50,107,107,66,45,20,8,16,419
820490517,48,84,59,56,20,8,2,6,283
820490518,46,59,73,61,41,17,8,4,309
820490519,2,1,0,1,0,0,0,0,4
820490520,0,0,0,0,0,1,0,0,1
820490521,32,42,50,51,24,6,4,0,209
820490522,68,82,94,61,45,12,1,5,368
820490523,33,62,92,126,110,83,46,55,607
820490524,50,96,106,84,55,31,11,16,449
820490525,44,77,56,74,41,12,5,2,311
820490526,69,84,72,60,21,17,1,2,326
820490527,59,111,109,99,53,42,14,25,512
820490601,64,60,50,45,21,12,3,1,256
820490602,51,67,68,53,24,13,6,6,288
820490603,87,123,109,85,41,18,7,10,480
820490604,108,125,96,80,45,14,4,4,476
820490605,65,100,75,76,45,16,8,4,389
820490606,75,95,68,44,26,12,3,1,324
820490607,29,40,58,43,49,33,16,23,291
820490608,47,59,105,93,90,78,39,67,578
820490609,24,40,17,26,11,3,6,1,128
820490610,96,107,75,55,28,14,3,3,381
820490611,81,94,46,44,18,6,0,1,290
820490612,71,73,48,25,8,6,0,0,231
820490613,90,84,61,39,24,7,4,0,309
820490614,32,77,40,25,10,6,1,1,192
820490615,54,73,55,39,17,3,2,0,243
820490616,94,119,65,46,20,6,2,1,353
820490701,34,61,66,61,37,26,11,11,307
820490702,69,95,65,56,26,7,3,1,322
820490703,47,56,57,45,11,8,2,0,226
820490704,47,71,55,54,28,10,0,0,265
820490705,19,40,80,56,34,25,7,9,270
820490706,73,107,95,74,50,17,10,4,430
820490707,58,111,126,118,53,23,11,10,510
820490708,73,106,107,83,38,19,2,7,435
820490709,80,128,94,69,33,7,3,5,419
820490710,61,87,57,43,20,10,1,1,280
820490711,53,90,60,35,20,4,1,1,264
820490712,118,153,105,59,23,7,4,2,471
820490713,56,69,37,30,14,3,0,0,209
820490714,40,68,53,51,14,6,0,3,235
820490715,86,101,108,83,59,29,9,11,486
820490716,38,77,88,81,55,30,16,39,424
820490717,40,106,112,113,70,20,9,14,484
820490718,67,107,138,150,141,79,32,33,747
820490719,33,68,85,106,73,85,31,51,532
820490801,15,33,27,23,17,11,6,6,138
820490802,8,10,6,5,7,10,7,11,64
820490803,20,19,19,31,11,15,3,8,126
820490804,0,2,0,0,0,0,0,1,3
820490805,3,3,1,0,1,2,0,0,10
820490806,18,25,17,15,6,2,0,4,87
820490807,12,11,14,18,8,9,2,2,76
820490808,13,20,15,17,6,11,3,3,88
820490809,8,13,13,14,12,8,7,13,88
820490810,26,18,33,44,38,40,13,26,238
820490811,0,0,0,0,0,0,0,0,0
820490812,7,11,5,11,5,7,1,4,51
820490813,2,0,3,3,0,1,0,0,9
820490814,6,11,21,15,15,6,3,2,79
820490815,7,13,6,8,6,3,0,1,44
820490816,2,5,2,4,2,1,2,1,19
820490817,3,9,9,18,4,3,0,2,48
820490818,19,30,24,24,17,10,4,10,138
820490819,10,19,14,9,14,7,5,2,80
820490901,26,24,31,19,7,3,1,1,112
820490902,2,3,6,7,5,3,0,2,28
820490903,22,30,16,17,15,9,4,10,123
820490904,9,25,19,13,14,7,0,6,93
820490905,18,21,21,22,10,5,6,1,104
820490906,78,87,97,99,62,45,17,23,508
820490907,41,66,57,35,24,10,4,2,239
820490908,51,53,53,65,28,17,5,9,281
820490909,11,15,23,9,10,3,4,2,77
820490910,27,29,29,18,9,6,2,3,123
820490911,13,24,17,22,11,9,5,3,104
820490912,18,20,4,11,5,7,4,6,75
820490913,30,36,47,34,27,15,11,22,222
820490914,34,65,70,59,41,21,5,8,303
820490915,51,52,77,66,49,23,9,8,335
820490916,54,74,73,63,19,6,2,4,295
820491001,48,66,67,53,25,11,4,6,280
820491002,32,62,63,48,31,10,10,4,260
820491003,21,57,69,53,53,23,9,8,293
820491004,30,61,84,69,54,27,8,16,349
820491005,61,91,110,96,54,22,6,14,454
820491006,14,37,38,45,55,47,24,44,304
820491007,59,108,166,168,108,92,27,47,775
820491008,42,64,81,95,52,32,14,7,387
820491009,41,77,84,76,55,19,6,3,361
820491010,56,76,87,91,43,15,7,2,377
820491011,28,62,111,94,76,36,13,16,436
820491012,26,44,82,80,48,21,11,13,325
820491013,23,53,58,68,38,17,7,7,271
820491014,67,110,124,131,92,57,20,29,630
820491015,28,67,90,105,79,49,20,11,449
820491016,43,73,86,95,53,45,33,41,469
820491017,56,78,109,109,83,44,22,26,527
820491018,46,80,86,83,54,16,11,13,389
820491019,50,66,109,107,79,80,22,39,552
820560101,64,78,49,52,31,22,9,6,311
820560102,9,16,14,11,4,3,2,2,61
820560103,47,75,83,58,35,17,8,7,330
820560104,41,60,40,35,24,7,3,3,213
820560105,69,83,87,63,35,16,14,6,373
820560106,26,30,24,10,11,7,0,1,109
820560107,2,3,2,2,0,4,0,0,13
820560108,53,53,72,64,29,15,9,4,299
820560109,55,79,67,43,24,9,1,0,278
820560110,13,17,22,25,11,10,4,6,108
820560111,46,62,55,42,29,21,4,3,262
820560112,19,46,27,18,20,4,5,2,141
820560113,16,41,25,31,11,6,1,2,133
820560114,18,25,16,13,5,2,0,1,80
820560115,40,48,58,53,32,12,9,9,261
820560116,53,56,40,33,24,7,0,2,215
820560117,57,76,63,69,28,13,3,5,314
820560118,14,37,26,24,10,14,3,9,137
820560201,22,24,38,49,21,16,5,3,178
820560202,83,65,68,74,29,11,5,4,339
820560203,58,72,39,47,16,4,4,0,240
820560204,84,100,77,68,35,12,4,4,384
820560205,87,110,71,73,27,13,5,3,389
820560206,40,83,71,85,36,14,7,3,339
820560207,24,42,33,38,20,14,3,9,183
820560208,28,46,34,39,26,7,1,4,185
820560209,19,26,14,20,8,14,3,2,106
820560210,63,88,59,64,27,12,4,0,317
820560211,12,23,23,12,7,3,0,1,81
820560212,29,33,21,20,17,6,0,1,127
820560213,15,28,13,18,11,5,4,5,99
820560214,23,28,34,36,16,3,5,2,147
820560215,89,102,89,110,52,20,6,10,478
820560216,46,69,51,42,17,8,2,1,236
820560217,61,73,65,39,19,6,3,1,267
820560218,67,86,64,71,31,14,2,3,338
820560219,68,85,54,64,32,9,2,2,316
820560301,82,94,75,71,29,14,4,7,376
820560302,28,43,30,27,10,7,3,1,149
820560303,74,109,104,116,66,39,12,7,527
820560304,56,53,48,43,15,5,3,1,224
820560305,78,89,91,87,48,12,5,5,415
820560306,41,78,62,44,24,4,4,1,258
820560307,62,70,64,52,27,9,2,1,287
820560308,31,34,44,50,26,15,9,6,215
820560309,61,74,55,42,24,8,2,3,269
820560310,67,66,50,22,15,2,1,0,223
820560311,96,151,142,88,43,11,6,4,541
820560312,15,23,18,19,12,2,2,5,96
820560313,7,34,24,26,5,5,0,1,102
820560314,10,21,19,15,12,9,3,0,89
820560401,80,111,88,80,44,23,7,3,436
820560402,53,82,93,87,36,14,7,6,378
820560403,75,101,61,65,21,2,3,1,329
820560404,60,78,57,45,22,7,2,0,271
820560405,108,128,73,77,18,3,4,1,412
820560406,85,104,48,34,13,6,0,2,292
820560407,69,47,31,21,10,2,0,0,180
820560408,78,81,43,43,17,4,1,1,268
820560409,77,104,59,60,17,9,2,0,328
820560410,63,64,53,43,22,7,2,0,254
820560411,99,95,65,29,19,8,2,0,317
820560412,50,65,59,39,9,4,4,0,230
820560413,50,62,37,21,5,2,0,1,178
820560414,62,109,121,129,50,25,6,4,506
820560415,36,57,48,53,20,14,6,7,241
820560501,24,38,44,38,9,3,1,0,157
820560502,74,132,118,109,57,4,13,3,510
820560503,54,91,82,69,24,9,2,0,331
820560504,58,89,55,45,20,10,0,2,279
820560505,77,108,92,54,34,11,2,4,382
820560506,50,57,62,49,17,5,3,2,245
820560507,64,84,112,100,60,39,16,20,495
820560508,38,53,49,27,12,5,1,2,187
820560509,67,102,79,68,60,29,9,13,427
820560510,30,66,69,56,34,24,11,6,296
820560511,75,85,87,77,49,30,9,18,430
820560512,49,66,58,61,40,16,8,7,305
820560513,41,61,48,74,30,13,1,2,270
820560514,61,79,73,64,25,12,3,3,320
820560515,38,62,47,46,20,5,5,2,225
820560516,36,51,65,49,25,18,7,8,259
820630101,42,56,38,44,18,12,6,5,221
820630102,10,5,3,2,1,2,0,0,23
820630103,57,70,67,63,43,15,9,8,332
820630104,44,69,51,47,33,21,13,8,286
820630105,101,94,79,60,34,8,7,3,386
820630106,14,24,14,17,21,7,4,1,102
820630107,63,67,73,54,19,11,7,5,299
820630108,9,11,15,17,15,7,2,3,79
820630109,36,63,80,44,36,24,7,7,297
820630110,51,56,64,83,41,33,14,27,369
820630111,32,29,29,28,21,15,3,7,164
820630112,13,28,21,15,7,3,1,1,89
820630113,4,11,7,6,3,4,2,4,41
820630114,14,28,19,12,18,6,2,1,100
820630115,8,15,14,6,4,2,1,1,51
820630116,9,7,6,3,3,2,0,0,30
820630117,6,6,6,6,7,1,0,1,33
820630118,25,64,53,48,40,24,10,6,270
820630119,78,99,87,72,38,15,9,9,407
820630120,36,52,78,49,35,22,3,10,285
820630121,36,57,45,40,27,6,5,4,220
820630122,47,83,64,62,61,20,7,5,349
820630123,38,61,64,44,31,11,3,3,255
820630124,45,61,51,51,34,17,8,4,271
820630125,40,63,65,57,47,28,11,6,317
820630126,86,108,130,86,57,30,5,13,515
820630127,58,84,55,62,22,18,5,1,305
820630128,28,53,81,47,55,51,21,42,378
820630129,72,106,103,116,79,40,20,26,562
820630201,18,16,21,19,11,6,1,3,95
820630202,5,12,7,5,5,3,0,0,37
820630203,7,5,2,1,4,2,0,1,22
820630204,53,69,58,78,31,23,13,8,333
820630205,65,83,64,48,24,12,7,5,308
820630206,63,102,63,56,37,7,2,2,332
820630207,94,85,88,60,41,9,5,8,390
820630208,69,99,81,84,66,48,19,27,493
820630209,56,77,62,42,23,9,5,1,275
820630210,59,88,53,42,13,12,1,4,272
820630211,54,64,52,46,25,9,9,4,263
820630212,72,97,83,73,38,15,12,4,394
820630213,79,96,81,95,41,41,11,15,459
820630214,12,16,17,14,8,6,1,2,76
820630215,8,21,15,15,6,10,1,2,78
820630216,34,55,51,38,21,14,4,10,227
820630217,13,1,6,3,1,2,0,2,28
820630218,16,7,7,11,5,4,2,1,53
820630219,21,9,13,8,0,2,0,0,53
820630220,35,45,53,60,45,43,19,7,307
820630221,86,103,110,95,53,24,12,8,491
820630222,56,67,90,92,62,25,13,15,420
820630223,14,27,24,28,22,8,9,8,140
820630224,13,20,14,20,12,8,4,7,98
820630225,16,28,41,55,23,23,4,5,195
820630226,13,12,11,14,12,8,0,4,74
820630227,10,19,19,11,10,10,3,2,84
820630228,22,17,22,15,6,4,2,5,93
820630229,3,7,7,4,1,3,0,0,25
820630230,8,7,4,5,3,0,1,0,28
820630231,49,73,44,54,40,26,15,5,306
820630232,56,84,80,82,54,29,1,6,392
820630301,32,39,34,29,19,14,4,6,177
820630302,40,33,57,44,23,14,5,6,222
820630303,32,47,31,24,14,10,7,2,167
820630304,0,1,0,0,0,0,0,0,1
820630305,42,60,36,34,19,7,7,3,208
820630306,37,54,43,29,21,4,4,2,194
820630307,65,68,65,77,45,28,8,9,365
820630308,33,64,58,51,37,19,7,6,275
820630309,61,77,64,68,28,18,5,4,325
820630310,49,95,88,82,45,35,11,12,417
820630311,56,69,91,72,47,37,20,25,417
820630312,71,95,96,100,51,26,11,20,470
820630313,38,49,46,46,23,12,5,8,227
820630314,39,81,76,98,59,13,8,6,380
820630315,43,30,48,47,40,21,14,11,254
820630316,69,64,68,77,41,36,15,14,384
820630317,59,68,75,37,30,22,18,5,314
820630318,4,1,1,1,1,1,0,1,10
820630319,76,97,97,97,47,27,14,19,474
820630320,2,0,0,0,0,0,0,0,2
820630321,0,0,0,0,0,0,0,0,0
820630322,58,58,79,52,34,17,19,16,333
820630323,45,51,51,44,24,21,3,7,246
820630324,46,114,109,93,33,16,6,5,422
820630325,62,83,88,66,34,23,9,3,368
820630326,39,76,66,67,39,16,8,0,311
820630327,40,65,45,39,17,7,2,2,217
820630401,6,0,4,2,3,1,2,1,19
820630402,51,82,83,66,43,36,9,8,378
820630403,23,31,26,28,16,5,4,2,135
820630404,61,72,79,68,52,31,4,5,372
820630405,15,10,18,19,17,8,4,8,99
820630406,2,1,2,0,0,0,0,0,5
820630407,33,51,52,85,42,34,16,18,331
820630408,36,52,58,66,43,29,6,7,297
820630409,82,136,154,227,110,66,63,36,874
820630410,414,180,151,160,111,112,43,50,1221
820630411,37,58,52,59,38,25,12,20,301
820630412,60,125,136,114,69,33,11,12,560
820630501,55,79,89,98,71,61,31,51,535
820630502,30,70,97,100,56,40,28,21,442
820630503,45,74,77,67,51,43,21,22,400
820630504,35,71,64,68,36,16,13,18,321
820630505,38,41,62,49,46,29,12,13,290
820630506,48,73,108,114,78,61,37,53,572
820630507,40,68,63,66,36,37,24,26,360
820630508,51,64,67,66,51,44,21,36,400
820630509,87,79,114,107,83,52,16,43,581
820630510,82,85,87,75,52,44,17,19,461
820630511,40,41,57,55,76,45,12,21,347
820630512,27,47,69,35,30,18,2,5,233
820630513,66,59,79,64,46,25,16,11,366
820630601,46,65,71,92,58,37,16,20,405
820630602,33,65,68,59,57,30,0,7,319
820630603,71,116,86,74,50,17,3,2,419
820630604,50,77,96,69,55,20,6,9,382
820630605,23,39,49,45,23,24,10,13,226
820630606,39,61,62,46,25,16,3,5,257
820630607,37,65,49,40,21,8,4,1,225
820630608,38,51,54,34,26,5,2,2,212
820630609,62,108,95,86,57,19,9,6,442
820630610,29,59,54,40,17,10,4,5,218
820630611,31,59,63,49,32,14,6,9,263
820630612,27,44,66,52,36,19,1,5,250
820630613,47,66,49,55,32,14,1,2,266
820630614,52,81,78,63,41,10,5,1,331
820630615,40,91,54,49,25,13,5,5,282
820630616,46,75,63,59,30,13,2,3,291
820630617,54,84,73,59,25,7,0,2,304
820630618,46,61,53,29,29,12,2,2,234
820630701,41,61,61,59,23,17,20,20,302
820630702,52,54,53,58,18,9,2,2,248
820630703,43,43,48,35,22,6,2,1,200
820630704,102,126,71,70,36,19,1,2,427
820630705,96,126,88,57,40,10,4,2,423
820630706,103,133,98,73,43,15,3,2,470
820630707,60,100,54,51,27,6,1,0,299
820630708,56,60,48,50,28,5,1,0,248
820630709,59,65,54,45,17,6,2,1,249
820630710,73,71,48,43,23,12,1,4,275
820630711,74,76,59,48,20,7,1,0,285
820630712,84,90,59,33,16,7,3,0,292
820630713,42,64,67,88,41,20,1,1,324
820630714,37,72,40,41,16,7,3,0,216
820630801,55,65,58,39,16,6,0,2,241
820630802,77,101,54,52,27,9,3,2,325
820630803,54,78,47,51,17,7,3,0,257
820630804,49,70,60,52,19,8,9,1,268
820630805,48,84,40,39,21,6,1,2,241
820630806,49,57,56,51,30,10,3,2,258
820630807,50,62,57,30,19,5,4,2,229
820630808,55,83,75,48,24,6,1,0,292
820630809,52,92,50,46,18,4,1,3,266
820630810,75,82,58,45,31,9,2,1,303
820630811,49,63,60,59,30,12,0,0,273
820630812,79,93,44,70,29,8,2,3,328
820630813,59,75,35,30,13,6,0,1,219
820630814,37,54,54,44,20,11,3,2,225
820630901,66,115,76,95,42,16,4,2,416
820630902,47,63,55,54,19,7,4,2,251
820630903,72,100,79,79,34,16,4,1,385
820630904,47,65,49,45,11,9,0,1,227
820630905,47,57,56,44,17,12,4,0,237
820630906,66,75,83,67,32,9,4,4,340
820630907,52,61,41,49,28,6,5,1,243
820630908,87,90,75,65,41,7,0,1,366
820630909,58,86,66,43,18,13,1,0,285
820630910,72,93,78,63,27,11,4,0,348
820631001,35,57,74,56,42,15,4,5,288
820631002,65,120,84,66,37,12,5,1,390
820631003,53,59,59,40,27,12,5,3,258
820631004,38,49,46,41,21,16,3,8,222
820631005,36,52,58,48,20,10,3,7,234
820631006,45,70,52,45,29,5,8,3,257
820631007,55,80,99,77,65,31,10,16,433
820631008,95,87,120,116,68,30,5,8,529
820631009,54,61,76,47,50,30,18,11,347
820631010,54,88,52,87,28,27,12,10,358
820631011,59,82,82,72,49,23,9,5,381
820631012,43,44,36,40,21,20,6,0,210
820631013,65,88,92,82,53,30,10,13,433
820631101,47,64,68,81,54,37,20,26,397
820631102,38,55,61,54,43,37,8,8,304
820631103,50,71,63,74,50,46,16,21,391
820631104,28,61,53,51,34,21,1,2,251
820631105,46,65,82,54,50,43,5,14,359
820631106,135,118,127,94,80,54,14,12,634
820631107,82,112,132,150,75,87,28,42,708
820631108,15,26,37,60,20,23,10,12,203
820631109,28,53,57,61,29,12,5,10,255
820631110,75,101,117,118,69,49,14,11,554
820631111,54,80,85,94,55,32,13,13,426
820631112,20,36,59,51,29,20,9,10,234
820631113,52,60,77,78,55,59,5,11,397
820631114,48,41,35,54,29,33,13,23,276
820631115,24,43,68,73,61,53,19,30,371
820631116,46,56,62,50,39,30,3,8,294
820631117,36,46,53,48,35,32,6,4,260
820631118,49,41,41,40,51,45,18,16,301
820631119,56,50,44,34,24,25,3,6,242
820631201,59,86,91,57,35,14,9,5,356
820631202,42,69,46,33,19,14,4,2,229
820631203,18,47,35,31,20,15,3,1,170
820631204,53,80,77,75,46,44,7,16,398
820631205,34,40,43,51,28,17,8,8,229
820631206,29,29,29,33,16,12,8,5,161
820631207,55,80,86,67,43,20,4,10,365
820631208,37,75,83,83,57,25,10,7,377
820631209,65,93,105,67,44,14,6,2,396
820631210,25,43,63,55,33,42,5,16,282
820631211,76,66,71,55,31,13,3,1,316
820631212,70,83,58,51,27,12,0,1,302
820631213,69,78,86,60,40,25,7,8,373
820631214,30,54,54,48,31,33,4,15,269
820631215,29,42,34,55,30,40,8,13,251
820631301,40,72,64,53,29,9,3,2,272
820631302,70,100,77,67,24,13,2,3,356
820631303,32,53,34,42,14,2,0,0,177
820631304,75,74,56,55,27,7,1,1,296
820631305,51,58,61,50,26,10,3,0,259
820631306,43,70,43,37,21,9,7,4,234
820631307,27,74,61,49,30,18,1,1,261
820631308,38,43,55,43,33,22,8,3,245
820631309,65,93,85,95,55,54,15,22,484
820631310,42,51,47,51,20,8,6,8,233
820631311,62,83,60,40,17,2,1,1,266
820631312,54,84,64,57,25,11,4,1,300
820631313,81,104,79,61,24,11,3,2,365
820631314,69,69,63,44,22,11,3,1,282
820631315,71,114,75,56,29,14,1,2,362
820631316,94,105,79,68,34,14,1,3,398
820631317,83,91,83,57,43,9,2,3,371
820631318,61,58,68,46,24,7,3,0,267
820631319,47,58,45,40,20,6,3,3,222
820631320,41,45,51,48,13,10,6,3,217
820631401,84,82,60,44,22,6,2,1,301
820631402,84,96,73,76,30,21,2,0,382
820631403,81,117,78,54,34,4,3,3,374
820631404,72,116,71,69,22,5,1,2,358
820631405,53,101,47,51,21,11,2,0,286
820631406,81,67,52,38,23,12,3,1,277
820631407,79,105,47,27,13,6,3,0,280
820631408,78,94,57,51,21,10,1,0,312
820631409,114,104,67,45,20,5,3,1,359
820631410,104,96,53,66,24,12,2,3,360
820631411,100,106,43,49,20,4,1,3,326
820631501,61,107,71,68,34,9,5,2,357
820631502,48,87,63,49,24,9,3,2,285
820631503,55,87,62,52,28,9,4,0,297
820631504,70,59,49,32,19,7,3,0,239
820631505,74,84,69,45,29,7,2,0,310
820631506,40,60,39,30,13,4,2,1,189
820631507,52,81,61,58,18,12,2,1,285
820631508,60,77,57,41,14,6,0,2,257
820631509,61,76,48,50,18,9,4,0,266
820631510,82,100,66,58,29,8,2,3,348
820631511,78,86,70,64,30,22,2,5,357
820631512,63,87,72,47,29,12,2,5,317
820631513,60,76,55,36,20,2,3,0,252
820631601,69,87,55,66,13,12,1,1,304
820631602,73,90,69,55,30,11,1,1,330
820631603,84,108,89,69,28,13,4,0,395
820631604,62,70,61,38,14,5,1,0,251
820631605,60,50,46,37,24,10,2,0,229
820631606,62,65,52,38,17,5,0,2,241
820631607,27,54,31,29,25,4,3,4,177
820631608,53,100,86,62,38,18,8,8,373
820631609,53,61,52,32,15,12,1,5,231
820631610,85,98,80,59,33,16,3,4,378
820631611,49,77,40,43,22,5,6,1,243
820631612,44,67,65,50,17,7,4,2,256
820631701,91,100,75,56,20,9,0,4,355
820631702,89,118,92,90,43,18,3,4,457
820631703,21,41,49,49,28,21,8,7,224
820631704,42,52,30,31,9,5,3,1,173
820631705,82,119,63,51,26,5,2,3,351
820631706,54,99,74,46,31,6,0,1,311
820631707,73,73,48,29,10,7,2,0,242
820631708,63,73,54,58,30,10,3,0,291
820631709,65,96,52,43,19,3,3,0,281
820631710,66,93,54,45,23,10,0,0,291
820631711,74,86,68,47,22,9,2,3,311
820631712,101,86,41,36,17,3,1,0,285
820631713,100,98,57,45,16,7,2,1,326
820631714,123,91,67,37,16,5,1,0,340
820631801,110,118,47,36,17,4,0,0,332
820631802,138,122,74,35,15,6,2,0,392
820631803,126,102,44,30,15,7,0,0,324
820631804,115,80,44,30,10,3,1,0,283
820631805,38,39,13,3,3,1,0,0,97
820631806,90,93,41,22,13,1,0,1,261
820631807,177,150,84,38,15,9,1,0,474
820631808,127,96,65,33,21,4,1,0,347
820631809,118,61,25,13,9,1,0,0,227
820631810,118,88,36,14,7,2,0,0,265
820631811,168,121,50,21,7,2,0,0,369
820631812,80,59,28,17,10,2,0,1,197
820631813,65,66,22,21,2,1,1,0,178
820631901,58,74,56,55,46,26,8,7,330
820631902,63,67,43,35,32,8,2,3,253
820631903,59,103,74,72,35,19,7,5,374
820631904,49,47,36,35,14,5,1,1,188
820631905,52,72,42,42,22,6,0,2,238
820631906,48,49,33,23,11,2,0,1,167
820631907,68,109,74,76,23,17,0,1,368
820631908,38,18,42,27,28,17,5,12,187
820631909,86,82,73,74,34,24,9,14,396
820631910,69,65,85,80,49,38,18,16,420
820631911,41,44,51,42,26,19,13,11,247
820631912,75,90,46,47,17,5,2,0,282
820631913,87,93,104,119,86,81,20,46,636
820632001,82,102,48,50,18,7,1,2,310
820632002,17,37,32,25,7,2,1,0,121
820632003,47,59,46,32,10,10,2,0,206
820632004,0,0,0,0,0,0,0,0,0
820632005,36,58,22,24,14,3,2,0,159
820632006,60,80,43,38,11,4,0,0,236
820632007,32,53,34,31,12,5,1,0,168
820632008,72,83,56,53,33,8,4,3,312
820632009,42,53,48,43,18,15,8,10,237
820632010,45,89,62,57,41,14,1,4,313
820632011,60,75,60,46,22,4,5,2,274
820632012,59,85,59,62,27,10,1,3,306
820632101,131,95,54,30,13,4,1,0,328
820632102,103,116,53,50,15,9,1,0,347
820632103,86,95,60,33,8,5,2,0,289
820632104,152,143,78,67,13,8,1,0,462
820632105,101,122,46,50,15,8,1,0,343
820632106,62,88,44,37,13,8,2,0,254
820632107,89,85,58,56,19,8,4,0,319
820632108,72,67,55,39,14,9,2,0,258
820632109,106,117,63,43,21,3,1,0,354
820632110,26,38,17,8,9,3,0,0,101
820632111,72,86,66,61,24,3,0,0,312
820632112,134,102,55,36,14,4,1,0,346
820632113,74,59,34,27,8,5,1,1,209
820632114,133,109,48,30,14,5,1,0,340
820632115,65,54,23,16,7,1,1,0,167
820632201,89,68,29,27,7,0,1,0,221
820632202,101,86,26,17,8,2,0,1,241
820632203,79,54,36,15,7,1,2,0,194
820632204,58,41,19,11,3,1,1,0,134
820632205,75,47,16,10,4,0,0,0,152
820632206,42,33,13,14,7,1,0,0,110
820632207,136,95,52,32,7,4,0,1,327
820632208,110,116,45,32,16,6,1,0,326
820632209,128,80,40,16,4,3,2,0,273
820632210,80,66,33,18,8,3,0,0,208
820632211,66,53,30,10,8,1,0,0,168
820632212,110,76,34,15,11,3,0,0,249
820632213,100,77,38,15,6,0,1,3,240
820632214,116,76,31,19,8,1,0,1,252
820632301,70,94,53,41,17,7,1,0,283
820632302,100,85,51,49,23,5,0,1,314
820632303,76,79,38,41,18,9,0,1,262
820632304,94,103,56,50,17,8,1,0,329
820632305,93,60,37,35,19,6,0,1,251
820632306,133,133,65,72,20,16,1,0,440
820632307,40,55,30,22,6,3,0,0,156
820632308,116,118,64,52,17,2,3,0,372
820632309,116,102,37,21,16,6,0,0,298
820632310,95,97,62,64,28,3,2,2,353
820632311,30,47,26,27,20,7,0,0,157
820632312,74,89,43,44,21,9,2,1,283
820632313,53,53,14,17,6,4,0,0,147
820632314,104,71,54,45,24,4,3,0,305
820632401,116,101,46,29,7,1,1,0,301
820632402,109,79,47,16,8,1,1,0,261
820632403,112,116,41,16,12,1,1,0,299
820632404,85,87,35,21,4,2,2,0,236
820632405,80,62,23,10,6,3,2,0,186
820632406,79,53,20,14,6,3,0,0,175
820632407,51,42,23,8,10,1,1,0,136
820632408,83,79,36,22,7,2,0,1,230
820632409,83,77,40,30,14,2,3,0,249
820632410,67,69,49,33,10,3,0,1,232
820632411,69,79,40,36,12,7,1,0,244
820632412,67,85,45,36,19,5,1,1,259
820632413,54,63,27,26,5,3,1,0,179
820632414,82,71,38,26,10,2,1,1,231
820632415,74,70,38,24,12,1,2,1,222
820632416,61,74,44,27,15,9,1,0,231
820632417,94,70,33,15,9,0,0,0,221
820632418,39,26,23,20,10,2,0,0,120
820632501,25,40,38,46,30,13,7,7,206
820632502,74,84,79,69,38,16,3,7,370
820632503,104,118,77,70,23,10,0,1,403
820632504,60,62,30,23,19,3,0,0,197
820632505,46,44,37,34,9,2,3,2,177
820632506,55,55,52,49,38,21,5,3,278
820632507,37,62,35,20,20,6,0,3,183
820632508,53,55,42,31,10,5,3,0,199
820632509,87,95,71,53,23,9,1,0,339
820632510,59,103,53,55,19,2,2,2,295
820632511,51,68,59,39,18,10,2,5,252
820632512,21,41,22,22,6,9,1,1,123
820632513,51,61,44,36,26,8,1,1,228
820632601,79,93,98,93,79,66,25,39,572
820632602,52,68,63,48,54,31,9,15,340
820632603,40,45,75,51,38,39,6,9,303
820632604,53,50,60,55,41,23,11,14,307
820632605,46,61,63,69,58,39,12,24,372
820632606,46,47,50,52,44,23,6,9,277
820632607,68,111,91,71,35,24,10,6,416
820632608,70,80,78,48,33,9,8,6,332
820632609,69,101,85,64,34,25,7,7,392
820632610,36,44,44,58,31,22,7,2,244
820632611,41,63,64,44,20,11,6,3,252
820632612,58,85,82,64,34,20,7,6,356
820632613,71,97,123,107,79,86,16,38,617
820632614,42,68,65,55,43,23,8,5,309
820632615,33,61,53,59,36,18,6,6,272
820632616,33,37,47,50,39,38,21,27,292
820632617,61,92,75,92,56,41,11,18,446
820632701,19,44,56,47,35,19,5,7,232
820632702,34,61,72,48,32,14,5,6,272
820632703,51,75,44,55,29,13,1,3,271
820632704,95,88,72,47,27,13,2,0,344
820632705,64,94,56,42,18,6,2,1,283
820632706,94,130,99,51,26,8,0,3,411
820632707,72,101,54,51,19,10,1,2,310
820632708,45,78,54,53,18,6,3,1,258
820632709,59,106,93,125,73,28,9,15,508
820632710,68,119,96,99,48,29,7,3,469
820632711,37,77,79,98,42,27,11,5,376
820632712,31,61,83,102,53,43,17,11,401
820632713,38,76,93,83,78,50,23,37,478
820632714,60,84,109,107,61,31,14,10,476
820632715,55,58,62,93,58,28,8,11,373
820632716,22,31,20,26,17,7,5,4,132
820632801,54,66,72,75,34,9,1,3,314
820632802,36,82,113,71,38,24,7,3,374
820632803,38,77,86,100,69,35,10,3,418
820632804,0,2,7,4,3,0,0,0,16
820632805,47,87,117,167,63,36,5,4,526
820632806,49,98,120,142,77,35,21,25,567
820632807,36,80,106,103,64,29,2,5,425
820632808,33,68,60,68,45,23,5,11,313
820632809,39,93,73,90,61,39,10,13,418
820632810,60,82,111,105,57,28,9,15,467
820632811,43,101,144,174,73,73,27,36,671
820632812,0,0,2,1,0,1,0,0,4
820632813,1,0,1,4,1,0,0,0,7
820632814,54,70,103,110,63,40,15,13,468
820632815,25,27,27,36,25,14,4,6,164
820632816,38,37,33,27,15,6,4,2,162
820632817,43,77,53,32,18,10,1,6,240
820632818,38,40,45,42,45,33,6,14,263
820632819,57,85,77,70,39,22,4,5,359
820632820,1,2,0,1,1,0,0,0,5
820632821,11,9,11,8,4,8,1,4,56
820632822,7,18,12,4,9,2,2,2,56
820632823,28,34,44,40,29,16,8,12,211
820632824,2,0,0,0,0,0,0,0,2
820632825,22,50,37,31,12,4,2,5,163
820632826,37,61,38,34,12,11,2,3,198
820632827,21,26,13,15,4,0,0,0,79
820632828,60,85,44,42,15,6,2,5,259
820632829,40,60,53,76,29,16,9,9,292
820632901,42,94,105,159,65,39,7,8,519
820632902,32,32,39,49,38,19,15,12,236
820632903,47,57,54,53,31,13,2,1,258
820632904,81,104,98,72,52,14,4,6,431
820632905,51,67,82,86,64,46,20,20,436
820632906,35,51,67,64,60,37,17,22,353
820632907,16,58,57,47,36,18,13,10,255
820632908,34,53,58,72,34,29,4,11,295
820632909,39,64,72,80,44,27,7,15,348
820632910,45,65,55,69,28,21,3,5,291
820632911,40,53,54,45,26,8,6,3,235
820632912,45,80,36,47,23,4,3,0,238
820632913,67,113,72,54,17,8,0,1,332
820632914,34,61,57,38,19,3,2,1,215
820632915,60,88,83,63,33,13,3,3,346
820633001,89,110,47,45,26,6,3,4,330
820633002,79,128,65,60,34,11,2,2,381
820633003,45,67,45,38,16,6,1,1,219
820633004,39,57,47,30,13,7,4,1,198
820633005,48,67,54,48,21,6,1,1,246
820633006,57,95,57,41,27,6,3,4,290
820633007,91,144,90,73,36,11,2,1,448
820633008,64,111,101,118,47,19,5,3,468
820633009,64,98,107,107,52,21,5,3,457
820633010,53,106,89,81,55,19,1,9,413
820633011,64,96,80,67,31,13,2,4,357
820633012,42,59,59,68,23,9,1,2,263
820633013,55,72,85,88,46,27,10,11,394
820633101,49,97,148,153,75,32,9,11,574
820633102,30,32,30,53,23,6,4,10,188
820633103,50,64,72,80,42,24,9,4,345
820633104,67,109,145,173,98,48,26,11,677
820633105,4,6,6,2,7,3,1,1,30
820633106,29,57,76,84,46,26,9,2,329
820633107,51,87,76,87,55,28,8,10,402
820633108,28,46,52,56,27,21,5,6,241
820633109,60,115,170,168,81,47,13,13,667
820633110,31,51,72,100,51,26,27,18,376
820633111,30,39,61,73,43,34,13,18,311
820633112,27,47,81,78,49,43,15,18,358
820633113,52,85,87,78,26,27,7,11,373
820633114,43,72,82,69,59,20,13,13,371
820633115,53,52,76,95,70,52,21,23,442
820633201,62,68,73,72,55,22,11,7,370
820633202,49,52,73,68,32,23,4,14,315
820633203,27,77,109,89,55,45,17,16,435
820633204,37,53,52,49,32,19,2,9,253
820633205,36,43,66,65,54,33,12,26,335
820633206,21,39,63,63,36,22,5,4,253
820633207,35,60,113,118,81,42,16,11,476
820633208,54,83,98,74,39,18,8,5,379
820633209,89,126,112,80,53,19,9,2,490
820633210,44,89,58,37,36,23,6,8,301
820633211,45,68,88,82,50,42,14,7,396
820633212,75,94,132,132,74,64,12,14,597
820633213,99,137,117,78,49,33,9,8,530
820633214,51,69,51,58,27,16,6,9,287
820633215,57,46,63,31,21,5,1,1,225
820633216,44,69,58,60,33,20,8,6,298
820633301,43,51,70,65,58,45,14,23,369
820633302,38,42,52,46,37,39,9,13,276
820633303,60,43,63,49,41,31,19,18,324
820633304,44,43,57,64,33,28,14,12,295
820633305,65,54,31,42,32,19,8,9,260
820633306,68,101,62,59,33,17,3,3,346
820633307,51,73,64,66,39,12,0,3,308
820633308,36,63,58,78,34,24,4,3,300
820633309,33,29,48,43,35,20,7,11,226
820633310,46,47,49,51,38,19,14,12,276
820633401,50,103,161,151,128,66,31,35,725
820633402,29,63,72,92,57,46,14,10,383
820633403,49,84,95,112,62,30,11,16,459
820633404,24,35,49,56,44,29,7,11,255
820633405,129,216,335,378,246,127,44,42,1517
820633406,28,79,122,139,90,54,21,12,545
820633407,33,63,54,62,26,17,4,5,264
820633408,26,44,46,44,30,21,4,3,218
820633409,38,44,39,55,42,30,8,7,263
820633410,31,55,58,54,32,12,3,5,250
820633411,36,65,62,61,36,17,5,7,289
820633412,52,74,99,106,61,31,9,13,445
820633413,73,155,194,220,119,61,31,28,881
820633501,30,45,44,32,39,22,11,14,237
820633502,63,50,56,41,23,19,8,8,268
820633503,39,38,47,41,36,16,8,11,236
820633504,43,64,50,37,27,5,1,3,230
820633505,48,68,42,39,16,7,3,0,223
820633506,72,100,54,58,25,9,3,3,324
820633507,111,88,56,48,12,3,0,0,318
820633508,93,111,57,39,14,4,0,0,318
820633509,89,95,77,30,12,4,0,0,307
820700101,65,63,58,49,34,11,4,4,288
820700102,15,18,20,16,15,4,3,1,92
820700103,5,4,9,11,2,2,0,0,33
820700104,70,69,70,51,31,22,7,9,329
820700105,21,23,22,15,8,7,3,5,104
820700106,7,7,4,5,2,3,0,0,28
820700107,5,16,5,12,9,0,1,5,53
820700108,66,52,40,36,26,6,2,6,234
820700109,7,8,14,9,12,4,5,2,61
820700110,32,43,42,42,14,5,5,3,186
820700111,84,120,100,78,57,30,6,3,478
820700112,11,15,20,8,15,8,0,2,79
820700113,11,8,8,6,3,0,1,0,37
820700114,7,8,10,7,1,1,2,0,36
820700115,12,16,22,18,10,4,1,1,84
820700116,4,9,12,11,6,1,3,1,47
820700117,47,61,43,33,19,3,1,0,207
820700201,72,120,64,66,34,17,2,4,379
820700202,28,31,37,32,19,9,3,5,164
820700203,15,20,15,16,10,6,4,3,89
820700204,80,85,67,60,38,9,3,3,345
820700205,22,18,24,19,20,11,4,6,124
820700206,5,11,13,17,8,11,2,2,69
820700207,49,46,33,34,15,12,2,1,192
820700208,18,21,21,19,10,12,6,3,110
820700209,69,78,46,41,18,10,7,7,276
820700210,17,22,42,33,14,10,4,3,145
820700211,31,40,32,32,13,3,1,0,152
820700212,9,13,19,26,12,10,4,5,98
820700213,88,117,83,60,30,8,6,1,393
820700214,24,35,23,46,22,11,4,2,167
820700215,7,12,1,10,6,2,3,0,41
820700216,5,20,13,11,5,4,1,1,60
820700217,8,7,15,12,7,6,4,3,62
820700218,65,78,71,69,42,20,2,6,353
820700219,81,134,101,93,47,18,7,4,485
820700220,11,41,33,39,20,10,6,2,162
820700221,62,80,72,74,44,15,4,2,353
820700222,73,102,68,55,35,7,3,3,346
820700301,44,46,34,43,18,15,7,3,210
820700302,22,25,24,18,13,4,3,4,113
820700303,52,87,98,91,46,23,12,8,417
820700304,34,41,29,35,20,12,3,5,179
820700305,100,112,75,53,24,13,0,0,377
820700306,53,72,47,37,19,12,4,1,245
820700307,25,65,53,71,28,9,1,0,252
820700308,76,105,58,57,22,7,2,1,328
820700309,110,101,54,37,21,4,2,1,330
820700310,96,105,83,96,58,19,5,5,467
820700311,45,79,92,87,57,30,11,17,418
820700312,64,80,41,45,17,6,0,2,255
820700313,44,54,55,67,28,15,5,3,271
820700314,77,96,62,51,34,15,3,4,342
820700315,58,98,99,94,63,32,16,21,481
820700316,36,66,60,75,40,10,3,0,290
820700317,57,83,59,59,20,11,1,3,293
820700318,57,81,108,114,63,39,17,22,501
820700319,56,67,88,81,45,19,5,7,368
820700320,51,85,74,50,37,19,6,3,325
820700401,52,97,146,126,88,58,32,40,639
820700402,116,135,113,123,59,15,2,4,567
820700403,87,110,71,55,39,20,8,3,393
820700404,74,99,72,53,33,13,5,5,354
820700405,95,82,48,40,17,10,2,1,295
820700406,46,63,74,62,44,9,6,8,312
820700407,68,65,44,30,17,6,2,1,233
820700408,75,80,31,15,12,2,0,0,215
820700409,76,89,43,28,15,2,0,2,255
820700410,185,136,103,84,31,9,0,2,550
820700411,128,98,47,40,13,6,2,1,335
820700412,88,102,40,45,20,3,1,0,299
820700413,82,111,76,55,19,7,3,4,357
820700414,60,77,73,53,33,12,6,4,318
820700415,54,90,104,100,62,30,11,6,457
820700416,71,119,109,81,44,8,3,5,440
820700417,66,111,137,166,94,34,16,9,633
820700418,85,74,32,31,12,1,1,1,237
820700419,105,105,64,31,24,8,0,1,338
820700420,37,52,44,35,19,5,1,2,195
820700501,55,101,58,83,46,25,16,13,397
820700502,41,57,32,34,15,11,3,5,198
820700503,84,110,72,78,43,16,1,4,408
820700504,40,56,48,29,14,9,3,1,200
820700505,30,42,35,44,18,13,7,4,193
820700506,2,7,11,14,7,5,0,2,48
820700507,3,12,14,13,12,7,0,1,62
820700508,58,112,95,85,68,19,2,1,440
820700509,61,88,59,47,21,5,1,0,282
820700510,93,100,62,50,37,11,1,0,354
820700511,114,172,103,130,59,14,3,6,601
820700512,26,52,48,63,45,15,6,1,256
820700513,8,11,2,12,4,4,3,0,44
820700514,6,7,5,7,5,2,1,2,35
820700515,12,29,20,13,14,10,3,3,104
820700516,1,12,8,14,8,5,2,1,51
820700517,55,93,78,54,13,4,3,2,302
820700518,16,23,28,30,13,6,3,1,120
820700519,19,16,22,20,16,8,2,4,107
820700520,6,22,13,7,6,9,2,2,67
820700521,46,50,36,32,16,1,2,1,184
820700522,48,78,55,42,20,8,3,1,255
820700523,74,132,89,105,48,19,4,3,474
820700524,52,96,71,106,52,32,3,7,419
820700525,63,78,85,117,58,15,7,4,427
820700601,96,138,103,92,59,14,6,7,515
820700602,11,22,24,22,7,8,1,3,98
820700603,47,57,45,41,23,15,5,5,238
820700604,7,10,9,8,10,3,5,2,54
820700605,33,50,48,61,34,14,3,2,245
820700606,11,14,15,16,10,5,3,0,74
820700607,41,68,47,36,16,5,2,5,220
820700608,12,27,25,22,13,11,0,3,113
820700609,15,17,14,11,8,6,1,0,72
820700610,4,8,4,13,5,9,2,1,46
820700611,95,84,60,59,24,11,3,2,338
820700612,89,118,83,82,54,25,14,10,475
820700613,37,41,38,26,27,18,4,5,196
820700701,57,80,44,49,18,7,2,0,257
820700702,64,84,47,53,28,6,1,5,288
820700703,65,98,57,40,17,4,0,0,281
820700704,54,73,49,30,19,11,2,1,239
820700705,63,72,63,57,37,9,5,2,308
820700706,70,76,38,28,24,2,1,1,240
820700707,65,67,62,67,26,12,3,6,308
820700708,61,127,102,114,53,27,7,8,499
820700709,21,16,22,18,14,8,6,1,106
820700710,37,58,42,48,23,14,7,4,233
820700711,11,15,12,6,6,4,2,3,59
820700712,61,95,67,69,26,20,5,5,348
820700713,62,66,65,60,27,9,5,1,295
820700714,8,16,6,9,5,5,4,1,54
820700715,61,85,91,75,40,16,3,5,376
820700716,44,64,63,63,29,7,2,1,273
820700717,82,95,54,60,20,8,0,2,321
820700718,56,90,69,46,34,7,0,3,305
820770101,22,20,19,17,10,7,2,9,106
820770102,23,18,11,20,6,5,5,4,92
820770103,55,82,70,63,52,28,6,23,379
820770104,39,23,28,22,10,10,3,3,138
820770105,26,18,21,11,15,9,3,6,109
820770106,35,40,63,54,35,15,12,13,267
820770107,42,38,53,53,20,27,17,14,264
820770201,14,32,29,38,20,17,5,11,166
820770202,32,29,32,51,34,14,4,7,203
820770203,62,64,61,61,49,15,10,12,334
820770204,39,32,40,25,21,9,4,9,179
820770205,9,16,13,5,8,3,5,3,62
820770206,72,88,82,82,61,36,11,22,454
820770207,69,102,90,76,47,35,12,17,448
820770301,42,20,32,21,15,9,1,4,144
820770302,40,68,55,55,34,19,8,8,287
820770303,59,81,87,63,50,30,16,19,405
820770304,87,107,102,92,54,53,16,14,525
820770305,49,93,93,79,72,40,14,15,455
820770306,40,58,65,80,39,18,11,11,322
820770307,77,86,74,61,39,11,3,4,355
820770308,64,61,61,72,63,57,20,21,419
820770309,42,40,57,48,22,22,7,9,247
820770310,30,16,20,13,8,8,1,1,97
820770311,28,13,23,12,6,4,2,3,91
820770312,75,57,48,39,21,11,2,2,255
820770313,71,96,77,66,39,24,9,8,390
820770314,57,54,52,43,24,11,2,5,248
820770315,66,64,40,25,12,6,0,4,217
820770316,42,33,57,75,39,27,12,23,308
820770317,57,71,52,47,27,18,7,3,282
820770401,26,18,10,12,8,4,3,0,81
820770402,23,53,36,40,25,10,4,2,193
820770403,12,13,4,5,5,3,3,4,49
820770404,14,13,15,3,7,3,1,1,57
820770405,2,0,2,0,1,0,0,0,5
820770406,2,3,5,1,1,3,0,0,15
820770407,12,19,4,7,5,0,2,0,49
820770408,6,10,14,3,6,3,0,2,44
820770409,1,0,1,0,0,0,0,1,3
820840101,30,33,45,30,22,18,4,4,186
820840102,45,101,93,94,63,33,11,7,447
820840103,74,147,153,135,75,29,13,15,641
820840201,40,37,36,40,29,24,10,7,223
820840202,37,45,71,65,51,32,10,13,324
820840203,57,83,72,58,45,23,16,14,368
820840204,50,104,88,106,44,31,13,9,445
820840205,30,53,67,64,31,13,1,6,265
820840206,57,80,130,148,94,54,19,16,598
820840207,34,59,58,57,27,9,5,3,252
820840208,45,112,101,113,57,12,7,7,454
820840209,51,101,111,127,55,15,5,2,467
820840210,46,88,112,138,70,34,7,12,507
820840211,33,53,67,61,34,40,10,11,309
820840212,28,58,65,65,52,24,11,12,315
820840213,2,2,5,2,1,2,0,0,14
820840214,56,91,87,100,56,27,12,6,435
820840301,25,25,22,28,12,14,2,8,136
820840302,40,51,78,95,60,40,17,14,395
820840303,37,69,66,81,48,23,4,4,332
820840304,36,65,79,78,41,36,5,6,346
820840305,74,104,118,94,47,19,11,5,472
820840306,66,84,128,104,57,28,7,6,480
820840307,33,107,122,193,104,46,10,5,620
820840308,78,79,104,95,51,46,12,14,479
820840309,23,51,69,75,41,27,3,8,297
820840310,27,76,65,69,31,17,10,4,299
820840311,63,102,107,87,57,52,14,23,505
820840401,21,42,35,24,27,6,3,4,162
820840402,41,74,57,39,34,5,1,2,253
820840403,54,103,86,56,35,6,4,1,345
820840404,32,91,62,63,27,30,10,6,321
820840405,65,118,81,61,35,12,6,3,381
820840406,77,96,70,56,35,12,0,2,348
820840407,42,55,43,44,17,9,3,1,214
820840408,50,70,57,60,27,10,3,2,279
820840409,72,114,100,64,37,13,1,3,404
820840410,46,72,50,46,26,5,1,0,246
820840411,62,80,74,62,21,5,0,3,307
820840412,41,77,59,68,40,17,4,3,309
820840413,43,61,70,65,41,22,13,18,333
820840414,62,88,48,47,24,7,2,1,279
820840415,49,70,47,39,24,3,2,2,236
820840416,20,41,21,20,9,5,0,0,116
820840417,17,22,24,20,10,1,0,0,94
820840418,21,33,31,28,15,7,0,1,136
820840419,12,24,16,15,4,1,0,0,72
820840420,66,92,86,61,28,14,5,3,355
820840421,89,105,107,119,71,28,10,13,542
820840422,43,49,61,55,25,10,2,2,247
820840501,83,123,112,61,29,5,3,4,420
820840502,170,243,179,164,74,33,8,5,876
820840503,105,132,58,55,30,11,4,2,397
820840504,26,35,21,37,9,3,0,0,131
820840505,166,178,123,114,63,11,4,3,662
820840506,63,80,84,72,23,9,2,1,334
820840507,70,96,66,67,25,6,5,1,336
820840508,61,95,67,51,28,7,1,2,312
820840509,58,100,59,48,30,8,4,0,307
820840510,46,68,51,52,21,8,0,0,246
820840511,44,73,68,64,38,7,2,1,297
820840512,31,58,30,38,21,2,1,0,181
820840513,41,64,49,47,16,5,1,2,225
820840514,76,95,75,65,31,8,2,2,354
820840515,32,65,44,45,20,6,2,0,214
820840516,44,99,59,67,29,11,2,0,311
820840517,69,122,73,62,21,6,1,1,355
820840518,71,147,77,72,35,9,1,1,413
820840519,76,110,90,73,26,6,0,1,382
820840601,46,83,50,37,18,9,1,1,245
820840602,80,101,83,52,23,6,1,1,347
820840603,67,83,68,44,16,4,3,2,287
820840604,54,86,99,101,55,42,12,19,468
820840605,56,70,83,88,88,49,23,22,479
820840606,50,71,88,74,53,23,6,9,374
820840607,52,72,76,38,18,7,1,1,265
820840608,58,96,69,49,15,6,0,1,294
820840609,61,75,53,44,27,7,2,1,270
820840610,54,111,60,88,40,10,3,1,367
820840611,41,114,60,79,34,15,3,1,347
820840612,71,106,84,63,32,13,3,0,372
820840613,57,105,85,80,33,17,5,4,386
820840614,71,127,87,92,56,21,15,6,475
820840615,41,63,67,60,36,14,3,5,289
820840616,65,103,121,136,84,54,18,19,600
820840617,37,73,61,69,32,14,7,4,297
820840618,91,61,51,44,27,18,4,5,301
820840619,29,42,46,54,22,23,4,3,223
820840620,40,82,77,60,21,12,5,2,299
820840621,44,64,78,50,29,12,6,4,287
820840622,50,93,60,78,38,11,7,7,344
820840623,35,43,78,59,49,23,14,21,322
820840624,22,45,27,29,17,9,3,2,154
820840701,39,52,63,54,26,19,8,7,268
820840702,43,71,68,59,44,30,10,5,330
820840703,58,100,95,88,65,24,9,14,453
820840704,59,97,108,88,46,28,8,16,450
820840705,101,144,151,116,63,25,11,8,619
820840706,51,162,110,163,70,78,20,17,671
820840707,29,46,60,69,49,31,11,6,301
820840708,58,58,47,50,28,16,9,6,272
820840709,74,136,136,94,49,24,9,3,525
820840710,41,62,46,37,16,10,1,2,215
820840711,54,87,45,45,21,5,3,1,261
820840712,58,79,60,55,12,8,0,1,273
820840713,33,50,35,46,21,6,6,0,197
820840714,52,81,62,52,23,8,1,0,279
820840715,66,85,57,51,25,2,4,2,292
820840716,42,57,45,36,27,5,4,1,217
820840717,64,75,75,60,36,24,7,7,348
820840718,68,87,88,56,49,22,7,5,382
820840719,65,79,58,42,15,8,1,1,269
820840720,75,84,65,68,27,8,2,0,329
820840721,40,47,78,76,77,48,18,36,420
820840722,35,49,35,42,20,12,9,4,206
820840723,42,63,75,50,30,15,7,7,289
820840724,12,56,69,67,32,15,11,4,266
820840801,49,82,52,46,19,7,0,0,255
820840802,80,86,66,51,23,4,1,3,314
820840803,69,94,63,52,19,4,1,1,303
820840804,80,96,59,38,20,9,0,2,304
820840805,66,108,76,49,25,6,1,1,332
820840806,69,73,69,59,26,13,2,3,314
820840807,73,105,62,70,32,12,4,1,359
820840808,67,103,72,68,15,7,3,2,337
820840809,78,98,65,44,21,5,1,0,312
820840810,64,84,45,47,25,7,2,3,277
820840811,49,56,81,77,61,62,12,40,438
820840901,64,74,66,45,21,9,1,2,282
820840902,82,107,73,70,15,4,3,1,355
820840903,51,63,44,45,17,6,0,0,226
820840904,74,77,40,48,25,3,2,0,269
820840905,82,97,62,58,16,10,1,1,327
820840906,54,90,59,48,20,10,1,2,284
820840907,152,128,150,146,74,38,20,12,720
820840908,59,97,48,73,22,9,4,4,316
820840909,45,63,47,29,7,4,3,1,199
820840910,53,58,46,34,12,2,0,1,206
820840911,52,67,41,30,12,4,0,1,207
820841001,48,75,75,91,66,38,8,19,420
820841002,74,107,94,101,65,47,14,11,513
820841003,33,42,51,45,25,20,3,6,225
820841004,59,79,106,94,87,44,13,16,498
820841005,44,56,70,62,50,30,14,12,338
820841006,53,97,104,104,66,44,13,15,496
820841007,81,84,139,144,103,67,22,30,670
820841008,91,115,88,82,51,33,10,9,479
820841009,68,104,101,97,65,34,9,12,490
820841010,58,78,94,110,58,42,13,17,470
820841011,69,98,118,114,97,45,18,13,572
820841012,60,93,102,105,84,37,10,16,507
820841013,60,70,66,67,50,24,5,5,347
820841014,69,76,86,74,48,25,11,9,398
820841015,46,57,56,47,17,10,6,8,247
820841016,30,43,32,33,14,6,2,0,160
820841017,69,108,78,99,28,33,7,3,425
820841018,64,108,116,130,53,35,23,9,538
820841019,183,234,291,267,187,93,41,33,1329
820841020,36,41,60,69,39,25,16,14,300
820841101,31,60,45,41,34,24,2,1,238
820841102,29,61,37,33,24,6,3,2,195
820841103,43,80,59,63,36,15,3,1,300
820841104,42,68,50,46,24,3,0,0,233
820841105,36,65,66,83,27,23,5,5,310
820841106,43,62,73,70,44,12,5,10,319
820841107,46,98,112,110,66,25,15,3,475
820841108,29,81,50,61,35,8,1,2,267
820841109,2,7,4,2,3,1,0,0,19
820841110,48,103,121,103,81,23,11,5,495
820841111,47,103,69,86,48,14,4,0,371
820841112,40,88,65,60,33,11,2,1,300
820841113,27,37,39,29,22,14,8,5,181
820841114,58,63,80,65,23,23,13,14,339
820841115,34,62,46,33,21,13,1,4,214
820841116,48,73,58,52,28,12,3,1,275
820841117,78,90,75,59,22,15,7,3,349
820841118,64,88,61,69,25,12,5,1,325
820841119,57,91,81,47,31,13,2,1,323
820841201,75,108,77,73,49,37,7,7,433
820841202,25,58,60,64,49,22,8,19,305
820841203,47,92,74,53,28,19,9,10,332
820841204,42,56,69,92,54,39,13,16,381
820841205,43,71,64,61,36,25,3,5,308
820841206,68,83,92,87,61,50,5,15,461
820841207,36,69,46,43,21,19,5,2,241
820841208,31,67,45,42,29,11,4,3,232
820841209,42,36,56,56,48,34,12,29,313
820841210,23,65,63,53,29,20,6,4,263
820841211,17,41,58,62,63,32,14,28,315
820841212,37,56,62,63,28,14,3,4,267
820841213,38,50,70,59,42,20,10,4,293
820841214,64,96,68,64,27,10,3,4,336
820841215,57,66,66,57,32,21,3,3,305
820841216,63,84,54,43,15,10,4,2,275
820841217,52,57,64,59,30,16,1,2,281
820841218,56,80,77,78,69,29,5,6,400
820841219,25,33,47,38,31,29,17,20,240
820841220,37,36,46,48,38,39,9,8,261
820841221,46,70,63,69,39,25,10,20,342
820841301,50,90,64,68,30,8,5,0,315
820841302,81,140,122,105,56,34,18,18,574
820841303,56,67,106,83,48,29,13,18,420
820841304,112,112,112,100,70,48,17,18,589
820841305,54,75,51,52,27,12,1,0,272
820841306,41,97,50,66,40,21,6,7,328
820841307,24,42,45,36,21,13,5,10,196
820841308,52,77,63,65,24,21,4,2,308
820841309,32,64,49,44,14,5,2,2,212
820841310,65,100,81,55,20,22,2,0,345
820841311,50,76,48,60,28,10,2,2,276
820841312,57,75,58,30,19,5,2,0,246
820841313,59,123,94,99,33,25,9,7,449
820841314,40,54,64,57,36,18,7,5,281
820841401,52,76,62,52,26,10,4,2,284
820841402,54,55,42,36,14,3,1,0,205
820841403,72,80,57,47,15,8,2,2,283
820841404,50,91,61,65,34,10,2,2,315
820841405,61,66,53,55,20,10,3,2,270
820841406,79,85,69,63,28,16,1,1,342
820841407,55,89,59,59,20,4,2,3,291
820841408,61,82,58,58,32,11,1,3,306
820841409,60,65,50,43,13,5,4,1,241
820841410,53,99,79,74,29,10,4,3,351
820841411,33,37,39,37,13,4,0,2,165
820841501,46,74,58,38,21,8,5,2,252
820841502,52,67,55,50,22,15,0,2,263
820841503,50,72,41,50,16,8,1,2,240
820841504,51,65,56,67,22,4,3,0,268
820841505,49,71,48,47,18,8,1,2,244
820841506,50,74,54,54,15,10,3,1,261
820841507,42,64,42,37,15,3,1,0,204
820841508,50,66,37,46,27,15,3,1,245
820841509,50,50,45,42,19,15,5,10,236
820841601,97,103,55,42,15,6,0,1,319
820841602,94,112,65,46,18,7,1,1,344
820841603,122,104,67,51,28,2,2,1,377
820841604,61,96,72,44,20,4,1,1,299
820841605,82,116,70,57,21,6,1,0,353
820841606,82,92,67,33,13,7,2,1,297
820841607,195,163,41,30,10,6,1,1,447
820841608,83,67,28,19,15,2,1,0,215
820841609,127,122,56,36,25,2,2,2,372
820841610,96,70,40,30,14,2,0,1,253
820841611,52,54,33,35,15,3,2,1,195
820841612,70,81,34,22,8,4,1,2,222
820841701,39,52,36,23,9,4,1,1,165
820841702,77,75,43,30,8,3,2,1,239
820841703,75,58,39,33,2,2,0,2,211
820841704,105,86,44,25,11,4,1,2,278
820841705,61,66,37,43,18,0,0,1,226
820841706,78,84,55,49,20,4,2,0,292
820841707,77,76,45,38,10,3,0,1,250
820841708,45,47,28,16,7,4,0,0,147
820841709,104,114,40,35,17,3,0,1,314
820841710,108,80,53,29,15,1,1,0,287
820841711,134,133,42,40,13,5,2,0,369
820841712,71,81,55,38,12,5,0,0,262
820841713,100,87,44,30,11,8,2,0,282
820841714,92,75,32,11,11,4,0,0,225
820841715,145,132,54,27,12,4,0,1,375
820841716,62,47,29,23,7,4,1,1,174
820841717,37,61,38,30,9,1,1,0,177
820841718,121,109,30,15,9,0,0,0,284
820841719,79,99,42,27,11,2,0,0,260
820841801,144,123,80,52,16,2,0,0,417
820841802,64,45,28,17,4,2,1,0,161
820841803,89,48,23,8,5,0,0,0,173
820841804,126,155,83,65,11,2,1,1,444
820841805,132,93,36,23,9,2,0,0,295
820841806,69,86,37,26,12,2,0,0,232
820841807,152,166,72,38,7,2,0,0,437
820841808,84,93,36,28,2,3,1,0,247
820841809,80,110,40,24,6,3,1,0,264
820841810,77,104,38,31,8,3,1,0,262
820841811,106,122,56,35,17,5,0,0,341
820841812,83,82,32,16,10,3,0,0,226
820841813,163,139,51,29,10,1,0,0,393
820841814,76,77,40,24,3,1,0,0,221
820841815,76,78,36,25,8,0,0,0,223
820841816,46,59,28,15,3,2,0,0,153
820841817,79,77,18,21,3,0,0,0,198
820841818,99,85,43,34,15,4,0,0,280
820841901,98,96,48,31,10,2,0,0,285
820841902,76,93,41,30,8,1,0,0,249
820841903,124,140,60,25,9,1,0,0,359
820841904,72,63,26,20,5,2,0,1,189
820841905,62,68,29,22,14,2,0,0,197
820841906,79,63,32,27,4,3,0,0,208
820841907,72,72,27,22,6,1,1,0,201
820841908,138,91,45,25,7,2,1,0,309
820841909,149,109,49,36,6,4,0,1,354
820841910,148,128,39,33,8,0,1,0,357
820841911,106,79,50,21,8,0,0,0,264
820841912,111,81,38,25,9,2,0,0,266
820841913,68,52,26,10,6,0,0,0,162
820841914,71,61,24,14,2,1,0,1,174
820841915,101,85,32,16,8,3,0,0,245
820841916,59,65,42,20,6,4,0,1,197
820841917,104,104,46,28,8,3,2,1,296
820841918,116,116,56,30,10,2,0,0,330
820841919,63,53,26,14,5,0,0,0,161
820841920,93,60,25,15,4,1,0,0,198
820841921,59,55,24,13,4,0,0,0,155
820841922,31,31,14,14,2,1,0,0,93
820841923,67,50,21,17,2,0,0,0,157
820841924,77,83,41,32,10,2,0,1,246
820842001,91,70,32,11,8,0,0,0,212
820842002,85,86,45,23,6,2,0,2,249
820842003,145,113,40,40,8,3,1,0,350
820842004,95,64,31,17,3,2,0,0,212
820842005,44,59,31,19,4,2,0,1,160
820842006,116,81,25,15,1,2,0,0,240
820842007,99,84,32,34,12,2,0,0,263
820842008,126,64,18,19,0,0,0,0,227
820842009,122,85,42,35,8,1,2,0,295
820842010,64,55,27,16,5,0,0,0,167
820842011,76,96,30,17,7,2,0,0,228
820842012,78,65,37,26,7,4,0,0,217
820842013,122,95,45,37,8,0,0,0,307
820842014,88,80,46,21,8,3,0,0,246
820842015,40,52,19,13,4,0,0,0,128
820842016,58,57,20,11,5,0,0,0,151
820842017,37,43,20,10,5,3,0,0,118
820842101,98,79,46,31,16,2,0,0,272
820842102,94,105,60,36,6,2,0,0,303
820842103,110,111,44,26,2,3,0,0,296
820842104,131,113,58,48,14,1,1,1,367
820842105,63,44,39,16,3,1,0,0,166
820842106,12,18,9,4,0,0,0,0,43
820842107,120,100,39,25,9,1,0,0,294
820842108,113,77,29,31,7,1,0,0,258
820842109,99,99,29,16,4,0,0,0,247
820842110,93,82,40,26,5,3,0,0,249
820842111,91,83,36,29,8,0,0,1,248
820842112,63,51,24,7,3,0,0,1,149
820842113,20,28,4,12,0,0,0,0,64
820842114,87,121,56,39,11,2,1,0,317
820842115,86,56,31,16,8,0,0,0,197
820842116,82,94,39,35,11,5,0,0,266
820842117,116,54,21,8,2,0,0,0,201
820842201,98,77,38,28,8,0,0,0,249
820842202,131,78,27,20,2,2,0,0,260
820842203,77,90,37,27,5,0,1,0,237
820842204,4,0,0,0,0,0,0,0,4
820842205,82,103,49,38,19,0,1,0,292
820842206,102,104,45,41,9,2,1,0,304
820842207,141,103,52,31,5,2,0,0,334
820842208,108,108,45,27,11,3,0,1,303
820842209,118,83,27,16,8,3,0,1,256
820842210,150,109,65,43,17,1,0,0,385
820842211,88,117,48,51,17,2,2,0,325
820842212,125,130,53,34,7,3,3,0,355
820842213,74,72,20,21,3,0,0,0,190
820842301,99,99,47,33,8,2,0,1,289
820842302,79,74,41,21,7,1,0,1,224
820842303,91,99,55,35,14,5,1,0,300
820842304,64,59,24,31,6,5,0,0,189
820842305,82,88,54,33,13,4,1,1,276
820842306,74,84,51,40,9,0,0,0,258
820842307,161,101,30,21,4,1,1,0,319
820842308,156,134,36,28,3,1,1,0,359
820842309,83,72,50,29,8,2,0,0,244
820842310,105,67,31,13,5,1,0,0,222
820842311,190,123,48,33,7,4,0,0,405
820842312,123,127,40,20,7,2,1,0,320
820842313,107,106,63,37,8,1,0,0,322
820842314,124,101,34,16,6,4,0,0,285
820842315,87,69,39,29,11,2,0,1,238
820842316,87,82,42,22,9,0,0,0,242
820842317,59,50,37,16,8,2,0,0,172
820842318,88,82,37,23,3,0,1,0,234
820842319,69,83,42,20,3,0,1,0,218
820842320,53,52,40,33,9,3,1,0,191
820842321,35,31,24,23,8,2,0,0,123
820842322,82,70,30,23,6,2,1,0,214
820842323,91,67,33,22,9,3,0,0,225
820842324,69,55,39,19,6,2,0,0,190
820842401,69,69,37,15,5,0,0,0,195
820842402,88,102,49,23,11,2,0,0,275
820842403,59,64,30,16,3,1,1,0,174
820842404,149,92,47,17,12,3,0,0,320
820842405,73,75,44,30,12,3,1,0,238
820842406,81,72,33,27,8,2,3,0,226
820842407,117,74,33,32,14,3,0,0,273
820842408,72,71,40,26,10,0,0,0,219
820842409,123,116,53,22,11,2,3,0,330
820842410,63,57,32,28,7,1,1,0,189
820842411,60,71,21,19,6,1,0,0,178
820842412,115,96,47,38,5,2,0,0,303
820842413,94,96,60,54,11,3,0,0,318
820842414,67,61,30,18,5,1,0,0,182
820842415,103,83,24,13,3,0,0,0,226
820842416,82,70,44,27,18,0,0,0,241
820842417,35,27,25,20,5,2,0,0,114
820842418,101,90,37,14,5,1,0,1,249
820842419,88,71,20,26,10,2,0,0,217
820842501,73,91,39,28,11,1,1,0,244
820842502,92,79,29,22,3,3,1,1,230
820842503,72,68,26,15,8,1,0,1,191
820842504,47,42,28,23,10,11,6,5,172
820842505,98,67,41,26,10,1,1,0,244
820842506,145,107,50,31,7,3,0,0,343
820842507,104,104,31,14,6,3,1,0,263
820842508,150,101,51,28,4,3,0,0,337
820842509,74,103,41,30,11,6,0,1,266
820842510,69,40,30,9,6,3,1,1,159
820842511,113,83,30,22,10,0,0,0,258
820842512,248,169,80,38,15,3,4,0,557
820842513,121,99,57,41,11,5,0,0,334
820842514,40,34,8,1,2,0,0,1,86
820842515,85,64,22,12,5,0,0,0,188
820842516,29,23,15,8,3,0,0,0,78
820842601,116,95,33,28,7,2,1,0,282
820842602,75,69,46,21,6,2,0,1,220
820842603,117,101,46,29,12,0,0,0,305
820842604,120,115,46,33,13,5,1,1,334
820842605,79,75,33,10,2,1,0,0,200
820842606,50,52,38,16,7,5,1,1,170
820842607,130,84,41,19,2,4,2,0,282
820842608,134,92,41,18,6,2,0,0,293
820842609,69,41,20,9,4,1,1,1,146
820842610,121,123,44,26,7,2,0,0,323
820842611,94,45,28,12,5,3,0,0,187
820842612,81,57,24,8,3,0,0,0,173
820842613,123,125,57,37,10,4,1,0,357
820842614,121,100,37,29,8,4,1,0,300
820842615,150,89,32,21,5,1,0,1,299
820842616,109,124,64,35,14,1,1,0,348
820842617,69,65,30,23,5,2,0,0,194
820842618,90,75,28,13,2,1,0,0,209
820842619,36,52,24,19,6,1,0,0,138
820842620,86,51,35,18,5,2,0,1,198
820842621,118,114,47,43,4,3,1,1,331
820842622,82,56,20,6,2,1,1,1,169
820842623,84,73,29,28,10,0,0,0,224
820842701,108,110,46,27,16,4,0,0,311
820842702,110,86,47,24,8,2,0,0,277
820842703,62,54,26,23,11,0,0,0,176
820842704,81,57,19,22,5,0,0,0,184
820842705,67,70,21,14,6,1,1,0,180
820842706,56,47,23,15,6,3,0,1,151
820842707,99,90,35,29,6,3,0,0,262
820842708,113,120,32,28,3,0,0,0,296
820842709,37,35,26,13,5,0,0,0,116
820842710,102,79,38,25,15,5,0,1,265
820842711,93,75,33,15,5,3,1,1,226
820842712,129,106,49,48,19,2,0,0,353
820842713,96,75,21,26,12,1,1,0,232
820842714,65,84,42,28,9,3,0,0,231
820842715,91,110,52,37,7,4,0,2,303
820842716,77,91,47,31,9,2,0,0,257
820842717,71,44,22,13,2,4,0,0,156
820842718,46,52,28,22,5,3,1,0,157
820842719,76,66,33,15,8,4,0,0,202
820842720,85,70,22,13,7,2,0,0,199
820842721,98,82,39,20,9,2,0,1,251
820842722,71,59,28,20,6,1,1,0,186
820842801,55,52,28,12,14,3,0,0,164
820842802,141,131,62,38,10,4,0,0,386
820842803,82,70,24,9,2,0,0,0,187
820842804,104,62,50,25,7,0,2,1,251
820842805,21,38,29,10,8,1,0,0,107
820842806,14,5,6,2,2,0,0,0,29
820842807,130,133,50,42,6,2,1,1,365
820842808,85,84,27,15,2,1,0,0,214
820842809,125,124,48,34,8,0,1,0,340
820842810,149,124,63,32,11,5,2,0,386
820842811,161,135,67,40,9,1,0,0,413
820842812,74,63,28,16,7,1,0,0,189
820842813,84,84,30,26,9,0,0,1,234
820842814,63,49,23,21,3,1,0,0,160
820842815,98,97,58,31,8,2,0,1,295
820842816,101,108,46,29,14,1,1,0,300
820842817,140,100,46,23,4,4,1,0,318
820842818,72,70,38,20,9,0,0,0,209
820842819,72,68,45,30,5,2,1,0,223
820842820,85,96,51,35,9,5,1,0,282
820842821,72,85,22,16,7,4,0,0,206
820842822,79,81,29,8,6,0,1,1,205
820842823,65,46,23,17,4,2,0,0,157
820842824,126,84,44,25,5,1,0,0,285
820842825,95,81,34,7,5,0,0,0,222
820842901,183,169,75,32,23,5,0,0,487
820842902,156,123,44,26,8,1,1,0,359
820842903,94,111,73,28,14,2,0,1,323
820842904,119,131,33,31,11,1,1,0,327
820842905,143,125,55,41,10,4,1,0,379
820842906,70,45,29,18,8,5,0,0,175
820842907,106,94,50,31,18,4,0,0,303
820842908,100,95,50,37,19,1,2,1,305
820842909,73,72,40,17,15,3,1,0,221
820842910,129,144,39,38,19,2,0,1,372
820842911,105,140,61,39,16,4,2,1,368
820842912,106,84,49,26,2,0,2,0,269
820842913,93,84,40,33,7,1,0,1,259
820842914,75,101,56,47,16,3,1,1,300
820842915,94,132,48,27,11,1,2,0,315
820842916,56,57,32,20,17,4,0,0,186
820842917,65,98,44,30,10,1,2,1,251
820842918,88,86,58,47,17,2,0,0,298
820842919,56,77,46,33,20,5,3,0,240
820842920,68,69,30,37,12,5,1,0,222
820842921,68,48,26,8,5,4,0,1,160
820842922,42,44,28,26,8,2,0,1,151
820842923,51,45,20,27,11,2,0,0,156
820842924,82,71,68,46,11,2,1,0,281
820843001,28,71,68,50,25,11,3,3,259
820843002,47,73,65,45,32,21,2,4,289
820843003,88,159,143,129,57,23,6,8,613
820843004,67,118,89,93,38,14,1,3,423
820843005,61,73,68,59,39,17,2,0,319
820843006,24,56,58,52,28,15,10,5,248
820843007,41,86,91,106,66,30,12,6,438
820843008,41,66,59,57,29,21,8,5,286
820843009,53,81,80,75,40,27,4,7,367
820843010,51,73,88,77,36,27,9,7,368
820843011,38,50,75,46,22,13,3,3,250
820843012,24,61,68,56,34,18,10,6,277
820843013,28,65,56,46,27,13,3,4,242
820843014,68,77,74,75,39,22,4,8,367
820843101,71,92,81,82,40,13,4,2,385
820843102,62,86,58,65,14,16,1,1,303
820843103,52,93,51,58,21,10,4,1,290
820843104,52,85,61,56,28,7,3,0,292
820843105,33,48,34,35,17,2,1,2,172
820843106,62,83,56,56,35,10,2,1,305
820843107,33,59,42,32,15,8,1,2,192
820843108,50,58,54,61,26,12,4,4,269
820843109,48,51,42,42,11,6,1,1,202
820843110,53,71,72,58,36,8,1,4,303
820843111,67,86,62,65,27,17,3,1,328
820843112,57,100,60,53,24,12,3,3,312
820843113,47,82,61,62,25,12,3,3,295
820843114,49,78,54,58,24,4,3,0,270
820843115,51,77,52,49,20,2,4,2,257
820843116,70,95,63,55,33,10,1,1,328
820843117,78,77,57,37,24,7,1,2,283
820843118,59,74,58,43,23,9,2,3,271
820843119,50,86,42,53,22,10,3,1,267
820843120,43,50,50,50,22,15,0,3,233
820843121,41,80,64,58,29,14,4,1,291
820843201,54,110,110,83,32,22,5,5,421
820843202,49,67,83,80,35,14,3,2,333
820843203,69,104,66,57,23,15,4,3,341
820843204,64,79,75,60,32,11,3,3,327
820843205,41,74,69,65,30,17,7,5,308
820843206,32,67,96,85,41,22,8,9,360
820843207,25,51,58,69,44,27,6,10,290
820843208,60,96,108,123,71,36,16,9,519
820843209,38,59,61,43,28,14,4,5,252
820843210,59,43,75,76,25,32,14,14,338
820843211,43,77,66,70,33,19,7,3,318
820843212,25,60,74,101,51,43,16,23,393
820843213,58,100,103,77,41,31,5,10,425
820843214,44,58,38,47,24,16,9,6,242
820843215,38,56,62,57,43,32,8,9,305
820843301,46,78,55,62,38,23,5,2,309
820843302,39,69,62,75,42,32,11,9,339
820843303,55,102,114,101,50,37,13,15,487
820843304,41,73,75,73,39,26,10,7,344
820843305,60,110,98,107,54,21,8,11,469
820843306,58,81,66,82,37,23,4,8,359
820843307,60,70,63,55,31,15,13,7,314
820843308,34,69,45,64,22,15,2,5,256
820843309,50,90,101,121,54,31,7,6,460
820843310,61,91,94,81,47,38,11,15,438
820843311,55,64,90,113,40,32,10,14,418
820843312,62,115,68,68,47,18,9,9,396
820843313,38,69,63,53,32,18,8,7,288
820843314,44,52,63,61,36,14,12,8,290
820843315,39,67,99,119,90,53,19,14,500
820843316,42,71,77,89,47,25,10,7,368
820843317,74,64,89,80,55,38,9,14,423
820843318,44,66,74,73,45,30,10,4,346
820843319,37,49,64,71,45,24,2,1,293
820843401,58,67,55,52,33,23,5,13,306
820843402,45,63,80,81,53,36,7,16,381
820843403,19,44,25,29,15,3,2,2,139
820843404,50,62,65,71,62,51,9,14,384
820843405,95,102,71,59,27,4,2,1,361
820843406,101,86,71,56,22,13,4,0,353
820843407,87,95,57,59,23,7,2,0,330
820843408,91,106,88,62,29,11,5,0,392
820843409,80,83,79,61,29,18,10,8,368
820843410,73,84,45,64,28,8,2,0,304
820843411,32,61,42,34,13,5,1,0,188
820843412,31,68,60,36,15,6,2,1,219
820843413,28,45,41,41,14,4,0,1,174
820843414,61,80,63,60,19,6,3,2,294
820843415,48,76,67,62,36,20,4,3,316
820843416,77,51,83,97,49,37,11,13,418
820843417,54,56,61,64,11,7,1,1,255
820843418,38,42,29,27,10,4,2,2,154
820843419,17,17,36,36,28,23,3,2,162
820843501,42,69,76,48,40,40,4,11,330
820843502,27,46,28,30,14,3,2,1,151
820843503,48,76,44,45,22,6,4,0,245
820843504,59,93,54,75,30,13,2,3,329
820843505,53,83,75,61,29,18,1,3,323
820843506,51,73,47,58,20,5,1,2,257
820843507,34,56,32,41,14,10,1,0,188
820843508,31,56,55,61,18,17,2,4,244
820843509,73,105,67,85,36,15,8,8,397
820843510,62,73,63,63,58,29,7,13,368
820843511,62,58,92,80,48,29,11,15,395
820843512,74,80,92,95,59,40,13,14,467
820843513,26,51,54,55,35,20,8,12,261
820843514,48,83,97,71,42,20,11,10,382
820843515,51,93,85,87,61,32,3,4,416
820843516,45,50,72,56,53,22,10,8,316
820843517,87,98,160,144,85,80,32,35,721
820843601,53,92,49,38,12,4,1,1,250
820843602,44,70,43,47,24,7,4,1,240
820843603,28,47,60,63,20,7,0,2,227
820843604,76,61,55,65,22,8,0,0,287
820843605,31,50,30,36,14,2,1,0,164
820843606,51,56,25,21,6,3,0,1,163
820843607,40,77,55,56,29,8,2,0,267
820843608,72,89,80,64,17,5,4,2,333
820843609,51,89,59,71,27,10,1,3,311
820843610,65,105,63,61,21,6,6,3,330
820843611,74,102,67,57,11,7,2,1,321
820843612,118,166,134,119,50,26,7,6,626
820843613,58,76,72,48,27,8,1,2,292
820843614,45,75,35,46,19,9,0,2,231
820843615,33,50,47,39,17,12,2,3,203
820843616,50,76,95,76,38,29,7,11,382
820843617,32,54,47,39,15,11,0,1,199
820843618,33,62,51,26,20,7,1,2,202
820843619,64,59,42,31,13,1,0,0,210
820843701,126,102,61,51,19,4,0,1,364
820843702,94,120,80,81,23,5,0,0,403
820843703,89,94,46,35,10,7,0,2,283
820843704,49,55,45,34,10,2,0,0,195
820843705,102,73,43,30,9,6,1,0,264
820843706,113,136,54,38,7,4,0,0,352
820843707,104,91,46,24,9,3,0,2,279
820843708,159,108,47,50,17,3,0,0,384
820843709,83,54,48,29,6,0,0,0,220
820843710,108,113,59,39,18,2,0,0,339
820843711,88,83,41,22,6,1,1,0,242
820843712,100,89,59,60,22,7,2,1,340
820843713,94,99,59,44,17,11,3,0,327
820843714,74,102,52,59,19,4,0,2,312
820843715,82,77,46,30,15,2,0,0,252
820843716,95,90,31,23,11,2,1,0,253
820843801,150,169,62,33,11,3,2,1,431
820843802,100,95,48,47,16,3,0,0,309
820843803,73,107,52,43,18,5,0,1,299
820843804,119,108,56,43,20,8,3,1,358
820843805,70,99,42,42,21,7,3,0,284
820843806,85,97,49,46,14,5,1,1,298
820843807,49,75,56,35,16,12,0,0,243
820843808,57,58,32,25,16,2,2,1,193
820843809,47,65,39,39,14,3,1,1,209
820843810,52,106,65,53,21,8,2,0,307
820843811,89,81,65,50,26,10,0,6,327
820843812,57,48,54,35,18,17,7,7,243
820843813,88,95,73,50,26,12,4,0,348
820843814,88,106,81,49,22,5,1,0,352
820843815,53,72,44,43,12,5,3,1,233
820843901,43,67,25,31,5,4,0,0,175
820843902,54,72,44,29,10,4,0,0,213
820843903,67,89,59,33,17,3,2,3,273
820843904,66,71,46,36,8,4,1,0,232
820843905,142,128,69,43,21,7,0,0,410
820843906,87,86,64,44,18,8,0,0,307
820843907,121,121,50,35,10,6,1,2,346
820843908,153,125,79,51,8,2,2,0,420
820843909,68,61,43,27,12,1,0,0,212
820843910,52,56,36,19,12,1,1,0,177
820843911,52,70,47,37,21,2,2,2,233
820843912,96,121,63,52,14,6,1,4,357
820843913,77,99,55,51,23,3,2,0,310
820843914,51,35,30,24,8,1,0,0,149
820843915,69,84,36,21,9,0,0,0,219
820843916,70,39,26,13,13,0,1,0,162
820843917,57,72,30,23,5,0,0,0,187
820843918,91,122,87,86,37,11,2,2,438
820843919,61,71,30,27,9,3,0,0,201
820843920,54,65,34,40,16,5,2,0,216
820844001,106,112,56,38,24,3,5,1,345
820844002,121,103,57,27,9,3,1,2,323
820844003,136,131,49,35,16,3,2,0,372
820844004,56,69,68,66,38,23,3,5,328
820844005,50,63,80,67,56,31,14,20,381
820844006,98,72,40,32,14,9,0,0,265
820844007,91,85,41,34,13,4,0,0,268
820844008,63,71,19,23,14,1,0,1,192
820844009,77,69,55,44,18,13,2,4,282
820844010,77,89,66,42,18,7,1,1,301
820844011,20,29,24,28,12,4,2,0,119
820844012,11,23,12,20,5,0,2,1,74
820844013,44,52,39,42,15,14,0,3,209
820844014,86,110,72,49,17,7,0,0,341
820844015,47,79,51,28,11,7,0,1,224
820844101,60,81,65,58,23,6,1,1,295
820844102,57,60,54,49,24,18,1,6,269
820844103,55,59,57,49,24,15,1,3,263
820844104,43,64,64,60,27,23,3,4,288
820844105,0,0,0,0,0,0,0,0,0
820844106,53,83,77,54,17,13,2,0,299
820844107,56,97,79,79,29,8,2,1,351
820844108,62,83,69,54,40,22,4,2,336
820844109,66,73,46,75,44,21,9,8,342
820844110,57,80,79,61,52,41,19,19,408
820844111,40,60,52,51,21,9,5,3,241
820844112,42,56,67,50,37,31,6,6,295
820844201,50,70,25,21,11,5,0,1,183
820844202,19,31,31,33,21,20,8,9,172
820844203,32,35,24,16,8,7,2,0,124
820844204,37,48,43,55,26,20,1,2,232
820844205,27,44,42,38,25,15,9,5,205
820844206,27,25,12,19,16,10,2,3,114
820844207,47,77,64,78,53,37,11,7,374
820844208,39,50,48,65,45,31,10,9,297
820844209,50,72,83,66,44,26,3,5,349
820844210,62,94,84,70,29,17,3,2,361
820844211,41,61,52,59,28,20,5,9,275
820844212,31,62,58,49,41,22,9,9,281
820844213,44,91,86,71,54,39,16,13,414
820844214,20,34,38,37,20,9,3,2,163
820844301,63,70,47,39,28,7,1,0,255
820844302,38,51,46,38,20,7,3,3,206
820844303,51,85,51,38,8,10,2,2,247
820844304,71,79,47,51,21,4,3,0,276
820844305,38,71,45,47,26,4,2,1,234
820844306,64,81,45,42,18,3,2,1,256
820844307,76,94,75,59,23,4,3,1,335
820844308,41,54,26,26,11,6,1,0,165
820844309,52,61,58,45,22,3,4,0,245
820844310,50,66,47,48,20,0,3,2,236
820844311,50,86,76,48,21,15,2,1,299
820844312,57,86,89,78,29,15,5,2,361
820844313,52,87,65,68,38,12,3,3,328
820844314,50,106,85,79,34,20,0,1,375
820844401,67,107,93,75,23,4,3,1,373
820844402,58,56,29,27,9,0,0,0,179
820844403,46,99,76,82,30,20,5,3,361
820844404,33,46,51,56,34,20,14,14,268
820844405,58,50,36,32,12,10,0,2,200
820844406,67,74,40,28,15,2,1,1,228
820844407,67,89,43,52,21,9,5,3,289
820844408,34,42,41,48,27,20,4,5,221
820844409,45,75,67,63,18,14,0,0,282
820844410,65,83,43,47,23,8,2,2,273
820844411,54,84,45,31,18,3,2,0,237
820844412,61,72,52,44,26,9,0,0,264
820844413,78,104,56,48,22,5,1,2,316
820844414,48,70,46,47,22,7,0,2,242
820844415,42,76,66,54,16,6,2,1,263
820844416,65,89,66,63,22,16,4,2,327
820844417,52,89,59,42,26,7,3,1,279
820844418,51,70,61,52,35,9,0,2,280
820844501,43,67,65,50,23,9,4,2,263
820844502,35,58,28,27,16,6,4,2,176
820844503,62,82,80,90,37,12,1,3,367
820844504,60,86,56,53,26,9,3,1,294
820844505,41,59,35,42,22,6,3,1,209
820844506,45,49,35,35,11,4,0,1,180
820844507,51,64,63,43,23,14,3,0,261
820844508,51,62,50,41,24,10,1,2,241
820844509,50,105,80,69,33,11,5,0,353
820844510,53,95,51,59,17,13,2,2,292
820844511,68,110,77,67,28,8,5,4,367
820844512,59,90,69,67,31,8,0,3,327
820844513,21,38,29,25,10,2,4,1,130
820844514,56,92,84,59,38,18,4,3,354
820844515,57,59,53,51,22,9,5,2,258
820844516,30,61,71,62,37,24,15,16,316
820844517,61,58,75,61,41,25,4,3,328
820844518,62,81,90,66,46,16,5,5,371
820844519,58,95,66,54,29,11,3,4,320
820844520,32,56,58,61,42,16,6,5,276
820844521,29,45,49,35,23,6,4,0,191
820844522,27,88,53,42,26,5,2,1,244
820844523,61,88,85,78,30,12,4,2,360
820844524,52,89,61,58,23,9,1,0,293
820844601,62,84,56,77,27,11,3,4,324
820844602,73,86,65,60,19,7,4,6,320
820844603,55,87,67,65,21,15,6,7,323
820844604,54,92,69,71,24,9,0,0,319
820844605,19,34,41,32,17,5,0,0,148
820844606,47,92,82,76,40,18,1,0,356
820844607,75,111,89,86,45,24,4,4,438
820844608,55,88,66,58,23,8,2,3,303
820844609,50,81,122,112,82,55,17,22,541
820844610,49,69,58,64,40,18,11,5,314
820844611,35,66,76,67,56,43,14,20,377
820844612,30,38,62,31,21,14,7,7,210
820844613,41,63,87,89,58,32,7,10,387
820844614,47,89,81,61,52,44,12,11,397
820844615,43,35,40,44,33,19,5,4,223
820844701,47,52,50,63,35,28,7,13,295
820844702,31,51,51,46,28,19,5,10,241
820844703,40,48,63,47,35,30,10,15,288
820844704,54,90,106,109,67,55,14,18,513
820844705,62,76,81,81,45,19,9,7,380
820844706,35,73,73,51,27,11,6,7,283
820844707,39,59,67,38,18,8,5,7,241
820844708,57,55,47,57,23,20,4,7,270
820844709,30,65,57,44,25,6,5,4,236
820844710,62,75,103,80,52,31,11,14,428
820844711,26,59,51,46,19,13,5,4,223
820844712,17,64,49,47,32,15,6,6,236
820844713,31,48,50,45,31,24,4,3,236
820844714,30,34,51,49,31,20,10,8,233
820844715,40,62,52,40,31,16,9,5,255
820844716,72,101,91,87,73,55,11,21,511
820844801,57,107,126,128,63,39,8,11,539
820844802,55,74,93,75,44,29,10,12,392
820844803,67,90,73,73,39,14,4,3,363
820844804,35,61,54,68,33,22,4,5,282
820844805,31,52,60,64,44,17,8,4,280
820844806,43,47,54,44,39,31,2,9,269
820844807,89,112,140,104,85,58,25,20,633
820844808,32,43,53,45,23,17,9,9,231
820844809,27,55,52,43,21,13,5,3,219
820844810,40,67,60,71,29,25,12,11,315
820844811,47,92,108,141,51,24,3,7,473
820844812,41,88,64,64,27,14,3,1,302
820844813,31,67,103,94,68,32,13,6,414
820844814,28,46,65,78,45,22,9,16,309
820844815,41,76,51,50,27,9,6,4,264
820844816,61,98,88,84,47,20,4,5,407
820844817,45,78,97,94,78,22,10,6,430
820844818,23,40,46,75,37,34,9,8,272
820844819,39,45,69,70,37,17,10,8,295
820844820,32,54,77,69,55,26,14,6,333
820844821,153,70,100,95,69,40,13,13,553
820844822,36,49,99,111,54,34,12,13,408
820844901,25,42,31,32,10,15,2,1,158
820844902,35,47,65,60,49,24,5,8,293
820844903,16,27,80,66,45,24,11,12,281
820844904,49,75,70,67,41,17,10,11,340
820844905,44,41,62,49,40,18,6,11,271
820844906,30,45,50,30,21,21,4,3,204
820844907,29,69,107,111,56,51,25,25,473
820844908,57,92,102,129,104,50,17,28,579
820844909,48,89,73,83,42,24,9,8,376
820844910,40,67,60,78,42,30,7,8,332
820844911,106,123,150,143,100,70,28,26,746
820844912,28,53,62,60,61,55,12,13,344
820844913,40,64,77,85,57,37,10,14,384
820844914,28,51,81,63,64,58,20,26,391
820844915,46,49,64,58,40,27,10,12,306
820845001,45,75,84,68,24,12,3,0,311
820845002,55,106,66,64,42,23,4,1,361
820845003,72,79,54,68,28,14,3,3,321
820845004,57,82,90,83,47,13,6,10,388
820845005,65,85,59,80,38,13,6,0,346
820845006,54,89,85,74,40,32,2,3,379
820845007,48,70,79,107,46,26,5,10,391
820845008,52,72,83,81,41,32,4,8,373
820845009,26,52,42,43,20,9,0,3,195
820845010,33,52,45,39,21,10,5,1,206
820845011,58,100,83,75,26,15,2,7,366
820845012,55,98,85,90,48,30,10,11,427
820845013,54,94,61,71,32,15,6,3,336
820845101,81,86,83,65,43,17,3,2,380
820845102,66,65,69,69,26,14,3,1,313
820845103,56,94,68,63,16,12,0,1,310
820845104,57,94,64,68,16,10,0,0,309
820845105,53,88,74,54,26,7,0,0,302
820845106,73,108,89,70,34,17,7,1,399
820845107,54,82,60,76,47,27,6,9,361
820845108,81,99,75,76,23,17,5,4,380
820845109,61,86,58,62,30,11,5,4,317
820845110,50,80,67,48,20,9,0,0,274
820845111,88,92,69,66,31,9,1,0,356
820845112,49,69,58,47,22,13,3,1,262
820845113,38,48,36,42,16,5,2,2,189
820845114,26,37,50,52,29,22,6,8,230
820845201,55,107,119,114,50,30,9,15,499
820845202,41,59,68,64,37,26,6,9,310
820845203,89,82,79,67,37,24,9,5,392
820845204,52,77,71,76,55,27,7,13,378
820845205,40,67,70,73,54,33,10,16,363
820845206,32,57,79,86,38,46,17,16,371
820845207,65,68,80,85,62,60,9,15,444
820845208,38,65,69,86,47,38,9,28,380
820845209,38,72,58,70,44,21,1,10,314
820845210,21,46,49,61,45,30,10,16,278
820845211,38,85,105,94,53,45,13,8,441
820845212,32,38,68,61,33,25,11,17,285
820845213,36,73,60,89,47,20,3,9,337
820845214,72,91,88,89,52,45,6,8,451
820845301,61,72,61,40,12,6,2,2,256
820845302,65,96,60,59,27,7,2,2,318
820845303,41,81,75,75,37,20,3,4,336
820845304,90,69,51,61,52,34,11,8,376
820845305,23,32,35,42,29,16,4,6,187
820845306,70,115,68,76,37,13,4,3,386
820845307,73,82,100,76,34,14,9,2,390
820845308,62,95,112,87,46,25,14,3,444
820845309,48,58,87,76,44,25,9,11,358
820845310,76,110,88,70,37,19,1,2,403
820845311,58,59,36,43,16,8,1,2,223
820845312,61,90,61,67,27,5,3,0,314
820845313,36,45,36,31,13,7,6,0,174
820845314,51,68,51,42,13,4,1,2,232
820845315,34,68,70,74,40,10,3,1,300
820845316,27,43,64,68,31,16,7,3,259
820845317,53,50,37,37,20,5,0,0,202
820845318,130,120,109,79,55,27,7,10,537
820845319,60,62,68,64,25,11,1,1,292
820845320,29,53,45,41,29,7,4,1,209
820845321,38,47,48,38,18,6,3,3,201
820845322,11,20,10,13,2,3,0,0,59
820845323,65,119,113,118,78,38,18,13,562
820845401,23,42,28,24,14,1,2,0,134
820845402,39,68,52,57,18,5,2,1,242
820845403,41,56,38,48,15,10,1,0,209
820845404,64,76,71,55,22,12,4,3,307
820845405,40,49,52,43,25,15,3,1,228
820845406,22,20,23,29,22,9,1,2,128
820845407,32,40,37,39,20,14,6,4,192
820845408,75,47,47,67,30,20,5,9,300
820845409,45,60,65,54,26,16,7,3,276
820845410,26,45,29,28,19,14,3,1,165
820845411,65,106,67,67,32,13,4,2,356
820845412,53,92,81,65,24,12,0,2,329
820845413,35,65,44,34,14,2,2,1,197
820845414,62,88,90,68,30,8,2,2,350
820845415,53,91,76,89,26,8,1,2,346
820845416,55,74,68,57,23,5,3,1,286
820845417,39,72,67,48,22,10,1,1,260
820845418,56,76,67,55,23,4,0,2,283
820845419,27,50,43,32,15,3,0,0,170
820845501,76,103,85,77,27,12,2,6,388
820845502,45,97,62,88,35,19,10,5,361
820845503,56,67,72,43,24,10,2,3,277
820845504,54,93,68,53,37,11,3,4,323
820845505,103,100,103,56,37,14,4,3,420
820845506,41,78,55,39,20,5,4,4,246
820845507,59,96,71,66,36,15,4,1,348
820845508,56,86,91,96,52,45,13,20,459
820845509,50,57,56,75,26,8,3,4,279
820845510,37,77,74,77,59,29,10,11,374
820845511,20,68,72,58,40,24,5,6,293
820845512,31,58,66,73,52,25,10,10,325
820845513,41,74,111,102,50,38,15,14,445
820845514,57,96,78,92,54,21,8,8,414
820845515,21,33,38,49,35,22,15,14,227
820845516,42,50,57,39,46,23,8,7,272
820845517,26,43,64,48,38,29,4,0,252
820845518,38,45,59,49,47,31,18,16,303
820845519,31,39,47,42,23,8,5,0,195
820845520,42,85,99,80,46,30,14,16,412
820845521,46,58,55,40,37,20,7,9,272
820845522,47,82,95,83,53,49,18,12,439
820845523,52,48,43,54,24,15,4,7,247
820845601,11,4,5,3,2,0,0,0,25
820845602,7,0,1,0,0,0,0,0,8
820845603,10,1,3,3,2,4,0,0,23
820845701,9,17,16,16,5,1,0,0,64
820845702,44,82,52,52,23,10,6,4,273
820845703,40,80,56,69,32,13,3,4,297
820845704,43,69,46,61,22,7,0,1,249
820845705,72,92,54,65,36,10,4,1,334
820845706,8,45,17,22,14,3,1,2,112
820845707,35,58,44,53,17,10,3,0,220
820845708,66,116,93,92,31,9,6,2,415
820845709,14,40,29,28,13,7,4,0,135
820845710,56,104,107,75,45,8,7,6,408
820845711,18,63,54,119,46,24,1,1,326
820845712,50,63,54,62,21,9,2,2,263
820845713,45,79,55,60,21,13,4,3,280
820845714,3,7,5,6,3,2,1,0,27
820845715,4,3,2,2,1,1,1,2,16
820845801,6,8,2,7,2,1,0,1,27
820845802,98,113,92,84,41,15,8,2,453
820845803,77,104,66,76,36,12,5,4,380
820845804,7,4,6,10,3,1,0,0,31
820845805,91,101,106,96,40,26,8,8,476
820845806,1,1,1,1,1,1,1,0,7
820845807,124,91,72,67,29,11,1,2,397
820845901,5,3,6,3,1,0,0,0,18
820845902,3,9,4,9,2,0,1,0,28
820845903,3,4,6,4,2,1,0,0,20
820845904,71,85,110,124,77,42,15,25,549
820845905,33,74,99,67,60,54,31,26,444
820845906,24,31,42,39,31,21,7,8,203
820845907,47,78,138,114,77,55,26,36,571
820845908,35,47,60,62,37,11,9,6,267
820845909,32,59,91,89,66,21,8,14,380
820845910,85,127,137,121,73,44,9,15,611
820845911,51,82,99,79,46,23,17,13,410
820845912,76,103,90,80,31,10,2,2,394
820845913,61,84,54,44,17,5,1,1,267
820845914,64,68,53,68,30,16,3,2,304
820845915,28,52,36,45,14,3,1,0,179
820845916,46,49,38,30,18,4,1,0,186
820845917,66,109,134,109,62,31,9,15,535
820845918,63,105,85,104,52,16,9,4,438
820845919,1,0,0,1,0,0,1,1,4
820845920,42,76,64,57,30,16,2,3,290
820845921,57,84,120,98,72,38,8,17,494
820845922,41,68,96,83,68,39,11,24,430
820845923,38,64,109,115,84,50,25,14,499
820845924,38,56,75,68,34,17,12,11,311
820846001,8,9,7,11,10,4,1,2,52
820846002,23,37,23,23,21,9,4,7,147
820846003,6,2,2,2,1,1,0,0,14
820846004,59,89,81,83,51,19,4,3,389
820846005,40,82,73,96,45,18,5,7,366
820846101,28,40,47,33,29,15,7,7,206
820846102,48,70,44,45,21,11,5,4,248
820846103,26,62,54,49,42,16,6,5,260
820846104,33,62,60,65,53,28,6,18,325
820846105,51,59,51,43,22,17,2,2,247
820846106,29,52,62,62,25,16,3,2,251
820846107,63,66,98,83,50,36,11,13,420
820846108,38,63,76,76,66,50,10,10,389
820846109,53,71,105,98,69,51,12,15,474
820846110,56,102,103,88,47,17,4,3,420
820846111,63,123,88,75,47,20,6,3,425
820846112,34,48,86,80,42,21,20,10,341
820846113,62,68,51,53,28,16,4,5,287
820846114,27,50,75,77,49,48,11,17,354
820846115,44,74,129,123,103,66,21,26,586
820846201,21,48,52,56,23,18,9,5,232
820846202,30,35,31,31,30,17,3,4,181
820846203,25,41,32,40,27,18,4,5,192
820846204,54,51,50,57,32,23,6,7,280
820846205,59,65,81,84,69,34,10,10,412
820846206,58,75,87,79,62,29,11,21,422
820846207,44,88,98,93,66,34,16,10,449
820846208,72,91,87,73,43,20,5,8,399
820846209,39,59,72,96,51,45,11,19,392
820846210,36,56,76,110,47,26,13,14,378
820846211,33,65,69,66,31,26,8,11,309
820846212,32,71,68,61,40,32,8,11,323
820846213,56,77,90,80,61,48,8,6,426
820846214,31,56,58,47,36,5,3,2,238
820846215,46,69,44,59,21,8,1,5,253
820846216,30,79,73,75,56,26,10,8,357
820846217,60,81,77,109,77,48,14,19,485
820846218,63,96,100,111,67,36,11,15,499
820846219,63,83,56,46,29,6,1,3,287
820846220,36,50,54,45,40,15,8,4,252
820846221,43,62,62,60,46,24,6,6,309
820846301,37,57,83,90,61,51,15,15,409
820846302,32,69,95,91,65,30,18,16,416
820846303,34,68,78,85,64,36,17,19,401
820846304,28,58,57,58,39,33,5,8,286
820846305,34,42,47,62,21,15,7,7,235
820846306,50,91,86,92,43,24,13,4,403
820846307,40,74,72,78,36,31,7,8,346
820846308,39,56,94,81,40,41,16,12,379
820846309,41,56,72,62,39,22,20,21,333
820846310,58,65,72,83,70,35,13,16,412
820846311,53,57,123,150,84,66,9,23,565
820846312,21,50,54,44,47,24,10,14,264
820846313,34,43,85,90,66,42,27,25,412
820846401,28,30,26,33,9,10,5,1,142
820846402,50,74,59,63,31,18,5,7,307
820846403,17,33,49,67,30,17,6,4,223
820846404,63,96,82,90,33,17,5,4,390
820846405,20,12,15,15,7,5,3,5,82
820846406,22,30,47,55,27,10,5,2,198
820846501,67,99,91,103,55,28,5,13,461
820846502,37,60,54,92,41,16,3,2,305
820846503,64,135,127,127,67,38,7,11,576
820846504,50,68,39,52,22,9,2,2,244
820846505,92,168,146,132,60,29,4,7,638
820846601,34,58,53,72,43,24,6,8,298
820846602,121,185,210,164,91,48,23,22,864
820846701,24,45,15,27,16,7,0,0,134
820846702,2,3,6,3,1,1,0,1,17
820846703,3,3,5,5,1,2,0,0,19
820846704,55,68,46,53,35,10,1,5,273
820846801,36,35,43,50,19,8,6,5,202
820846802,22,40,32,36,27,9,10,9,185
820846901,11,18,10,15,6,1,1,2,64
820846902,54,83,77,83,34,14,1,0,346
820846903,74,86,77,66,36,14,4,1,358
820846904,67,115,125,124,59,49,16,30,585
820846905,38,46,44,41,23,11,3,3,209
820846906,60,81,81,76,36,16,6,1,357
820847001,6,4,4,2,0,0,0,0,16
820847002,45,57,38,28,14,3,1,2,188
820847101,0,2,3,1,1,0,0,0,7
820847102,13,27,24,12,10,5,3,0,94
820847201,4,12,7,13,5,3,2,2,48
820847202,121,128,77,90,32,15,3,4,470
820847203,44,84,83,82,38,15,4,9,359
820847204,44,47,40,41,20,4,1,2,199
820847205,6,18,18,14,8,6,4,2,76
820847206,41,51,56,60,25,7,10,2,252
820847207,61,91,75,76,22,11,7,2,345
820847301,15,35,34,25,17,6,4,9,145
820847302,16,27,26,26,5,6,1,1,108
820847401,14,31,17,21,4,5,2,2,96
820847402,54,68,48,57,23,10,3,4,267
820847501,0,5,1,2,0,1,1,0,10
820847502,1,2,5,3,1,0,0,0,12
820847503,25,32,33,30,9,5,0,1,135
820847504,35,34,37,22,12,7,2,5,154
820847601,4,16,5,1,2,1,0,0,29
820847602,11,24,20,15,5,2,3,1,81
820847701,7,12,14,11,6,4,1,1,56
820847702,9,13,10,21,10,4,2,1,70
820847703,15,19,19,26,12,6,2,1,100
820847704,28,38,46,48,29,19,13,7,228
820847705,23,63,73,102,40,12,6,1,320
820847706,3,5,2,6,2,0,0,0,18
820847707,1,0,1,2,0,0,0,0,4
820847708,56,83,89,73,36,7,6,6,356
820847709,54,90,70,61,24,19,4,4,326
820847710,57,77,80,72,30,18,3,1,338
820847711,47,64,84,83,51,23,13,14,379
820847712,55,74,73,96,32,18,2,4,354
820847713,69,93,70,80,51,18,5,4,390
820847714,56,64,40,49,19,6,0,0,234
820847715,41,48,43,42,16,5,1,0,196
820847716,41,70,75,62,27,8,1,4,288
820847717,54,50,46,46,28,10,4,5,243
820847718,58,53,95,81,68,57,26,40,478
820847719,59,68,71,68,46,9,3,4,328
820847720,75,98,80,74,28,18,3,1,377
820847721,58,80,87,100,36,11,6,0,378
820847722,69,85,54,47,31,6,2,1,295
820847723,80,96,114,96,55,10,2,2,455
820847724,49,68,60,51,34,8,0,0,270
820847725,55,71,57,55,28,14,3,1,284
820847801,5,3,2,1,0,0,0,0,11
820847802,15,24,22,24,13,6,1,4,109
820847803,47,72,53,59,43,6,1,3,284
820847804,46,96,79,72,32,10,7,2,344
820847805,21,33,30,31,27,7,4,11,164
820847806,36,72,78,73,35,15,6,6,321
820847807,61,68,75,68,43,11,4,5,335
820847901,2,2,0,4,0,0,0,0,8
820847902,1,5,14,15,4,4,0,0,43
820847903,3,9,4,6,3,1,2,3,31
820847904,1,2,0,1,0,0,0,0,4
820847905,64,88,68,61,18,9,2,3,313
820847906,75,76,63,55,38,17,2,10,336
820848001,128,102,71,52,23,4,0,2,382
820848002,98,110,64,56,21,6,3,3,361
820848003,107,113,61,46,19,3,2,1,352
820848004,131,125,46,29,13,5,0,0,349
820848005,76,73,53,45,22,8,0,0,277
820848006,55,57,40,45,12,5,0,0,214
820848007,83,87,36,29,8,3,4,0,250
820848008,163,143,61,36,19,7,2,1,432
820848009,115,108,75,47,18,3,1,0,367
820848010,85,94,37,36,5,3,1,1,262
820848011,45,54,38,32,5,2,0,0,176
820848012,64,60,22,27,8,6,1,0,188
820848013,86,101,57,43,19,6,1,2,315
820848014,54,87,46,39,17,4,1,1,249
820848015,74,68,50,39,10,5,3,1,250
820848016,73,94,55,46,21,5,2,1,297
820848017,92,89,50,45,20,9,0,0,305
820848018,48,59,46,46,17,4,1,2,223
820848019,81,67,53,41,17,7,0,1,267
820848020,69,100,66,56,19,5,1,1,317
820848021,66,56,47,36,20,8,1,1,235
820848022,147,119,43,25,5,0,1,0,340
820848101,59,93,73,52,37,13,4,0,331
820848102,52,83,43,45,20,5,1,0,249
820848103,53,81,37,39,14,6,0,1,231
820848104,52,65,49,41,20,4,1,0,232
820848105,49,60,53,40,15,5,1,1,224
820848106,62,77,44,55,7,4,2,0,251
820848107,56,67,55,54,19,8,0,1,260
820848108,55,66,38,41,22,4,6,1,233
820848109,66,93,73,56,27,12,1,1,329
820848110,72,80,61,56,27,15,5,2,318
820848111,64,63,49,39,8,4,0,1,228
820848112,67,90,66,52,17,6,2,1,301
820848113,66,74,43,35,13,3,0,1,235
820848114,47,61,45,36,14,7,2,1,213
820848115,28,27,10,29,6,2,1,0,103
820848116,86,89,64,66,34,9,1,1,350
820848117,57,81,63,46,14,5,3,2,271
820848118,43,69,69,62,24,8,1,1,277
820848119,60,102,57,50,16,14,5,5,309
820848120,48,70,61,46,18,17,5,1,266
820848121,46,72,39,35,17,5,4,0,218
820848201,36,73,129,108,58,49,11,8,472
820848202,38,59,78,96,53,32,10,13,379
820848203,31,69,81,93,60,28,11,7,380
820848204,28,44,82,78,60,43,15,21,371
820848205,46,77,85,53,28,23,7,7,326
820848206,44,87,71,66,28,16,7,5,324
820848207,41,86,94,78,39,21,5,6,370
820848208,50,89,118,96,55,37,12,11,468
820848209,59,92,123,129,82,59,16,19,579
820848210,41,70,105,124,71,53,12,20,496
820848211,45,75,87,85,67,30,10,12,411
820848212,37,57,85,74,45,30,18,21,367
820848213,58,87,102,124,63,49,18,16,517
820848214,44,87,80,87,62,19,5,3,387
820848215,38,57,66,63,42,27,8,9,310
820848216,39,73,69,88,59,19,8,2,357
820848301,56,100,77,72,25,18,4,0,352
820848302,55,91,94,75,39,17,3,3,377
820848303,62,93,51,56,17,4,3,3,289
820848304,65,98,69,73,35,8,2,6,356
820848305,56,109,73,55,15,8,2,2,320
820848306,66,75,52,57,30,10,4,0,294
820848307,53,89,70,47,18,11,1,1,290
820848308,73,106,75,69,29,6,4,2,364
820848309,40,60,43,44,12,3,0,1,203
820848310,48,53,44,38,16,5,0,1,205
820848311,62,97,71,71,19,14,0,0,334
820848312,59,63,51,44,20,6,2,2,247
820848313,42,55,61,41,24,15,5,5,248
820848314,64,87,76,80,31,21,5,2,366
820848315,55,74,65,65,24,11,3,0,297
820848401,47,33,68,54,47,34,18,19,320
820848402,50,73,66,73,47,19,6,8,342
820848403,40,108,109,144,57,24,3,6,491
820848404,60,114,114,114,70,40,3,10,525
820848405,57,61,68,43,26,9,5,1,270
820848406,43,69,61,50,30,22,3,4,282
820848407,19,18,38,44,26,11,7,2,165
820848408,43,71,69,84,25,15,4,6,317
820848409,57,133,146,120,54,36,7,9,562
820848410,83,97,129,128,64,28,15,13,557
820848411,39,68,106,159,76,18,9,2,477
820848412,44,106,129,181,73,32,8,13,586
820848413,85,59,102,83,60,57,17,20,483
820848414,13,35,66,75,54,39,13,23,318
820848415,32,46,60,55,39,20,5,3,260
820848416,12,9,16,13,9,9,5,5,78
820848501,47,76,106,121,78,69,22,32,551
820848502,46,54,79,85,61,57,13,23,418
820848503,29,66,71,60,40,30,12,9,317
820848504,30,40,46,64,27,23,10,13,253
820848505,42,61,52,44,25,8,5,5,242
820848506,43,59,44,48,17,4,4,2,221
820848507,40,71,58,52,33,16,2,3,275
820848508,47,78,63,50,20,9,1,6,274
820848509,28,43,51,55,41,28,7,15,268
820848510,50,82,87,85,55,44,9,9,421
820848511,41,59,59,73,16,21,2,5,276
820848512,59,84,84,86,57,38,11,4,423
820848513,36,53,79,75,54,43,11,4,355
820848514,33,60,83,95,71,32,16,19,409
820848515,23,55,62,53,45,24,8,8,278
820848516,21,42,56,55,30,23,6,2,235
820848601,44,61,54,45,28,29,8,6,275
820848602,87,120,90,87,48,17,9,3,461
820848603,51,72,73,64,42,23,6,4,335
820848604,58,87,68,71,26,20,0,6,336
820848605,62,87,90,69,46,31,7,11,403
820848606,72,82,99,114,65,32,10,10,484
820848607,57,111,119,124,55,37,14,21,538
820848608,47,61,55,57,52,24,6,7,309
820848609,34,73,88,86,53,24,8,7,373
820848610,88,114,142,137,94,55,19,21,670
820848611,37,49,67,77,49,38,6,9,332
820848701,16,39,19,21,7,3,1,1,107
820848702,60,68,60,50,21,10,5,0,274
820848703,31,72,71,53,19,8,5,1,260
820848704,88,112,110,52,21,6,5,1,395
820848705,39,69,71,64,37,8,2,0,290
820848706,84,127,126,120,52,29,8,5,551
820848707,60,107,119,107,40,16,2,1,452
820848708,62,116,84,95,40,19,10,8,434
820848709,32,85,74,62,37,25,5,8,328
820848710,46,92,82,77,49,21,3,6,376
820848711,41,50,50,33,27,14,6,7,228
820848712,31,59,56,50,29,13,2,6,246
820848713,46,72,56,69,30,20,2,2,297
820848714,34,50,62,58,20,8,4,2,238
820848715,22,61,41,49,22,8,1,4,208
820848801,39,57,102,76,60,37,7,16,394
820848802,34,65,80,66,43,37,9,8,342
820848803,51,67,63,57,26,4,3,1,272
820848804,65,89,65,51,22,7,4,1,304
820848805,40,61,70,72,27,20,10,2,302
820848806,42,61,97,94,54,38,9,14,409
820848807,38,74,90,102,76,50,18,27,475
820848808,70,116,69,56,24,11,3,0,349
820848809,34,62,58,78,28,4,0,2,266
820848810,77,95,88,62,30,10,1,1,364
820848811,78,116,89,116,54,12,1,1,467
820848812,44,64,74,78,50,47,6,15,378
820848813,30,62,80,55,32,24,12,10,305
820848814,37,87,49,63,22,6,1,4,269
820848815,24,58,56,43,38,23,9,11,262
820848816,47,89,79,90,46,20,5,12,388
820848817,49,52,53,64,31,31,5,10,295
820848901,44,61,67,60,15,10,3,2,262
820848902,43,74,103,103,51,40,9,11,434
820848903,47,65,103,146,85,38,25,17,526
820848904,41,57,87,71,39,28,14,13,350
820848905,39,90,102,91,58,19,6,8,413
820848906,50,58,39,56,24,4,2,3,236
820848907,42,56,62,68,29,11,2,1,271
820848908,19,17,42,33,15,15,7,7,155
820848909,44,70,103,103,45,41,12,14,432
820848910,48,93,136,126,72,40,23,17,555
820848911,42,100,179,200,137,76,39,29,802
820848912,49,96,160,180,134,62,17,17,715
820849001,13,45,51,48,22,8,0,1,188
820849002,51,95,111,124,71,32,17,22,523
820849003,57,91,91,122,59,28,13,6,467
820849004,51,67,63,56,36,11,4,2,290
820849005,35,47,42,45,20,6,2,2,199
820849006,12,16,31,24,11,3,1,1,99
820849007,60,95,118,129,61,47,6,10,526
820849008,31,73,64,62,27,12,3,1,273
820849009,29,42,24,27,11,6,2,1,142
820849010,43,77,65,79,28,11,4,6,313
820849011,44,86,99,94,36,7,4,3,373
820849012,36,94,77,75,29,11,2,1,325
820849013,49,56,37,66,22,8,1,4,243
820849501,0,1,1,1,0,0,0,0,3
820910101,53,32,34,29,24,15,7,9,203
820910102,84,102,79,61,31,15,10,1,383
820910103,75,78,62,44,27,11,8,3,308
820910104,23,25,20,34,14,10,5,7,138
820910105,30,28,21,25,15,7,2,3,131
820910106,28,28,20,17,7,5,2,1,108
820910107,46,72,47,45,17,20,6,0,253
820910108,20,26,27,28,18,5,3,1,128
820910109,19,22,11,8,10,2,2,2,76
820910110,6,10,8,9,5,5,1,2,46
820910111,14,17,10,15,14,10,6,2,88
820910112,54,51,50,36,31,19,7,14,262
820910113,54,86,60,46,43,18,4,7,318
820910201,17,16,12,10,4,6,0,3,68
820910202,13,21,11,17,7,4,2,1,76
820910203,40,26,18,23,17,13,3,5,145
820910204,11,10,14,11,8,4,1,2,61
820910205,3,2,2,0,1,1,0,1,10
820910206,38,34,17,22,13,6,1,3,134
820910207,12,17,12,12,13,8,13,18,105
820910208,2,3,5,3,6,1,0,1,21
820910209,24,16,13,12,14,6,4,3,92
820910210,12,8,9,8,9,5,0,3,54
820910211,40,52,38,26,23,8,8,10,205
820910212,10,10,9,5,1,1,0,0,36
820910213,21,3,3,9,3,7,1,3,50
820910214,48,75,64,59,34,17,11,12,320
820910216,5,5,8,5,5,1,0,0,29
820910217,20,23,29,20,16,11,3,3,125
820910218,2,8,7,10,9,2,1,0,39
820910301,8,10,13,23,13,7,1,2,77
820910302,60,89,65,47,22,12,5,3,303
820910303,19,27,35,27,18,7,4,13,150
820910304,61,76,107,95,71,52,6,14,482
820910305,17,27,44,49,30,17,8,7,199
820910306,36,62,69,70,58,41,11,9,356
820910307,10,12,13,27,10,16,6,4,98
820910308,62,78,60,51,22,9,1,0,283
820910309,47,63,36,28,17,11,3,1,206
820910310,67,113,79,66,37,10,1,1,374
820910311,35,62,39,27,13,7,2,0,185
820910312,83,100,93,90,55,33,10,18,482
820910313,45,76,75,57,38,15,3,1,310
820910314,41,59,66,80,53,17,11,10,337
820910315,19,21,31,25,25,21,3,4,149
820910316,0,1,0,2,0,1,0,0,4
820910317,100,112,105,93,50,29,4,6,499
820910318,45,66,79,78,38,21,3,5,335
820910319,61,81,56,41,27,6,4,3,279
820910320,51,46,44,47,22,15,6,6,237
820910321,61,89,78,73,23,16,6,5,351
820910322,75,110,102,79,38,16,10,8,438
820910323,70,63,34,32,17,5,2,2,225
820910401,15,21,22,37,15,13,5,2,130
820910402,20,18,15,10,7,7,0,3,80
820910403,28,44,33,13,22,10,2,11,163
820910404,18,22,26,18,16,4,3,1,108
820910405,3,5,3,3,6,1,1,2,24
820910406,9,10,3,4,8,1,3,1,39
820910407,6,13,6,2,5,4,1,0,37
820910408,87,90,47,48,31,17,4,5,329
820910409,33,52,25,18,13,4,2,1,148
820910410,59,66,54,40,36,23,8,8,294
820910411,12,10,17,17,9,10,2,2,79
820910412,4,5,7,8,4,3,0,4,35
820910413,3,5,4,4,3,9,1,1,30
820910414,9,8,9,6,6,4,0,2,44
820910415,15,11,16,18,10,6,3,2,81
820910501,71,61,58,48,31,18,1,8,296
820910502,76,105,67,56,33,12,2,2,353
820910503,46,57,56,48,31,20,9,6,273
820910504,96,104,68,56,25,8,3,1,361
820910505,126,165,128,144,60,28,6,5,662
820910506,74,107,73,52,20,10,4,2,342
820910507,101,151,175,145,90,44,15,23,744
820910508,84,123,96,109,59,29,16,11,527
820910509,63,87,104,102,59,38,14,22,489
820910510,17,14,18,14,14,6,3,2,88
820910511,32,23,22,23,17,13,4,7,141
820910512,38,38,34,33,22,16,10,7,198
820910513,67,64,75,64,33,13,4,5,325
820910601,65,105,101,88,59,38,18,12,486
820910602,95,76,50,47,27,15,7,5,322
820910603,86,102,64,45,17,10,5,2,331
820910604,44,72,37,37,17,9,3,4,223
820910605,81,86,49,37,17,1,1,1,273
820910606,74,78,49,34,12,3,1,1,252
820910607,47,60,28,33,19,4,1,0,192
820910608,83,100,89,71,56,40,19,18,476
820910609,60,78,55,55,35,19,10,13,325
820910610,74,107,83,73,45,29,7,12,430
820910611,98,107,71,56,22,14,3,2,373
820910612,101,131,101,87,40,22,14,14,510
820910613,47,37,37,29,22,10,8,9,199
820910614,68,68,54,24,18,6,2,1,241
820910615,35,37,34,26,19,12,7,7,177
820910616,43,57,39,22,10,3,1,0,175
820980101,3,9,4,3,2,2,0,1,24
820980102,4,7,3,4,1,0,0,0,19
820980103,2,1,1,1,0,0,0,2,7
820980104,2,4,4,4,1,2,0,2,19
820980105,10,13,7,6,3,1,1,0,41
820980106,1,6,3,6,3,0,0,0,19
820980107,3,1,4,1,5,0,1,0,15
820980108,23,26,16,22,12,5,2,5,111
820980109,2,4,1,1,1,2,0,0,11
820980110,4,13,7,2,1,1,1,1,30
820980111,5,16,6,3,5,2,1,1,39
820980112,9,11,11,7,5,2,3,0,48
820980113,76,66,62,42,22,9,4,3,284
820980114,73,84,91,66,41,26,4,10,395
820980115,6,11,4,6,4,1,0,0,32
820980116,5,6,10,4,6,4,1,4,40
820980117,10,13,10,6,7,5,4,0,55
820980118,95,101,83,85,35,16,3,4,422
820980119,49,41,55,47,38,16,20,14,280
820980120,56,67,52,40,26,6,2,3,252
820980121,68,77,80,89,46,25,17,14,416
820980122,56,50,68,54,46,31,15,19,339
820980201,11,19,14,16,10,6,2,0,78
820980202,10,9,11,5,2,2,0,1,40
820980203,35,38,51,41,23,21,8,11,228
820980204,6,7,2,5,1,1,0,1,23
820980205,44,30,30,27,13,11,6,5,166
820980206,58,50,53,47,42,12,8,14,284
820980207,75,86,76,86,41,22,20,13,419
820980301,3,5,3,4,2,0,0,0,17
820980302,28,25,40,23,13,12,12,8,161
820980303,10,1,3,1,0,0,0,0,15
820980304,17,20,32,17,11,12,4,8,121
820980305,25,14,10,10,5,5,2,2,73
820980306,7,18,9,9,6,3,1,0,53
820980307,2,1,5,4,1,1,0,0,14
820980308,4,10,6,8,5,3,1,6,43
820980309,8,9,6,6,2,3,2,4,40
820980310,29,31,36,35,22,16,6,5,180
820980311,54,94,110,99,73,34,12,21,497
820980312,19,12,20,17,12,12,9,8,109
820980313,10,9,3,3,7,4,4,3,43
820980314,9,10,11,8,1,6,1,0,46
820980315,16,24,21,18,12,4,4,2,101
820980316,84,94,149,145,121,97,37,65,792
820980401,64,67,75,58,33,24,10,11,342
820980402,49,79,57,58,45,20,7,13,328
820980403,64,47,43,42,17,10,6,2,231
820980404,34,44,45,35,25,10,10,12,215
820980405,57,41,58,48,34,17,3,5,263
820980406,57,56,55,42,15,17,1,2,245
820980407,37,67,62,63,31,19,8,10,297
820980408,64,54,45,40,23,8,4,1,239
820980409,47,55,40,36,20,8,2,3,211
820980410,50,45,55,53,38,19,10,21,291
821050101,12,19,25,21,16,8,4,8,113
821050102,38,38,34,42,11,11,5,9,188
821050103,40,42,56,54,37,19,9,9,266
821050104,11,12,11,11,5,1,0,0,51
821050105,73,75,49,54,29,9,8,2,299
821050106,5,5,3,6,2,3,0,0,24
821050107,21,25,37,30,18,8,3,3,145
821050108,47,45,55,31,26,21,9,21,255
821050109,35,29,42,37,23,16,6,11,199
821050110,31,39,49,34,33,26,3,8,223
821050111,55,57,43,33,22,9,5,5,229
821050112,43,58,64,46,34,19,8,7,279
821050113,10,9,3,11,4,1,0,0,38
821050114,57,59,48,42,30,10,8,8,262
821050115,56,68,52,61,35,21,6,8,307
821050116,53,61,50,50,30,20,5,9,278
821050117,90,91,56,39,14,12,1,1,304
821050118,46,64,56,41,28,5,6,2,248
821050119,63,66,57,52,26,15,3,6,288
821050120,45,95,67,59,36,21,7,10,340
821050121,30,37,32,52,23,16,8,7,205
821050201,10,8,14,10,5,3,4,2,56
821050202,3,7,6,5,5,1,0,0,27
821050203,12,5,4,5,4,2,0,0,32
821050204,10,26,13,12,10,4,0,3,78
821050205,5,15,17,8,5,2,1,0,53
821050206,9,10,7,9,11,10,0,2,58
821050207,3,5,1,4,5,0,1,1,20
821050208,2,10,2,4,10,3,0,0,31
821050209,15,14,11,11,11,6,3,2,73
821050210,12,19,13,10,13,3,1,1,72
821050211,23,23,14,18,9,3,1,1,92
821050212,64,75,51,66,24,8,3,4,295
821050213,110,123,99,93,39,10,8,6,488
821050214,72,103,81,81,41,28,8,7,421
821050215,11,26,14,17,8,2,0,0,78
821050216,7,9,4,5,1,0,1,1,28
821050217,72,80,57,51,21,9,3,4,297
821050218,57,61,64,55,27,12,5,12,293
821050219,17,13,7,9,5,3,1,1,56
821050220,48,56,51,41,19,6,2,2,225
821050221,72,106,69,72,39,18,4,9,389
821050222,75,86,71,70,48,14,5,11,380
821050223,40,52,43,44,22,9,3,0,213
821050224,50,72,66,55,34,21,7,7,312
821050225,37,46,22,27,5,4,0,0,141
821050226,46,60,44,35,15,7,2,1,210
821050227,59,65,45,44,25,3,5,4,250
821050228,62,66,74,77,43,35,9,13,379
821050229,47,74,44,38,14,5,1,0,223
821050230,49,69,44,41,21,11,3,1,239
821050231,48,56,42,50,40,23,9,7,275
821050301,68,121,108,111,89,56,31,35,619
821050302,49,60,59,76,48,14,9,14,329
821050303,104,101,70,41,20,8,6,2,352
821050304,67,68,47,43,19,2,1,1,248
821050305,93,81,49,33,22,8,0,4,290
821050306,57,84,93,90,50,22,7,8,411
821050307,64,58,48,46,26,9,1,0,252
821050308,83,105,76,68,45,19,7,6,409
821050309,2,1,3,5,2,2,1,1,17
821050310,56,83,113,97,63,39,17,21,489
821050311,57,45,44,43,30,11,0,4,234
821050312,57,76,56,38,21,8,3,2,261
821050313,37,50,48,40,22,9,4,0,210
821050314,38,59,50,48,31,9,6,1,242
821050315,20,31,33,24,16,14,1,2,141
821050316,41,55,94,64,34,16,8,10,322
821050401,44,64,76,70,54,30,12,5,355
821050402,63,87,59,52,16,7,5,2,291
821050403,83,91,57,42,19,7,0,0,299
821050404,65,90,54,28,16,3,0,0,256
821050405,48,56,54,46,17,11,2,1,235
821050406,88,88,47,30,11,2,0,0,266
821050407,72,110,86,71,29,15,4,2,389
821050408,68,88,53,29,9,2,1,0,250
821050409,101,91,67,59,28,4,0,1,351
821050410,52,90,88,99,41,16,7,4,397
821050411,83,76,52,34,14,8,2,1,270
821050412,92,117,71,76,32,14,5,2,409
821050413,60,78,70,61,32,27,17,10,355
821050414,69,92,92,104,46,24,8,9,444
821050415,33,67,64,61,31,20,4,4,284
821050416,47,69,62,65,41,24,12,6,326
821050417,39,64,56,51,21,9,6,3,249
821050418,60,84,50,52,16,0,0,1,263
821050419,59,141,102,119,45,18,2,3,489
821050420,52,77,54,53,22,7,6,1,272
821050501,8,10,9,7,6,4,1,2,47
821050502,71,94,65,62,36,17,7,4,356
821050503,37,37,27,36,26,8,4,8,183
821050504,45,47,32,18,16,6,6,2,172
821050505,69,85,61,45,21,14,4,3,302
821050506,71,100,57,61,19,16,8,6,338
821050507,28,27,22,21,19,10,5,6,138
821050508,54,54,55,70,35,18,10,10,306
821050509,50,38,49,29,23,18,7,4,218
821050510,6,8,5,9,2,0,2,0,32
821050511,34,56,68,56,31,22,10,12,289
821050512,51,57,43,46,30,10,6,4,247
821050513,79,121,69,88,29,19,7,5,417
821050514,80,81,65,69,38,16,9,8,366
821050515,56,49,57,27,20,12,3,0,224
821050516,36,45,62,50,18,13,1,3,228
821050517,31,31,33,35,31,12,8,17,198
821120101,25,44,30,22,21,13,2,7,164
821120102,19,19,8,8,3,6,1,0,64
821120103,77,67,67,48,40,12,5,9,325
821120104,27,38,38,21,20,18,8,7,177
821120105,56,61,64,44,29,16,9,11,290
821120106,5,14,7,11,7,1,2,2,49
821120107,6,13,16,7,5,6,2,2,57
821120108,67,61,54,50,18,7,3,3,263
821120201,4,6,2,6,1,1,0,0,20
821120202,7,9,4,13,6,0,2,1,42
821120203,40,44,53,62,33,19,12,13,276
821120204,14,17,11,17,15,10,6,18,108
821120205,33,35,38,22,16,12,8,5,169
821120206,22,22,19,19,16,6,3,3,110
821120207,48,52,32,20,11,16,4,5,188
821120208,57,54,40,48,17,12,6,3,237
821120209,78,114,88,98,40,22,10,13,463
821120210,69,97,76,69,29,9,8,1,358
821120211,6,14,10,15,5,2,0,0,52
821120212,8,8,8,5,4,3,0,2,38
821120213,14,17,10,8,5,2,0,1,57
821120214,2,6,2,3,2,2,1,0,18
821120215,3,6,8,0,2,1,0,0,20
821120216,13,19,18,16,11,10,8,3,98
821120217,48,51,52,50,28,16,11,14,270
821120218,68,77,71,60,40,21,16,8,361
821120219,67,74,72,56,20,7,0,1,297
821120301,8,14,10,11,6,1,1,1,52
821120302,14,5,5,9,3,6,0,1,43
821120303,27,32,40,46,21,7,3,3,179
821120304,2,3,4,2,2,1,1,1,16
821120305,9,5,3,8,2,2,1,1,31
821120306,9,11,6,9,9,2,0,1,47
821120307,18,20,13,8,8,6,2,2,77
821120308,5,1,5,3,0,1,0,0,15
821120309,8,8,3,8,2,1,0,0,30
821120310,17,22,26,25,7,3,2,4,106
821120311,97,95,43,47,16,4,1,1,304
821120312,20,28,20,16,9,4,2,5,104
821120313,16,26,18,8,7,6,1,1,83
821120314,79,90,72,78,46,23,8,10,406
821120315,5,4,5,4,1,0,0,0,19
821120316,48,66,66,68,31,17,0,1,297
821120401,48,81,101,87,58,33,12,26,446
821120402,51,65,58,48,19,8,2,2,253
821120403,58,74,25,33,16,1,1,0,208
821120404,106,121,77,52,19,6,0,2,383
821120405,74,67,81,88,58,42,20,29,459
821120406,64,69,75,73,51,35,14,18,399
821120407,66,87,58,61,38,18,7,5,340
821120408,79,124,69,36,20,9,4,1,342
821120409,76,90,61,43,12,5,0,0,287
821120410,120,139,61,38,31,6,3,0,398
821120411,81,70,38,35,12,7,1,0,244
821120412,79,107,105,81,44,24,6,6,452
821120413,78,91,120,112,66,60,23,41,591
821120414,77,91,57,49,21,5,1,4,305
821120415,82,161,98,82,40,11,2,1,477
821120416,51,94,58,57,26,11,1,1,299
821120417,51,70,52,31,11,2,0,0,217
821120418,25,52,57,42,29,20,7,8,240
821120419,67,71,72,92,48,21,10,12,393
821190101,41,34,32,40,19,9,7,4,186
821190102,85,105,109,134,81,29,26,26,595
821190103,3,9,10,5,5,3,2,3,40
821190104,41,56,62,60,19,19,4,3,264
821190105,57,114,95,84,58,25,12,11,456
821190106,69,118,80,72,35,19,2,4,399
821190107,46,45,33,28,14,11,4,2,183
821190108,60,71,64,44,30,8,3,5,285
821190109,33,42,52,45,13,6,2,2,195
821190110,57,83,90,126,50,22,6,1,435
821190111,57,55,48,57,24,13,5,7,266
821190112,7,11,7,12,3,4,2,1,47
821190113,1,3,2,5,0,1,0,0,12
821190114,2,0,0,0,0,0,0,0,2
821190115,6,8,9,5,7,2,1,2,40
821190116,11,6,9,12,4,1,1,1,45
821190117,55,93,82,96,62,23,12,14,437
821190118,30,45,55,48,31,23,7,9,248
821190119,30,53,72,61,55,37,7,13,328
821190120,58,128,201,254,174,85,43,31,974
821190121,41,81,106,149,81,56,28,21,563
821190122,21,39,58,83,46,19,13,8,287
821190201,78,80,78,67,41,25,8,7,384
821190202,65,85,104,106,51,15,14,6,446
821190203,67,105,107,103,42,17,5,4,450
821190204,71,91,81,62,31,11,0,1,348
821190205,69,118,70,82,33,8,4,1,385
821190206,75,99,83,78,29,5,4,0,373
821190207,49,65,45,26,13,6,0,0,204
821190208,45,69,44,53,19,5,0,1,236
821190209,49,66,51,48,17,7,1,0,239
821190301,11,12,9,12,9,9,3,3,68
821190302,61,92,113,119,63,35,12,15,510
821190303,55,82,47,52,17,9,3,0,265
821190304,75,153,119,75,43,20,4,2,491
821190305,35,55,51,65,21,2,2,0,231
821190306,44,65,61,63,42,21,8,9,313
821190307,26,47,37,37,23,16,2,5,193
821190308,90,105,141,145,92,51,17,25,666
821190309,45,74,54,57,21,13,2,4,270
821190310,24,22,37,37,24,15,4,7,170
821190311,42,51,59,59,31,18,2,5,267
821190312,45,45,68,62,46,17,12,9,304
821190313,36,55,63,53,23,24,6,7,267
821190314,41,71,57,61,42,20,3,9,304
821190315,3,5,9,4,1,3,0,2,27
821190401,4,5,15,6,5,5,0,3,43
821190402,41,66,64,51,33,23,14,16,308
821190403,55,80,75,75,38,18,4,12,357
821190404,45,74,67,67,37,17,2,2,311
821190405,5,15,17,21,7,4,0,1,70
821190406,17,43,53,55,50,31,10,9,268
821190407,18,50,77,68,58,38,13,11,333
821190408,55,81,85,71,47,18,10,3,370
821190409,62,130,101,96,56,27,4,15,491
821190410,54,88,85,73,41,11,6,1,359
821190411,5,23,33,16,6,6,2,1,92
821190412,45,69,64,59,29,15,9,7,297
821190413,29,60,73,88,58,30,15,16,369
821190414,56,95,104,122,92,47,20,18,554
821190415,46,83,90,90,56,33,8,13,419
821190416,47,66,64,73,30,14,9,5,308
821190417,81,115,121,92,57,30,11,8,515
821190418,46,56,67,40,21,3,1,0,234
821190419,70,92,84,64,34,6,3,0,353
821190420,41,66,64,52,37,27,4,3,294
821190422,46,99,78,64,32,12,5,4,340
821190423,26,45,49,57,28,20,6,6,237
821190424,65,66,67,69,25,26,5,5,328
821190425,46,65,71,59,22,8,0,3,274
821190426,55,42,66,61,59,36,12,20,351
821190501,8,14,11,5,5,2,0,0,45
821190502,76,87,78,85,40,19,7,9,401
821190503,82,107,83,113,42,16,7,0,450
821190504,15,20,11,21,4,7,3,0,81
821190505,0,1,0,0,0,0,0,0,1
821190506,9,11,17,19,4,4,2,3,69
821190507,55,83,96,88,73,39,17,17,468
821190508,40,62,66,64,32,24,3,9,300
821190509,51,76,52,46,26,9,3,0,263
821190510,44,93,76,92,54,31,9,18,417
821190511,65,90,62,83,39,18,3,3,363
821190512,32,61,41,41,22,16,2,3,218
821190513,50,70,42,50,35,12,4,4,267
821190514,57,71,74,84,41,24,6,5,362
821190515,68,103,115,112,62,46,16,18,540
821190516,18,43,26,22,7,1,0,2,119
821190517,39,37,32,60,24,6,0,3,201
821190518,16,74,41,45,18,12,1,4,211
821190519,44,103,100,85,46,21,2,5,406
821190601,17,20,19,20,13,5,1,3,98
821190602,61,72,47,46,30,12,1,0,269
821190603,75,100,120,99,60,24,9,8,495
821190604,56,73,66,69,21,10,1,1,297
821190605,3,1,5,2,4,1,1,1,18
821190606,49,54,47,41,29,5,0,1,226
821190607,6,4,2,2,1,1,0,1,17
821190608,80,137,103,136,49,14,2,1,522
821190609,79,96,91,98,34,20,1,0,419
821190610,14,15,7,8,2,6,2,0,54
821190611,60,92,79,59,27,11,1,2,331
821190612,73,94,66,79,37,16,4,3,372
821190613,5,7,4,1,1,1,2,0,21
821190614,46,87,71,67,34,15,6,0,326
821190701,61,72,75,91,40,25,10,13,387
821190702,60,78,79,84,60,37,8,13,419
821190703,43,70,71,93,48,26,12,9,372
821190704,58,73,64,75,32,18,7,4,331
821190705,67,97,90,91,43,22,11,9,430
821190706,71,84,63,71,28,7,1,2,327
821190707,39,55,34,41,14,3,0,2,188
821190708,60,68,60,66,30,10,2,1,297
821190709,39,68,77,68,28,7,4,6,297
821190710,35,65,59,85,27,4,2,0,277
821190711,56,44,37,43,17,10,1,0,208
821190712,53,70,70,62,21,3,3,2,284
821190713,15,19,18,22,8,5,1,2,90
821190714,52,67,60,54,20,11,2,2,268
821190715,67,76,90,114,67,46,19,20,499
821190716,51,72,78,91,35,24,11,7,369
821190801,51,68,73,79,36,15,4,4,330
821190802,55,113,109,113,41,21,10,4,466
821190803,73,102,78,69,29,13,4,1,369
821190804,79,86,61,58,36,12,1,0,333
821190805,50,80,112,113,81,55,26,14,531
821190806,35,57,49,39,9,7,3,4,203
821190807,48,58,70,90,46,18,7,0,337
821190808,77,89,65,79,38,23,1,3,375
821190809,66,74,61,49,19,13,5,0,287
821190810,82,91,69,69,24,6,2,1,344
821190811,38,64,54,36,21,15,6,5,239
821190812,37,46,39,36,17,5,1,1,182
821190813,68,69,73,51,38,21,5,4,329
821190814,43,83,87,68,60,36,6,9,392
821190815,63,95,90,67,46,34,6,2,403
821190816,75,73,83,57,26,16,2,2,334
821190817,13,8,14,7,5,7,3,2,59
821190818,57,66,50,40,24,11,2,1,251
821190901,2,10,6,3,4,3,1,1,30
821190902,49,36,47,42,37,29,6,14,260
821190903,37,52,64,56,33,18,5,14,279
821190904,40,84,48,57,22,13,1,2,267
821190905,25,32,48,62,26,16,2,5,216
821190906,79,93,108,135,57,32,4,10,518
821190907,39,76,63,52,35,8,1,1,275
821190908,44,63,54,57,9,13,0,1,241
821190909,38,64,57,52,18,11,4,4,248
821190910,43,58,24,31,12,7,3,1,179
821190911,39,58,33,36,18,4,3,0,191
821190912,31,63,52,41,24,8,3,1,223
821190913,46,102,95,109,68,54,11,18,503
821190914,8,11,8,13,3,4,0,0,47
821191001,45,68,44,54,18,4,1,0,234
821191002,64,58,33,39,21,4,1,1,221
821191003,55,72,46,43,12,5,1,1,235
821191004,41,68,56,57,41,10,6,1,280
821191005,66,77,54,44,27,10,2,1,281
821191006,54,53,53,54,33,14,11,9,281
821191007,52,55,83,93,54,39,6,17,399
821191008,76,92,53,49,17,2,3,1,293
821191009,59,82,53,40,15,7,0,2,258
821191010,36,58,32,25,10,4,1,0,166
821191011,68,85,65,56,20,3,1,1,299
821191012,95,104,67,59,29,7,4,2,367
821191013,46,59,52,74,37,7,2,1,278
821191014,46,76,45,26,14,6,2,0,215
821199301,5,4,3,5,2,1,0,1,21
821199401,0,3,0,1,0,0,0,0,4
821199402,2,1,1,1,0,0,0,0,5
821199403,3,1,1,0,0,0,0,0,5
821199601,0,1,0,1,0,0,0,0,2
821199701,1,0,0,1,0,0,0,0,2
821260101,36,61,43,38,21,8,2,1,210
821260102,18,12,17,11,8,2,6,4,78
821260103,14,26,27,28,18,4,3,3,123
821260104,81,94,45,63,26,6,2,4,321
821260105,23,20,25,24,14,12,4,4,126
821260106,95,108,85,73,30,11,5,4,411
821260107,53,88,61,59,39,19,10,8,337
821260108,90,121,71,55,34,15,5,3,394
821260109,78,84,43,30,11,3,0,1,250
821260110,75,92,51,36,17,5,2,2,280
821260111,11,15,6,11,5,4,1,0,53
821260112,21,16,12,15,15,7,4,3,93
821260113,7,10,7,13,9,5,8,5,64
821260114,63,64,50,27,14,9,3,1,231
821260201,83,95,80,81,28,18,6,1,392
821260202,88,91,64,49,23,5,6,5,331
821260203,7,7,1,3,3,1,0,1,23
821260204,5,19,18,16,5,9,6,2,80
821260205,11,8,7,9,8,3,3,1,50
821260206,43,57,38,37,17,20,4,9,225
821260207,60,113,91,69,38,17,9,3,400
821260208,104,127,112,95,27,14,4,7,490
821260209,95,108,83,44,24,8,0,0,362
821260210,95,124,92,65,56,19,9,12,472
821260211,5,6,7,8,4,2,2,2,36
821260212,13,9,13,9,12,5,0,0,61
821260213,9,14,14,13,9,6,0,1,66
821260214,7,9,4,9,5,2,1,1,38
821260215,7,17,20,20,20,8,2,5,99
821260216,6,8,9,11,5,2,1,2,44
821260217,79,98,80,71,31,16,8,4,387
821260301,13,16,21,10,13,4,3,4,84
821260302,80,112,79,62,27,5,1,0,366
821260303,61,101,70,63,45,6,3,0,349
821260304,60,79,74,70,40,22,7,11,363
821260305,19,31,28,23,11,13,3,3,131
821260306,15,21,23,15,10,6,1,0,91
821260307,89,81,78,79,34,20,6,3,390
821260308,28,36,30,37,30,10,6,8,185
821260309,66,84,74,79,20,20,7,6,356
821260310,64,84,43,46,14,5,2,1,259
821260311,103,108,74,63,25,7,2,2,384
821260312,83,74,50,34,10,6,2,2,261
821260313,69,90,104,100,53,25,10,7,458
821260314,58,74,82,62,48,12,5,3,344
821260315,66,72,61,57,17,5,2,0,280
821260316,52,56,41,28,8,8,1,0,194
821260317,97,103,107,98,40,12,5,3,465
821260318,52,73,48,46,18,4,0,1,242
821260319,52,81,79,75,39,18,6,8,358
821260401,116,113,78,71,44,13,6,6,447
821260402,8,16,20,16,7,2,4,1,74
821260403,4,24,14,12,7,2,0,1,64
821260404,93,152,62,70,36,12,0,0,425
821260405,65,87,68,61,32,15,13,4,345
821260406,88,108,73,81,29,15,4,1,399
821260407,21,34,53,41,30,14,4,8,205
821260408,79,79,50,49,18,12,4,3,294
821260409,80,144,129,82,51,20,5,6,517
821260410,88,76,46,37,22,8,0,1,278
821260411,98,118,97,102,54,16,7,1,493
821260501,49,59,52,36,14,8,1,3,222
821260502,62,68,64,49,26,23,7,6,305
821260503,68,83,78,73,53,18,7,4,384
821260504,95,94,63,43,18,5,2,0,320
821260505,99,86,61,40,22,12,2,0,322
821260506,83,117,112,110,78,33,13,20,566
821260507,100,92,46,47,18,5,3,1,312
821260508,102,92,50,32,15,4,2,0,297
821260509,52,72,67,59,41,26,8,10,335
821260510,64,85,70,58,35,16,4,1,333
821260511,83,128,92,64,22,10,1,2,402
821260512,78,108,69,86,36,14,2,3,396
821260513,39,78,52,51,38,7,2,1,268
821260514,30,75,50,58,41,23,6,7,290
821260515,38,73,59,67,35,30,7,3,312
821260516,67,95,80,75,25,14,7,7,370
821260517,62,96,91,83,42,24,5,8,411
821330101,4,7,5,2,2,0,2,0,22
821330102,14,9,9,3,1,0,2,3,41
821330103,4,3,3,0,1,0,0,0,11
821330104,10,5,7,0,1,1,0,0,24
821330105,6,0,0,3,1,8,0,0,18
821330106,1,1,0,1,0,0,0,0,3
821330107,14,13,15,6,6,4,3,4,65
821330108,5,3,5,2,3,2,2,2,24
821330109,2,1,0,0,0,0,0,0,3
821330110,0,0,0,0,0,0,0,0,0
821330201,51,57,50,45,26,31,16,13,289
821330202,7,3,6,7,2,1,0,0,26
821330203,0,1,2,1,2,0,0,0,6
821330204,26,33,29,22,25,15,4,1,155
821330205,0,1,2,0,0,0,0,1,4
821330206,15,7,10,23,16,4,5,5,85
821330207,6,8,7,6,2,6,2,0,37
821330208,2,0,1,0,2,0,0,0,5
821330209,15,18,23,14,11,10,0,4,95
821330210,1,0,0,1,1,1,1,0,5
821330211,10,9,9,12,6,3,0,2,51
821330212,71,70,81,82,42,36,25,22,429
821330213,45,35,56,45,35,23,9,18,266
821330214,5,10,8,5,6,4,0,2,40
821330215,10,7,11,5,7,5,1,5,51
821330216,7,1,2,1,6,4,2,3,26
821330217,5,4,7,1,0,0,1,0,18
821330218,7,2,9,3,2,4,0,2,29
821330219,44,41,36,61,33,25,9,15,264
821330220,0,0,1,1,1,0,0,0,3
821330301,3,1,2,1,0,0,1,0,8
821330302,0,0,0,0,0,0,0,0,0
821330303,10,10,10,12,11,3,0,3,59
821330304,4,2,2,3,0,0,0,2,13
821330305,0,3,2,3,4,0,0,0,12
821330306,1,0,0,0,0,0,0,0,1
821330307,16,12,5,3,2,0,0,1,39
821330308,17,8,14,14,5,3,0,0,61
821330309,4,2,2,2,2,2,1,0,15
821330310,8,6,11,7,4,3,1,3,43
821330311,15,23,24,23,18,11,3,5,122
821330312,19,12,12,12,13,5,0,3,76
821330313,76,67,94,88,70,57,20,32,504
821330314,12,13,13,9,8,4,1,6,66
821330315,4,3,5,4,4,1,0,1,22
821330316,2,2,1,4,2,2,1,3,17
821330317,5,3,4,3,2,1,2,0,20
821330318,10,9,10,5,2,3,1,4,44
821330401,47,49,70,57,62,46,21,31,383
821330402,60,65,65,71,33,20,11,12,337
821330403,33,51,57,40,30,14,5,14,244
821330404,52,80,83,80,36,30,5,9,375
821330405,79,98,69,64,22,14,3,0,349
821330406,43,53,70,64,29,24,2,12,297
821330407,51,55,72,31,17,9,2,0,237
821330408,41,51,32,25,11,3,1,1,165
821330409,52,71,67,45,33,16,3,5,292
821330410,71,68,79,85,48,35,14,10,410
821330411,42,82,50,38,20,10,3,3,248
821330412,69,75,80,69,27,14,14,6,354
821330413,53,49,64,56,39,22,9,15,307
821330414,39,60,57,43,25,18,11,12,265
821330415,53,72,91,92,87,68,17,49,529
821330416,35,43,47,62,38,26,11,19,281
821330417,31,65,96,98,47,27,4,6,374
821330501,6,4,8,9,4,2,2,6,41
821330502,3,4,5,4,1,1,0,4,22
821330503,2,2,1,2,1,0,0,1,9
821330504,25,11,19,18,13,9,4,10,109
821330505,8,11,12,8,5,11,6,4,65
821330506,0,0,1,0,0,1,0,0,2
821330507,1,1,0,2,0,0,0,0,4
821330508,0,4,1,0,2,0,0,0,7
821330509,11,10,13,8,11,4,0,2,59
821330510,6,6,1,0,2,0,0,1,16
821330511,17,8,18,5,10,9,1,6,74
821330512,5,3,9,2,0,0,1,1,21
821330513,5,1,0,0,0,2,0,0,8
821330514,12,3,8,5,6,5,0,0,39
821330515,5,5,4,5,0,3,0,0,22
821330516,4,2,3,0,2,0,1,0,12
821330517,26,26,25,15,10,13,3,3,121
821330518,9,10,16,9,3,5,1,1,54
821330519,0,0,0,0,0,0,0,0,0
821330520,4,5,2,2,0,1,1,0,15
821330521,0,0,0,0,0,0,0,0,0
821330522,13,7,5,9,4,1,1,1,41
821330523,4,4,4,3,5,2,2,2,26
821330524,15,5,3,5,5,1,0,0,34
821330525,17,5,7,5,7,0,0,0,41
821330526,8,1,2,1,0,0,1,0,13
821330527,5,3,3,3,2,2,1,0,19
821330528,10,10,8,8,3,6,3,6,54
821330529,6,1,1,1,0,1,0,0,10
821330530,3,3,3,2,3,0,1,0,15
821330531,2,5,1,2,2,1,0,0,13
821330532,1,5,2,1,1,2,0,0,12
821330533,69,64,66,64,48,13,6,11,341
821330534,43,55,47,42,28,20,8,8,251
821330601,3,3,2,1,2,0,1,0,12
821330602,6,13,16,8,7,10,7,7,74
821330603,16,23,13,30,4,12,3,9,110
821330604,108,153,125,86,37,18,4,7,538
821330605,80,82,72,76,48,28,19,14,419
821330606,0,4,2,1,3,0,0,0,10
821330607,1,0,1,2,2,0,0,0,6
821330608,11,20,23,22,16,6,1,2,101
821330609,1,2,3,3,0,0,1,0,10
821330610,1,4,2,7,3,3,0,1,21
821330611,4,2,1,0,1,0,0,0,8
821330612,3,2,1,1,2,1,1,0,11
821330613,1,7,3,3,0,2,0,0,16
821330614,10,6,8,6,5,2,2,1,40
821330615,0,3,2,1,0,2,0,0,8
821330616,2,2,1,0,0,0,0,1,6
821330617,41,50,59,57,37,26,4,20,294
821330618,35,53,72,58,46,19,7,15,305
821330619,90,136,132,127,70,36,11,8,610
821330620,75,80,89,99,74,38,24,31,510
821330621,73,85,53,42,21,10,3,2,289
821330622,0,3,2,7,5,3,0,0,20
821330623,4,6,5,4,1,2,1,0,23
821330624,3,5,2,5,0,0,0,1,16
821330625,3,1,1,1,3,0,0,0,9
821330626,7,3,3,1,2,1,1,0,18
821330627,3,2,2,2,3,0,1,1,14
821330628,2,2,2,1,1,0,1,0,9
821330629,60,66,97,92,70,36,21,33,475
821330630,47,63,52,62,23,11,5,3,266
821330631,45,70,56,59,23,8,5,8,274
860070101,5,5,6,7,7,3,3,2,38
860070102,15,18,9,17,5,7,7,7,85
860070103,40,21,20,18,19,12,7,9,146
860070104,12,15,10,18,16,11,4,21,107
860070105,26,40,42,36,20,21,4,7,196
860070106,54,77,76,66,37,30,15,16,371
860070107,48,47,76,76,45,31,13,25,361
860070108,46,43,48,51,42,24,15,12,281
860070201,2,1,3,1,1,1,0,0,9
860070202,2,10,6,1,3,2,2,2,28
860070203,11,9,11,5,2,4,0,3,45
860070204,2,2,1,0,1,0,0,0,6
860070205,4,1,1,0,0,0,0,1,7
860070206,55,57,70,59,26,24,4,12,307
860070301,2,0,2,3,0,1,0,0,8
860070302,7,5,4,4,1,2,0,0,23
860070303,14,8,7,3,0,0,1,0,33
860070304,7,9,8,6,5,1,0,0,36
860140101,20,31,33,30,43,33,22,40,252
860140102,9,6,16,8,9,21,1,4,74
860140103,6,17,18,11,13,17,6,16,104
860140201,8,7,7,13,16,12,0,0,63
860140202,18,25,23,29,16,24,6,20,161
860140203,5,4,8,5,4,7,2,8,43
860140301,14,9,10,5,9,8,0,4,59
860140302,1,4,0,4,0,1,0,0,10
860140401,8,3,3,3,1,0,1,1,20
860140402,7,14,11,9,7,2,2,5,57
860140501,8,6,8,8,3,3,0,3,39
860140502,77,35,58,38,39,21,10,28,306
860140503,22,34,59,55,31,23,7,15,246
860140504,24,24,37,60,39,24,14,27,249
860140601,2,3,6,1,3,2,4,1,22
860140602,3,7,7,10,9,9,4,10,59
860140603,24,19,13,18,12,13,10,20,129
860140701,2,0,0,1,0,0,0,0,3
860140702,41,34,54,36,35,36,13,41,290
860140703,45,51,38,64,50,27,16,44,335
860140704,41,56,47,54,62,54,14,44,372
860140705,37,37,55,51,42,37,15,34,308
860140706,32,49,52,64,50,38,27,38,350
860140801,4,8,15,10,12,7,3,6,65
860140802,5,10,8,5,7,2,2,4,43
860140901,24,17,27,25,31,23,13,8,168
860140902,13,20,22,12,7,9,2,4,89
860140903,5,13,14,9,4,9,5,5,64
860210101,7,5,4,3,2,4,3,3,31
860210102,9,8,6,8,6,8,4,9,58
860210103,24,27,26,16,17,15,6,16,147
860210104,22,23,22,17,18,11,4,9,126
860210105,8,7,7,7,4,2,1,1,37
860210201,48,51,61,56,54,47,19,41,377
860210202,21,31,29,43,47,63,21,56,311
860210203,3,8,5,5,7,5,2,3,38
860210204,16,22,32,23,22,28,12,30,185
860210205,10,9,6,11,8,11,10,12,77
860210206,27,24,31,24,20,13,8,8,155
860210207,33,30,37,50,43,29,7,20,249
860210208,39,40,50,52,39,21,15,13,269
860210209,24,21,54,47,37,26,14,33,256
860210301,5,4,9,10,10,5,5,4,52
860210302,9,14,15,7,3,4,1,2,55
860210303,2,5,3,4,1,2,0,1,18
860210304,11,7,5,5,9,2,0,4,43
860210305,2,1,2,1,3,0,0,1,10
860210306,4,7,6,0,4,0,1,4,26
860280101,9,15,9,13,9,12,7,21,95
860280102,19,26,11,16,18,11,2,5,108
860280103,14,21,4,6,7,5,7,6,70
860280104,14,10,15,11,8,5,2,9,74
860280201,10,5,7,6,8,6,0,11,53
860280202,4,5,7,3,4,4,2,5,34
860280203,11,16,12,15,16,12,6,16,104
860280204,17,6,9,6,10,5,2,5,60
860280205,16,16,11,12,6,8,3,10,82
860280206,20,20,31,25,20,20,21,27,184
860280207,40,53,57,51,37,19,17,30,304
860280301,25,21,31,25,18,20,14,27,181
860280302,18,22,12,24,20,19,10,19,144
860280303,26,10,11,9,10,9,3,10,88
860280304,31,45,43,38,53,25,10,16,261
860280305,30,29,31,38,36,20,12,15,211
860280401,12,8,16,12,15,16,11,7,97
860280402,10,4,10,7,5,7,4,11,58
860280403,24,34,19,24,29,19,12,29,190
860280404,26,16,19,19,15,6,7,18,126
860280405,19,13,11,15,20,16,6,16,116
860280406,29,27,24,40,43,34,17,30,244
860280407,35,51,38,39,28,28,12,14,245
860280408,51,71,79,71,54,41,15,37,419
860280409,47,56,82,72,48,29,15,29,378
860280410,22,44,49,41,34,21,14,24,249
860280501,17,17,27,18,22,14,11,20,146
860280502,21,15,16,18,21,16,11,18,136
860280503,16,6,12,15,14,9,11,17,100
860280504,34,50,63,53,62,34,18,26,340
860350101,10,10,7,12,7,8,1,12,67
860350102,7,17,13,15,9,4,4,9,78
860350201,3,7,13,12,7,3,3,5,53
860350202,2,3,4,2,6,4,3,4,28
860350203,13,22,15,25,28,16,7,26,152
860350301,6,7,6,3,6,8,1,3,40
860350302,8,6,2,3,2,2,0,0,23
860350303,7,11,7,9,4,3,3,5,49
860350401,21,31,23,23,18,7,5,16,144
860350402,24,16,16,19,11,9,7,26,128
860350501,26,34,28,31,16,9,1,11,156
860350502,29,19,18,20,16,5,5,11,123
860350503,8,12,5,14,10,7,3,8,67
860350601,41,47,53,55,35,24,20,29,304
860350602,15,38,38,26,29,20,13,19,198
860350701,9,14,14,25,15,9,3,10,99
860350702,14,17,22,13,15,10,8,22,121
860350703,13,13,20,18,10,14,6,12,106
860350704,37,38,49,49,41,35,13,35,297
860350705,8,12,11,9,9,15,1,7,72
860350706,17,8,14,18,7,12,7,13,96
860350707,24,32,49,54,35,32,10,19,255
860350801,16,16,17,16,10,10,5,5,95
860350802,20,10,11,9,6,7,3,7,73
860350803,22,28,29,33,40,31,11,21,215
860350804,40,57,60,52,32,23,11,21,296
860350805,35,70,73,79,50,40,19,23,389
860350806,38,67,42,47,36,25,4,13,272
860350807,55,73,70,81,66,31,27,51,454
860350808,44,56,48,48,29,22,10,12,269
860350809,41,43,57,51,42,31,10,22,297
860350810,24,57,98,88,78,40,31,37,453
860350901,15,12,28,23,18,28,10,20,154
860350902,14,5,8,16,11,10,6,21,91
860351001,51,47,75,59,51,51,19,48,401
860351002,23,24,23,31,28,24,13,28,194
860351003,4,7,10,10,9,9,1,2,52
860351004,19,27,40,34,24,18,12,15,189
860351005,15,20,15,18,19,12,8,12,119
860351101,21,38,89,84,47,25,6,18,328
860351102,21,30,39,30,18,29,12,19,198
860351103,7,9,10,6,10,6,2,9,59
860351104,4,7,14,11,7,8,6,13,70
860351105,2,6,4,7,7,6,2,5,39
860351106,12,31,61,35,14,8,5,10,176
860351107,42,66,85,97,68,80,24,56,518
860351108,33,72,109,132,71,42,10,7,476
860351109,30,64,103,122,80,48,18,19,484
860351110,1,0,0,0,0,0,0,0,1
860351111,1,10,39,27,13,5,1,0,96
860351112,18,46,88,94,41,23,7,3,320
860351113,21,52,97,121,58,29,12,11,401
860351114,32,50,89,74,34,21,7,17,324
860351201,11,15,18,16,11,9,7,9,96
860351202,19,21,30,28,25,23,8,13,167
860351203,13,29,31,38,28,26,11,28,204
860351204,11,21,24,18,15,14,12,22,137
860351205,41,59,85,94,53,38,24,22,416
860351206,27,30,46,39,42,30,7,11,232
860351207,23,54,85,95,59,46,24,38,424
860351208,14,36,50,53,46,30,23,24,276
860351209,43,52,61,64,32,18,2,6,278
860351210,37,74,74,48,22,14,5,5,279
860351211,19,55,68,45,34,27,12,14,274
860351213,23,43,60,67,52,42,13,15,315
860351214,18,60,77,66,79,40,20,22,382
860351215,23,36,45,52,47,39,15,16,273
860351216,30,34,34,50,32,21,5,10,216
860351217,31,30,45,70,51,19,7,6,259
860351218,8,9,29,43,37,34,10,11,181
860351219,47,62,72,98,71,64,19,40,473
860351220,29,51,60,47,36,22,18,14,277
860351221,9,8,8,3,3,3,1,1,36
860351301,21,44,90,97,66,33,10,16,377
860351302,33,43,67,65,51,35,19,26,339
860351303,49,87,83,65,48,55,25,30,442
860351304,28,37,47,47,29,23,6,8,225
860351305,23,43,37,31,25,17,4,4,184
860351306,32,47,42,47,29,23,5,14,239
860351307,44,62,89,67,63,42,27,31,425
860351308,36,45,79,100,85,42,32,34,453
860351309,31,38,41,47,42,27,16,15,257
860351310,25,28,37,45,40,29,20,34,258
860351311,20,40,62,75,45,34,4,2,282
860351312,15,42,56,83,64,21,7,5,293
860351313,15,38,51,65,60,39,15,16,299
860351314,22,47,50,69,56,29,16,16,305
860351315,26,36,49,58,60,48,9,51,337
860351316,27,43,57,68,50,44,19,41,349
860351317,31,40,44,41,37,25,9,13,240
860351318,33,32,52,59,35,39,16,30,296
860351319,22,43,84,113,57,36,15,16,386
860351401,37,54,86,112,80,56,23,46,494
860351402,27,44,40,49,34,33,15,42,284
860351403,20,53,81,99,74,55,28,31,441
860351404,19,40,58,62,56,45,14,18,312
860351405,28,53,57,61,45,50,27,45,366
860351406,27,56,40,54,43,26,9,18,273
860351407,16,28,32,42,34,40,17,23,232
860351408,26,45,64,65,43,24,14,24,305
860351409,30,60,64,53,45,20,10,7,289
860351410,40,49,52,49,29,15,11,14,259
860351411,52,64,50,35,22,12,4,3,242
860351412,46,69,61,62,37,30,8,9,322
860351413,34,46,70,51,26,22,5,6,260
860351414,23,46,82,83,75,53,24,34,420
860351415,23,30,47,56,46,31,12,20,265
860351416,16,33,48,50,33,25,10,22,237
860351501,46,63,51,39,32,17,7,3,258
860351502,29,60,59,53,37,29,4,14,285
860351503,25,46,52,38,40,28,11,10,250
860351504,39,73,79,72,59,28,23,16,389
860351505,28,37,50,43,36,32,13,18,257
860351506,36,51,56,72,53,41,23,38,370
860351507,43,74,57,51,38,14,7,3,287
860351508,37,45,25,31,12,6,2,2,160
860351509,36,78,52,38,32,12,8,6,262
860351510,36,69,64,71,50,35,19,20,364
860351511,21,26,59,64,69,49,29,33,350
860351512,27,21,35,44,36,26,9,18,216
860351513,21,41,53,60,40,22,20,43,300
860351514,20,40,43,52,45,37,14,33,284
860351515,32,52,63,78,54,22,11,8,320
860351516,27,46,77,79,39,25,15,23,331
860351517,19,35,44,48,41,35,7,26,255
860351601,36,40,38,34,27,13,1,0,189
860351602,46,67,49,37,22,8,3,0,232
860351603,57,72,54,52,29,13,8,6,291
860351604,62,79,100,76,44,26,7,7,401
860351605,34,52,56,66,24,22,4,7,265
860351606,14,39,36,47,25,13,8,9,191
860351607,34,71,77,64,46,23,10,10,335
860351608,32,51,42,52,47,17,12,6,259
860351609,70,76,90,80,40,31,20,15,422
860351610,47,72,104,78,40,40,8,11,400
860351611,27,35,46,58,34,27,21,17,265
860351612,36,63,59,99,73,47,18,40,435
860351613,23,33,55,73,56,19,5,16,280
860420101,18,13,24,5,9,6,3,5,83
860420102,6,2,3,1,2,2,0,0,16
860420103,4,7,5,5,0,0,0,0,21
860420201,2,2,0,3,2,1,1,0,11
860420202,18,34,52,48,42,30,11,22,257
860420203,1,4,1,0,5,1,2,1,15
860420204,5,4,1,0,0,0,0,1,11
860420205,48,36,32,33,34,22,9,19,233
860420206,71,67,97,81,45,35,21,22,439
860420207,59,65,73,70,66,22,16,20,391
860420208,45,73,80,64,37,19,13,11,342
860420209,43,45,83,68,51,24,14,18,346
860420301,21,19,29,21,10,6,4,4,114
860420302,2,5,2,1,4,0,0,0,14
860420303,2,5,10,4,4,1,2,0,28
860420304,4,2,5,1,0,3,0,2,17
860420305,22,27,23,24,15,12,5,7,135
860490101,31,37,31,28,25,24,6,16,198
860490102,20,31,35,20,14,22,8,15,165
860490103,8,12,5,11,9,11,3,7,66
860490201,44,48,70,59,40,40,22,23,346
860490202,51,70,103,91,71,48,29,46,509
860490301,2,0,2,1,2,2,0,2,11
860490302,1,2,2,2,1,3,1,0,12
860490303,39,52,78,109,67,36,6,10,397
860490304,41,45,53,68,35,32,2,7,283
860490305,29,48,75,70,62,37,10,17,348
860490306,19,45,52,82,78,49,13,14,352
860490307,23,27,59,63,51,33,19,21,296
860490308,17,22,45,56,38,37,22,15,252
860490309,12,19,47,59,44,48,11,31,271
860490310,29,36,45,34,41,27,10,12,234
860490311,32,45,66,66,38,20,18,15,300
860490312,18,30,51,35,25,24,12,14,209
860490313,18,22,38,42,18,2,4,4,148
860490314,29,65,131,85,51,21,8,12,402
860490401,10,17,11,19,13,5,5,3,83
860490402,18,20,24,19,21,12,5,16,135
860490403,5,6,5,7,5,1,4,7,40
860490404,2,6,8,6,4,3,4,3,36
860490501,59,67,108,117,105,92,38,75,661
860490502,25,73,104,109,102,50,26,48,537
860490503,27,36,47,48,47,36,20,20,281
860490504,21,31,77,66,54,32,15,19,315
860490505,17,22,44,43,33,18,8,10,195
860490506,31,38,62,53,58,58,8,8,316
860490507,11,18,29,39,50,33,16,31,227
860490508,21,39,59,95,57,28,7,8,314
860490509,12,29,55,80,60,50,27,36,349
860490510,3,16,19,26,17,14,7,15,117
860490511,7,16,38,46,51,34,14,24,230
860490512,15,30,53,50,42,51,20,26,287
860490513,13,20,39,46,50,36,15,30,249
860490514,11,40,94,118,59,40,24,20,406
860490515,38,60,49,79,39,21,11,6,303
860490516,12,61,82,89,57,37,21,15,374
860490517,23,27,38,58,35,29,7,6,223
860490518,25,44,70,80,58,18,9,6,310
860490519,32,57,99,94,61,21,5,3,372
860490520,30,43,55,48,41,27,15,14,273
860490521,24,27,29,41,31,27,1,7,187
860490522,15,34,59,80,53,43,18,20,322
860490523,10,35,38,18,11,4,2,2,120
860490601,16,13,13,11,14,15,8,5,95
860490602,13,10,15,4,4,9,4,5,64
860490801,26,51,73,62,59,25,11,14,321
860490802,22,39,40,46,32,27,15,14,235
860490803,16,38,35,35,34,19,2,3,182
860490804,20,30,43,36,21,17,6,8,181
860490805,35,47,39,44,22,13,1,2,203
860490806,30,28,35,24,18,11,4,1,151
860490807,22,52,41,29,29,13,4,7,197
860490808,27,41,47,34,19,12,2,1,183
860490809,41,58,48,41,34,17,11,6,256
860490810,48,102,63,52,32,20,2,3,322
860490811,26,48,30,30,22,18,7,8,189
860490812,68,76,69,77,45,31,16,23,405
860490813,34,46,54,57,40,23,7,9,270
860490814,21,40,36,33,27,24,10,15,206
860490815,23,41,42,42,21,22,11,36,238
860490816,24,30,26,38,30,31,10,24,213
860490817,48,68,71,79,48,32,15,28,389
860490818,19,26,33,38,35,24,9,21,205
860490819,31,28,53,40,34,21,14,12,233
860490901,32,47,44,39,47,40,12,24,285
860490902,23,42,41,37,31,17,9,18,218
860490903,47,48,46,42,27,16,1,6,233
860490904,36,71,51,45,40,13,7,9,272
860490905,39,60,43,45,20,14,1,5,227
860490906,72,59,40,37,18,7,1,2,236
860490907,42,46,28,31,18,3,3,1,172
860490908,81,59,28,24,7,5,0,1,205
860490909,77,88,49,36,16,10,2,1,279
860490910,32,39,22,13,8,2,0,1,117
860490911,28,43,28,24,12,6,0,0,141
860490912,40,38,38,31,9,8,1,0,165
860490913,44,51,53,33,17,7,3,1,209
860490914,49,61,35,29,25,7,4,0,210
860490915,49,56,56,52,33,9,4,3,262
860490916,45,62,48,42,24,11,5,3,240
860490917,36,61,45,44,30,25,14,10,265
860490918,46,66,68,59,28,20,4,11,302
860490919,49,58,56,53,28,11,1,3,259
860490920,51,40,26,10,16,2,0,0,145
860490921,46,48,37,25,22,7,2,2,189
860490922,39,49,33,27,10,10,0,1,169
860491001,56,70,70,70,47,41,11,21,386
860491002,29,15,54,58,35,30,17,18,256
860491003,45,43,62,113,83,66,41,58,511
860491004,21,23,36,57,40,37,29,37,280
860491005,38,48,49,55,37,29,13,17,286
860491006,27,41,55,66,69,64,26,41,389
860491007,31,33,53,62,50,39,24,48,340
860491008,19,24,52,54,48,34,14,38,283
860491009,55,59,73,54,27,14,4,5,291
860491010,40,60,42,36,23,12,1,0,214
860491011,39,60,55,34,14,12,2,2,218
860491012,50,76,75,60,20,16,6,1,304
860491013,40,43,38,30,11,7,5,2,176
860491014,51,57,36,31,18,4,3,4,204
860491015,41,66,58,49,32,14,3,5,268
860491016,48,76,52,48,35,18,6,8,291
860491017,30,56,61,65,57,56,22,38,385
860491018,33,46,43,60,36,42,24,28,312
860491019,19,48,42,63,41,40,14,47,314
860491020,19,45,56,57,30,33,13,23,276
860491101,32,47,74,86,59,28,12,28,366
860491102,25,43,45,72,45,31,14,16,291
860491103,41,45,71,81,53,39,13,24,367
860491104,20,40,40,46,31,26,4,11,218
860491105,20,47,48,40,33,26,12,15,241
860491106,30,55,61,75,44,38,20,31,354
860491107,22,35,55,65,42,11,5,10,245
860491108,55,76,66,70,32,15,3,0,317
860491109,26,75,71,84,65,28,8,6,363
860491110,33,54,66,52,42,20,2,2,271
860491111,52,67,59,83,40,31,4,1,337
860491112,44,83,68,78,47,24,11,22,377
860491113,37,64,62,69,53,40,16,31,372
860491114,53,61,70,52,43,36,14,22,351
860491115,36,57,70,62,52,28,11,6,322
860491201,53,56,48,31,20,8,2,2,220
860491202,40,55,67,36,21,13,9,3,244
860491203,38,38,54,57,33,31,4,7,262
860491204,30,64,47,57,21,19,4,14,256
860491205,24,44,31,44,32,17,10,10,212
860491206,38,64,64,51,42,21,7,7,294
860491207,28,46,57,33,43,12,3,10,232
860491208,17,57,68,58,45,39,9,10,303
860491209,31,32,53,41,34,23,7,11,232
860491210,25,36,71,71,43,40,11,22,319
860491211,14,38,48,34,9,15,7,14,179
860491212,13,29,34,44,24,21,6,6,177
860491213,23,40,55,50,44,24,10,12,258
860491214,26,57,48,50,32,16,8,4,241
860491215,28,45,51,59,31,25,4,15,258
860491216,32,40,60,52,52,26,12,12,286
860491217,17,43,47,47,41,31,14,25,265
860491218,27,44,34,30,30,23,13,19,220
860491219,35,45,48,37,24,25,7,6,227
860491220,26,27,46,30,34,28,13,12,216
860491301,52,82,65,50,25,10,3,1,288
860491302,48,67,39,38,16,3,1,1,213
860491303,50,81,44,37,19,10,7,0,248
860491304,56,71,59,55,43,18,4,3,309
860491305,56,75,75,51,38,17,4,2,318
860491306,65,92,54,49,26,14,6,7,313
860491307,40,45,40,45,31,26,13,13,253
860491308,27,43,45,48,26,17,8,13,227
860491309,85,81,73,69,37,22,9,7,383
860491310,41,76,55,54,32,14,7,9,288
860491311,52,73,55,52,24,13,4,1,274
860491312,37,70,40,32,21,6,4,2,212
860491313,25,38,30,19,11,8,2,2,135
860491314,32,51,41,31,19,10,1,1,186
860491401,29,42,30,42,25,11,4,4,187
860491402,51,44,65,48,39,22,4,12,285
860491403,46,77,59,59,47,20,12,16,336
860491404,24,50,49,43,40,22,8,12,248
860491405,48,46,49,54,37,29,4,8,275
860491406,29,42,66,58,40,25,5,16,281
860491407,24,25,38,37,28,19,20,21,212
860491408,15,28,34,47,31,19,10,10,194
860491409,22,33,40,32,14,15,3,9,168
860491410,35,68,37,56,46,23,6,10,281
860491411,30,48,54,55,36,17,9,8,257
860491412,36,63,65,66,53,36,8,12,339
860491413,42,58,51,50,29,15,13,8,266
860491414,14,24,44,38,24,28,13,13,198
860491415,19,39,68,60,38,31,11,27,293
860491501,30,57,46,59,45,20,13,17,287
860491502,23,27,41,43,34,28,6,27,229
860491503,41,81,77,69,41,23,6,11,349
860491504,26,52,49,56,39,22,9,13,266
860491505,16,32,45,44,29,19,8,6,199
860491506,29,37,72,67,50,46,18,29,348
860491507,20,20,37,44,41,36,14,19,231
860491508,49,59,109,79,57,54,19,31,457
860491509,41,55,56,51,50,29,9,16,307
860491510,17,45,49,63,48,21,16,13,272
860491511,25,27,45,51,52,20,9,17,246
860491512,13,39,52,65,58,35,18,24,304
860491513,22,38,46,32,29,13,3,3,186
860491514,26,56,67,76,63,58,19,25,390
860491515,11,28,37,36,40,29,8,19,208
860491601,30,40,73,84,59,41,19,23,369
860491602,39,55,69,58,58,32,18,34,363
860491603,23,47,54,64,39,36,14,20,297
860491604,40,51,76,69,58,28,17,10,349
860491605,23,46,61,60,58,43,24,28,343
860491606,49,34,40,41,43,27,18,17,269
860491607,23,32,55,60,47,47,28,36,328
860491608,35,71,55,60,36,11,9,3,280
860491609,31,68,50,57,38,14,4,6,268
860491610,14,36,55,60,46,44,17,36,308
860491611,45,73,57,38,22,10,0,0,245
860491612,39,60,66,57,35,20,9,9,295
860491613,30,53,79,56,63,39,7,9,336
860491614,13,26,41,59,49,19,5,15,227
860491615,28,34,51,78,59,38,15,27,330
860491616,13,21,42,46,35,29,26,26,238
860491701,15,19,44,39,24,11,12,13,177
860491702,23,25,43,48,31,21,5,17,213
860491703,32,38,51,40,43,24,11,20,259
860491704,31,54,62,55,37,28,20,19,306
860491705,28,42,57,56,30,24,13,29,279
860491706,23,31,50,50,52,37,12,27,282
860491707,23,31,43,54,51,45,21,35,303
860491708,18,21,47,43,41,28,11,19,228
860491709,28,37,69,70,59,43,17,31,354
860491710,34,33,48,54,59,46,22,31,327
860491711,28,36,70,56,44,35,22,13,304
860491712,31,53,95,91,72,49,22,36,449
860491713,23,41,45,54,46,36,18,31,294
860491714,23,53,50,57,38,28,19,34,302
860491715,20,34,55,99,47,36,8,14,313
860491716,14,25,51,74,46,34,18,12,274
860491717,32,45,47,65,57,20,19,14,299
860491718,31,30,41,59,41,33,21,28,284
860491801,25,29,50,68,38,51,13,19,293
860491802,24,58,89,69,49,29,14,37,369
860491803,10,30,57,56,51,46,14,31,295
860491804,26,43,65,62,69,34,22,21,342
860491805,22,51,70,85,68,26,16,10,348
860491806,26,39,48,64,35,16,7,3,238
860491807,26,45,70,57,44,32,10,18,302
860491808,20,37,57,74,54,22,6,7,277
860491809,28,50,68,81,65,30,7,5,334
860491810,26,37,51,64,58,33,9,16,294
860491811,16,24,32,51,41,26,8,14,212
860491812,4,12,13,14,16,12,9,3,83
860491813,30,41,53,43,38,22,3,3,233
860491814,12,21,46,65,36,27,2,5,214
860491815,15,34,41,84,59,33,16,19,301
860491816,31,41,61,55,55,37,14,4,298
860491817,13,33,39,72,57,30,19,26,289
860491901,11,44,83,69,31,6,7,3,254
860491902,17,51,145,121,52,21,10,10,427
860491903,22,53,135,115,61,32,6,9,433
860491904,24,56,95,89,47,31,11,9,362
860491905,23,73,102,90,43,20,9,6,366
860491906,23,53,134,121,49,22,6,7,415
860491907,29,46,98,68,45,8,1,5,300
860491908,24,52,109,104,53,24,11,2,379
860491909,16,52,79,72,42,16,12,3,292
860491910,12,14,22,17,7,3,0,0,75
860491911,21,40,72,84,47,18,8,13,303
860491912,30,51,69,86,53,20,7,11,327
860491913,13,34,55,44,22,13,4,1,186
860491914,25,38,106,90,47,19,4,6,335
860491915,8,27,54,58,29,13,5,2,196
860491916,47,53,39,60,41,23,21,23,307
860560101,18,25,26,21,37,24,14,18,183
860560102,78,59,76,64,29,51,18,28,403
860560103,24,30,44,25,34,38,12,28,235
860560104,64,81,83,63,50,39,8,14,402
860560201,3,13,9,8,5,7,5,3,53
860560202,37,12,14,18,15,13,5,33,147
860560203,18,25,29,35,23,19,9,21,179
860560204,12,15,20,20,11,8,5,6,97
860560205,15,12,21,22,8,15,10,10,113
860560206,9,8,10,11,5,4,7,6,60
860560301,20,18,10,10,4,4,2,2,70
860560302,12,15,8,5,4,8,3,9,64
860560303,23,16,25,16,19,15,10,17,141
860560304,22,28,22,11,13,9,5,7,117
860560305,6,14,11,9,9,8,5,10,72
860560306,50,48,64,57,55,46,26,47,393
860560307,27,48,69,79,64,41,18,19,365
860560308,34,48,52,49,50,22,16,34,305
860560309,16,29,40,48,32,26,9,30,230
860560310,21,35,36,41,36,14,13,17,213
860560311,39,38,43,36,44,24,12,18,254
860560312,46,74,99,110,59,48,19,36,491
860560313,35,44,39,41,18,13,6,3,199
860560314,31,27,35,33,33,27,11,20,217
860560315,31,39,40,50,34,39,15,24,272
860560401,6,14,6,13,9,7,3,7,65
860560402,24,15,22,24,13,12,1,10,121
860560403,23,11,15,17,5,7,3,3,84
860560404,19,13,28,25,21,20,16,18,160
860560405,46,38,52,65,42,47,22,35,347
860560501,69,59,71,41,43,50,17,56,406
860560502,49,32,42,41,30,26,13,27,260
860560503,41,39,45,36,31,25,18,20,255
860560504,28,34,40,53,39,32,14,27,267
860560505,33,39,61,40,50,36,10,13,282
860630101,1,4,1,1,1,2,1,1,12
860630102,25,27,29,26,12,13,4,14,150
860630103,27,33,26,33,24,9,11,19,182
860630104,25,13,18,13,12,5,5,13,104
860630105,10,7,3,5,3,6,4,2,40
860630106,34,32,34,36,21,24,5,16,202
860630201,16,20,24,14,16,14,8,11,123
860630202,8,8,7,11,12,8,2,6,62
860630203,11,9,11,13,13,7,4,8,76
860630204,1,4,5,5,6,2,3,1,27
860630205,33,48,59,53,43,20,8,31,295
860630301,30,20,11,9,10,13,2,8,103
860630302,8,8,8,5,4,1,3,3,40
860630303,53,43,40,48,28,31,10,20,273
860630401,3,7,4,2,5,5,2,1,29
860630402,7,11,7,5,8,4,0,1,43
860630403,19,20,24,38,18,17,10,16,162
860630501,14,7,7,11,12,9,6,4,70
860630502,3,6,3,8,4,2,4,4,34
860630601,27,23,25,32,37,24,9,15,192
860630602,24,38,73,59,56,18,10,10,288
860630603,9,23,49,38,19,5,5,7,155
860630604,28,26,31,39,26,23,14,16,203
860630605,31,54,77,100,45,21,1,6,335
860630606,25,34,46,35,31,27,8,25,231
860630607,22,34,42,35,30,25,8,13,209
860630608,26,55,58,52,24,14,4,4,237
860630609,39,47,67,69,36,14,3,5,280
860630610,60,82,49,50,37,13,7,8,306
860630611,32,55,55,57,32,22,3,14,270
860630612,36,55,50,54,25,21,13,10,264
860630613,34,42,47,42,39,20,10,18,252
860630614,46,67,62,42,31,17,7,7,279
860630615,48,56,45,40,19,13,1,3,225
860630701,0,0,0,0,0,0,0,0,0
860630702,0,0,0,0,0,0,0,0,0
860630703,0,0,0,0,0,0,0,0,0
860630801,39,57,58,56,34,39,23,31,337
860630802,42,55,54,44,29,15,7,7,253
860630803,45,50,37,21,13,4,2,3,175
860630804,50,50,51,34,14,17,2,7,225
860630805,29,42,47,41,21,17,5,5,207
860630806,31,59,59,56,23,16,12,5,261
860630807,17,39,62,86,34,22,9,4,273
860630808,29,38,47,33,22,25,9,13,216
860630809,41,43,32,17,8,9,5,2,157
860630810,63,79,65,44,34,12,4,12,313
860630811,35,66,60,55,27,20,8,14,285
860630812,17,26,25,38,22,19,15,16,178
860630813,42,64,64,50,28,30,14,12,304
860630814,25,38,36,36,24,22,4,12,197
860630815,60,61,50,45,44,26,15,30,331
860700101,15,12,18,15,15,21,6,16,118
860700102,13,18,22,23,18,19,11,13,137
860700103,17,17,32,23,28,18,11,14,160
860700104,22,21,24,21,27,14,9,24,162
860700201,39,32,33,33,35,39,26,32,269
860700202,50,64,77,75,44,59,20,58,447
860700203,26,30,31,31,24,19,14,19,194
860700301,4,13,7,6,6,1,2,4,43
860700302,24,25,25,23,18,16,5,16,152
860700401,70,86,106,103,94,85,38,74,656
860700402,38,47,52,37,36,23,16,42,291
860700403,30,24,30,21,27,19,16,24,191
860700501,9,11,25,22,19,13,8,21,128
860700502,20,20,17,26,15,15,8,18,139
860700503,29,42,37,30,30,24,20,24,236
860700504,5,5,7,3,4,8,2,5,39
860700505,30,26,19,16,16,7,7,20,141
860700601,14,17,11,8,15,10,4,10,89
860700602,14,18,10,8,11,9,3,13,86
860700603,53,54,74,76,54,34,19,42,406
860770101,32,45,59,34,36,50,19,43,318
860770102,19,21,29,33,27,50,4,23,206
860770103,19,23,38,43,38,32,17,37,247
860770201,11,16,24,17,16,10,5,16,115
860770202,43,61,91,77,64,63,24,67,490
860770203,26,27,34,35,23,20,17,29,211
860770204,13,15,11,20,15,12,9,7,102
860770205,59,55,72,70,54,31,13,20,374
860770206,21,28,53,42,47,28,11,18,248
860770207,29,41,43,36,29,20,7,22,227
860770301,36,31,43,37,38,24,11,18,238
860770302,25,36,37,28,31,23,10,15,205
860770303,11,7,7,11,12,6,2,3,59
860770401,1,3,5,9,4,12,2,6,42
860770402,15,21,22,23,28,19,6,16,150
860770403,23,17,26,27,23,16,7,13,152
860770404,4,4,12,8,9,7,1,1,46
860770405,23,26,32,33,30,35,13,32,224
860770501,14,23,36,41,31,31,12,30,218
860770502,33,44,63,72,47,30,13,25,327
860770503,23,19,36,33,22,22,14,24,193
860770504,11,23,32,34,33,27,12,22,194
860770505,22,39,58,55,47,38,22,36,317
860770506,30,32,43,43,33,21,7,24,233
860770507,20,27,30,35,28,20,7,15,182
860770508,51,63,48,63,46,25,15,12,323
860770509,36,38,35,29,29,10,5,5,187
860770510,24,40,29,27,27,12,1,13,173
860770511,31,43,28,36,29,18,9,11,205
860770512,26,33,42,39,33,19,10,16,218
860770601,10,28,30,36,21,25,10,17,177
860770602,25,53,50,36,21,17,2,6,210
860770603,44,47,47,38,14,17,6,4,217
860770604,44,67,32,27,18,13,4,9,214
860770605,27,50,47,41,15,18,9,8,215
860770606,28,28,27,25,31,16,7,13,175
860770607,20,19,24,26,28,18,13,14,162
860770608,39,40,61,57,60,46,13,35,351
860770609,29,32,44,39,31,21,4,14,214
860770610,22,34,41,44,28,37,15,25,246
860770611,21,24,51,43,39,28,8,19,233
860770612,21,31,36,43,41,28,16,19,235
860840101,4,4,3,3,6,2,1,3,26
860840102,14,29,21,27,12,16,1,8,128
860840103,7,5,3,2,4,1,2,2,26
860840201,23,23,17,16,9,11,6,15,120
860840202,6,10,4,5,6,2,3,11,47
860840301,21,29,30,31,28,17,11,33,200
860840302,8,2,9,6,9,6,2,8,50
860840303,11,9,9,9,18,13,6,12,87
860840304,9,9,13,18,13,6,1,13,82
860840305,19,14,16,13,11,4,8,4,89
860840401,5,11,10,5,11,6,4,4,56
860840402,7,3,6,5,0,0,0,1,22
860840403,5,6,5,3,2,4,1,1,27
860840404,4,3,6,2,4,1,1,2,23
860840405,26,17,12,11,6,6,5,6,89
860840406,48,38,31,34,10,17,9,11,198
860840407,39,49,47,48,28,15,16,12,254
860840408,25,37,44,50,24,24,8,11,223
860840409,37,39,39,40,20,13,6,9,203
860910101,17,17,15,33,22,16,5,6,131
860910102,9,10,8,4,4,3,3,1,42
860910103,10,17,14,27,20,11,10,22,131
860910104,14,11,12,15,7,6,8,11,84
860910105,31,42,59,64,47,46,19,37,345
860910106,32,28,39,28,20,19,8,18,192
860910107,23,18,23,13,10,8,4,10,109
860910108,3,1,1,2,4,0,0,2,13
860910109,41,57,63,73,46,34,15,22,351
860910201,20,7,11,10,5,3,1,7,64
860910202,3,6,4,2,3,1,1,0,20
860910203,5,8,8,15,7,14,3,17,77
860910204,1,2,1,1,1,0,0,1,7
860910301,1,4,2,3,9,18,0,6,43
860910302,1,9,5,4,5,2,1,0,27
860910401,4,7,4,10,6,3,2,4,40
860910402,19,14,10,7,6,6,4,3,69
860910403,21,20,29,31,19,10,4,12,146
860910404,37,32,31,28,20,20,5,7,180
860910405,36,41,38,36,22,21,6,2,202
860910406,65,64,68,84,49,39,12,19,400
860910407,26,27,32,36,19,20,6,18,184
860910408,10,7,6,7,5,2,5,4,46
860910409,2,6,6,6,3,3,3,3,32
860910410,46,53,51,52,47,34,22,31,336
860910411,36,59,48,52,43,31,18,28,315
860980101,17,5,13,7,3,13,6,7,71
860980102,8,2,2,2,0,0,1,2,17
860980103,29,14,9,14,20,10,7,19,122
860980104,13,4,3,4,2,0,2,6,34
860980105,4,5,5,4,5,4,1,5,33
860980106,7,6,3,2,4,2,3,3,30
860980107,2,2,4,1,0,1,1,0,11
860980108,31,48,67,65,49,45,26,42,373
860980109,68,68,68,85,51,85,17,34,476
860980110,48,48,62,56,42,23,20,27,326
860980111,32,22,38,55,39,27,15,39,267
860980112,22,26,23,32,21,19,11,34,188
860980201,13,20,19,11,21,15,9,18,126
860980202,4,2,1,3,1,1,0,0,12
860980203,14,2,2,4,7,3,1,7,40
860980204,8,5,6,8,0,5,3,5,40
860980205,40,26,28,42,34,27,14,41,252
860980301,11,10,9,10,13,4,2,8,67
860980302,8,8,9,3,5,6,0,5,44
860980303,4,2,3,1,2,0,0,0,12
860980304,6,5,2,1,4,1,0,0,19
860980305,50,37,64,74,57,40,26,44,392
860980401,22,16,44,48,20,32,9,30,221
860980402,19,16,25,27,15,12,13,17,144
860980403,37,25,35,12,24,15,9,8,165
860980501,8,8,12,9,8,7,4,7,63
860980502,21,16,30,44,30,30,12,19,202
860980503,50,43,44,33,33,39,13,23,278
860980601,7,7,4,5,2,0,0,3,28
860980602,4,11,3,8,7,9,3,8,53
860980603,0,4,0,4,0,3,3,1,15
860980701,6,5,4,3,5,4,0,6,33
860980702,3,5,3,3,1,0,1,2,18
860980703,0,2,3,1,1,0,0,1,8
861050101,66,75,71,66,68,70,36,69,521
861050102,4,9,9,7,5,9,5,10,58
861050201,30,41,72,78,45,32,11,15,324
861050202,3,6,8,5,7,5,6,4,44
861050203,55,75,54,53,49,45,17,41,389
861050204,43,52,59,71,61,54,27,40,407
861050205,49,37,65,49,49,27,9,11,296
861050206,27,43,55,46,42,36,14,20,283
861050207,42,70,50,56,56,23,15,30,342
861050208,22,59,61,53,39,27,14,19,294
861050209,36,59,68,45,54,26,19,32,339
861050210,35,41,69,61,45,41,28,27,347
861050211,24,42,42,48,29,37,16,27,265
861050212,25,31,49,49,55,36,12,25,282
861050301,48,46,54,62,50,36,16,23,335
861050302,20,29,29,29,17,20,5,13,162
861050303,13,12,15,13,11,13,5,12,94
861120101,6,8,3,5,2,4,3,5,36
861120102,13,6,9,13,4,13,6,5,69
861120103,10,7,10,3,9,3,1,1,44
861120104,5,7,6,7,2,6,2,1,36
861120105,11,13,8,3,4,2,1,5,47
861120201,26,9,12,13,5,3,2,3,73
861120202,7,3,4,2,4,3,2,0,25
861120203,43,23,38,19,24,9,7,1,164
861120302,3,5,9,6,6,6,2,5,42
861190101,42,43,52,67,55,50,25,61,395
861190102,52,47,65,72,62,54,35,72,459
861190103,39,43,58,69,46,27,16,42,340
861190104,33,62,52,109,64,54,33,43,450
861190201,18,12,14,13,13,11,11,16,108
861190202,5,7,6,5,4,5,1,0,33
861190203,18,15,15,15,8,6,1,2,80
861190301,19,17,24,23,18,17,9,14,141
861190302,21,9,7,12,6,8,6,6,75
861190303,23,15,20,14,15,12,5,11,115
861190304,10,3,4,4,7,1,1,6,36
861190401,35,18,18,13,18,8,9,10,129
861190402,5,2,2,5,3,1,0,4,22
861190403,10,3,6,7,8,4,0,5,43
861190404,42,47,49,57,37,31,23,43,329
861190405,11,16,21,24,15,13,9,21,130
861190406,48,75,103,82,68,57,22,34,489
861190407,41,50,54,50,44,26,11,20,296
861190408,39,51,89,82,53,37,14,33,398
861190409,51,91,85,69,54,18,15,23,406
861190410,53,63,71,71,71,40,18,26,413
861190411,14,28,58,54,45,32,11,19,261
861190412,25,40,62,67,69,42,22,33,360
861190413,38,57,91,88,70,63,33,56,496
861190414,53,65,75,83,41,36,10,16,379
861190415,22,24,22,34,34,28,21,44,229
861190501,36,32,52,64,47,35,16,34,316
861190502,49,52,48,42,38,60,29,62,380
861190503,32,29,28,28,10,18,3,11,159
861260101,7,18,8,8,1,4,0,0,46
861260102,1,3,0,3,0,0,0,0,7
861260201,33,34,25,25,21,19,8,18,183
861260202,6,6,8,11,5,2,0,1,39
861260203,24,22,20,17,12,10,2,14,121
861260204,16,18,11,10,12,6,6,12,91
861260301,46,31,33,27,24,23,12,13,209
861260302,16,16,15,12,13,8,3,6,89
861260303,27,16,15,16,8,6,1,4,93
861260304,11,6,6,3,2,3,0,1,32
861260305,12,10,9,10,2,7,4,4,58
861260306,9,4,3,7,3,2,1,1,30
861260307,43,46,64,54,46,31,8,15,307
861260308,41,54,63,53,53,23,17,23,327
861260309,38,56,86,91,75,39,19,15,419
861260310,92,91,83,74,74,43,20,17,494
861260311,59,65,66,48,34,15,6,11,304
861260312,44,60,54,67,47,32,11,12,327
861260313,31,50,48,59,36,30,18,12,284
861260401,28,13,13,11,9,3,4,6,87
861260402,11,15,21,11,10,8,2,4,82
861260403,22,20,28,22,8,9,5,12,126
861260404,8,6,6,4,2,2,1,0,29
861330101,13,17,11,14,5,6,1,1,68
861330102,16,14,19,14,6,7,9,8,93
861330103,43,29,21,21,29,8,3,9,163
861330201,23,25,22,26,25,12,7,10,150
861330202,13,7,13,9,7,8,2,9,68
861330203,40,46,38,38,31,31,10,14,248
861330204,34,39,31,37,20,14,5,12,192
861330205,33,47,84,82,54,30,9,16,355
861330301,32,22,29,24,16,15,5,11,154
861330302,15,10,13,12,11,8,3,13,85
861330303,30,22,18,20,14,12,9,13,138
861330304,6,4,8,7,3,0,0,2,30
861330305,5,10,10,4,9,3,1,4,46
861330401,17,9,7,8,8,3,4,2,58
861330402,4,7,9,8,3,6,3,4,44
861330403,43,69,67,72,37,29,11,20,348
861330404,27,44,60,59,36,39,19,35,319
861330405,13,14,8,5,4,4,2,3,53
861330406,29,27,24,20,21,9,4,23,157
861330407,32,38,37,38,28,11,3,8,195
861330408,24,48,46,40,22,15,7,13,215
861330409,19,26,35,56,33,16,11,12,208
861330410,70,73,119,94,66,40,20,31,513
861330501,3,4,1,4,3,1,0,0,16
861330502,8,3,6,2,0,2,1,1,23
861330503,8,6,8,5,5,6,2,1,41
861330504,21,17,18,14,11,14,11,8,114
861330505,52,39,53,56,40,32,14,32,318
861330601,15,15,15,9,5,10,3,4,76
861330602,10,14,8,2,8,3,2,9,56
861330603,12,10,10,16,7,9,1,8,73
861330701,29,31,44,42,36,17,9,23,231
861330702,23,24,22,24,18,15,5,8,139
861330801,12,8,12,12,7,7,1,11,70
861330802,27,34,49,38,34,23,13,21,239
861400101,20,31,18,9,11,10,3,7,109
861400102,4,9,10,10,5,2,2,5,47
861400103,32,21,36,28,17,23,13,24,194
861400104,6,13,9,12,13,6,6,4,69
861400105,33,33,28,17,15,8,3,7,144
861400201,16,27,11,17,19,15,6,2,113
861400202,19,10,17,16,7,2,3,4,78
861400203,8,18,12,10,5,8,2,4,67
861400204,15,17,20,26,16,18,5,10,127
861400205,45,39,58,25,11,11,6,5,200
861400206,47,36,71,69,50,32,15,19,339
861400207,46,41,43,44,24,15,2,19,234
861400208,28,38,39,40,27,19,7,8,206
861400209,41,45,42,32,39,32,15,31,277
861400210,23,57,48,57,29,18,2,7,241
861400301,21,26,31,28,14,10,6,12,148
861400302,14,8,11,10,9,10,3,6,71
861400303,25,24,26,24,8,13,8,15,143
861470101,35,16,36,17,13,10,5,11,143
861470102,55,49,58,55,31,26,11,22,307
861470103,54,51,83,67,36,40,14,20,365
861470104,17,21,27,19,33,17,10,15,159
861470201,32,34,26,33,25,16,8,20,194
861470202,29,60,51,68,60,43,26,46,383
861470301,66,84,145,156,145,101,66,88,851
861470302,28,21,30,29,26,19,3,8,164
861470401,55,59,75,100,77,82,49,70,567
861470402,18,23,26,11,13,14,7,11,123
861470403,22,17,19,32,27,22,11,27,177
861470501,20,27,33,31,25,26,8,14,184
861470502,38,41,49,43,36,25,21,28,281
861470503,15,15,19,15,16,21,6,13,120
861470504,13,20,23,27,14,10,8,11,126
861470601,12,26,27,27,15,17,8,16,148
861470602,15,19,25,24,13,12,9,10,127
861470603,16,20,23,17,19,6,12,21,134
861470701,6,4,8,5,9,6,2,2,42
861470702,15,13,13,11,8,8,3,7,78
861470703,44,58,36,33,21,20,9,11,232
861470704,43,48,38,34,27,20,12,15,237
861470705,21,30,16,14,12,9,1,8,111
861470706,28,26,37,29,21,11,7,5,164
861470801,33,41,72,76,66,32,10,13,343
861470802,35,50,65,58,43,37,13,12,313
861470803,32,60,73,58,36,16,9,13,297
861470804,37,52,38,30,19,9,2,7,194
861470805,30,44,36,39,35,12,3,4,203
861470806,24,49,58,43,36,26,8,23,267
861470807,45,50,64,84,39,38,15,25,360
861470808,46,65,62,62,53,32,7,11,338
861470809,23,36,43,54,35,28,17,17,253
861470810,13,26,40,40,32,14,12,14,191
861470811,41,54,60,64,35,30,8,14,306
861470812,27,39,44,60,46,25,7,12,260
861470813,13,39,47,50,26,25,12,17,229
861470814,24,63,78,65,36,36,4,5,311
861470815,13,27,26,28,17,7,2,1,121
861470816,24,29,49,50,32,13,2,7,206
861470817,19,16,32,38,28,17,5,13,168
861470901,24,29,44,61,42,16,5,9,230
861470902,37,48,59,69,56,43,25,22,359
861470903,25,28,53,52,40,17,10,12,237
861470904,18,24,44,47,34,19,7,16,209
861470905,13,36,62,48,42,27,12,19,259
861470906,23,53,33,26,20,19,6,10,190
861470907,12,12,10,16,3,6,2,3,64
861470908,34,41,30,21,9,9,5,5,154
861470909,36,48,38,44,26,26,8,10,236
861470910,27,36,32,28,14,9,4,5,155
861470911,26,24,10,10,8,3,1,0,82
861470912,25,32,36,37,30,19,12,18,209
861470913,21,19,37,33,17,15,13,17,172
861470914,15,21,42,49,30,27,15,29,228
861470915,28,44,42,37,23,11,7,7,199
861470916,18,30,46,52,34,23,16,15,234
861470917,35,39,41,34,30,14,13,6,212
861470918,14,24,31,36,18,17,6,13,159
861470919,18,26,27,35,38,26,12,20,202
861540101,10,3,5,5,5,3,0,0,31
861540102,18,13,9,18,9,4,2,3,76
861540103,1,2,3,3,2,1,0,2,14
861540104,4,8,4,12,12,1,4,0,45
861540105,6,5,4,4,3,6,0,3,31
861540106,33,52,68,70,41,23,3,7,297
861540107,74,64,69,52,33,19,21,20,352
861540108,64,63,45,29,19,6,1,3,230
861540201,7,1,6,4,5,2,3,1,29
861540202,9,12,14,8,9,3,4,1,60
861540203,26,30,25,31,17,16,0,5,150
861540204,2,0,1,4,1,1,0,1,10
861540301,4,3,6,6,3,2,2,0,26
861540302,9,5,13,13,6,5,2,1,54
861540303,3,12,16,8,12,6,3,3,63
861610101,25,15,17,28,19,16,11,23,154
861610102,25,29,45,43,27,30,14,17,230
861610103,24,18,13,17,28,20,5,19,144
861610104,16,14,21,17,15,15,9,12,119
861610105,50,33,48,52,43,31,19,38,314
861610106,35,26,39,31,33,28,7,23,222
861610107,25,39,54,33,30,26,12,15,234
861610108,33,41,59,51,34,19,15,25,277
861610109,40,63,79,53,43,25,6,25,334
861610110,35,42,71,64,51,31,17,34,345
861610111,33,42,52,42,29,43,17,25,283
861610112,26,25,56,52,40,36,19,30,284
861610201,28,10,9,14,9,7,4,6,87
861610202,19,7,6,4,1,4,0,1,42
861610203,20,48,46,46,37,54,17,36,304
861610204,22,35,34,27,43,21,10,26,218
861610205,12,16,21,36,27,20,7,24,163
861610206,16,35,38,39,23,22,22,27,222
861610301,40,39,70,53,48,48,25,48,371
861610302,47,40,40,56,32,39,22,31,307
861610303,10,9,8,5,3,2,1,7,45
861610304,14,8,11,17,8,5,6,13,82
861610305,22,25,40,44,38,37,16,40,262
861610306,21,16,29,26,17,15,6,22,152
861610307,4,3,6,9,4,10,4,2,42
861610308,50,82,88,90,61,44,21,33,469
861610309,18,31,40,50,50,27,13,26,255
861610310,21,55,41,44,36,22,12,12,243
861610311,28,41,36,40,26,17,5,13,206
861610312,32,60,66,46,27,17,4,12,264
861610313,28,39,37,35,23,24,3,4,193
861610314,24,31,42,49,39,25,10,9,229
861610315,28,26,27,38,32,37,20,34,242
861610316,41,36,57,56,49,31,22,37,329
861610317,32,39,38,32,34,21,9,17,222
861610318,25,37,82,75,55,30,8,11,323
861610319,40,38,43,34,32,20,13,15,235
861610401,14,14,9,13,5,7,2,9,73
861610402,12,11,19,19,16,10,5,5,97
861610403,13,22,18,20,10,18,8,10,119
861610404,31,29,32,45,17,20,12,18,204
861610405,19,25,25,21,10,7,7,6,120
861610406,31,18,22,20,12,11,0,13,127
861610407,6,2,8,7,14,5,4,8,54
861610408,6,5,7,5,9,4,2,10,48
861610409,30,43,63,70,39,27,13,18,303
861610410,27,52,61,71,46,35,15,13,320
861610411,20,22,42,36,33,18,16,14,201
861610412,59,36,46,45,42,32,17,31,308
861610413,27,30,35,21,27,18,9,21,188
861680101,29,15,12,14,12,10,9,11,112
861680102,15,17,9,17,9,15,7,20,109
861680103,24,28,20,17,27,14,4,18,152
861680104,13,18,19,9,11,5,7,5,87
861680105,32,21,27,23,17,13,9,7,149
861680201,24,17,27,18,25,19,13,22,165
861680202,30,27,39,32,22,19,16,20,205
861680203,24,19,21,18,17,17,5,21,142
861680204,24,13,28,14,16,15,4,19,133
861680205,27,28,28,35,31,19,8,19,195
861680206,46,59,74,86,54,32,8,17,376
861680207,45,56,58,48,41,25,15,17,305
861680301,37,24,25,41,28,31,9,29,224
861680302,27,22,29,16,26,18,12,30,180
861680303,8,6,7,11,12,11,3,7,65
861680304,16,16,14,20,18,13,6,16,119
861750101,48,48,62,48,36,29,19,33,323
861750102,14,9,10,8,7,7,4,4,63
861750103,15,22,28,14,11,13,3,14,120
861750201,12,6,14,12,8,15,2,12,81
861750202,10,7,10,14,12,8,6,6,73
861750203,9,18,23,20,17,16,8,15,126
861750204,29,34,50,36,40,23,22,32,266
861750301,24,22,32,35,22,21,9,25,190
861750302,10,9,5,8,6,6,3,7,54
861750303,25,16,19,29,28,20,5,24,166
861750304,46,36,39,30,24,23,15,22,235
861750305,27,32,23,26,19,17,3,14,161
861750306,29,30,33,30,18,13,7,16,176
861750307,22,30,34,31,39,33,12,26,227
861820101,2,3,3,1,2,2,0,1,14
861820102,10,4,5,3,2,6,1,3,34
861820103,10,8,20,11,8,7,8,13,85
861820201,10,8,7,6,7,5,6,8,57
861820202,3,1,1,3,0,0,0,0,8
861820203,12,13,9,10,4,7,4,17,76
861820204,5,8,12,6,5,2,1,2,41
861820205,32,41,46,40,36,22,14,32,263
861820206,45,47,52,71,35,38,18,37,343
861820301,11,12,9,17,4,9,1,10,73
861820302,8,11,6,14,5,8,4,7,63
861890101,41,43,53,63,35,29,16,29,309
861890102,11,11,15,19,14,21,11,15,117
861890103,24,31,37,51,42,35,17,20,257
861890201,38,42,39,34,37,27,18,23,258
861890202,17,24,28,29,20,14,15,14,161
861890203,1,2,5,0,0,0,0,1,9
861890301,29,21,26,22,26,15,9,16,164
861890302,32,26,60,48,36,37,16,23,278
861890303,33,45,47,41,35,26,9,30,266
900070101,3,2,2,1,4,2,0,0,14
900070102,4,3,2,2,4,2,1,1,19
900070103,3,5,9,8,7,4,0,4,40
900070104,15,11,12,13,8,8,11,7,85
900070105,17,14,16,11,9,11,3,2,83
900070201,5,7,8,5,1,4,0,1,31
900070202,6,4,3,2,4,2,2,3,26
900070203,4,5,6,2,1,1,1,1,21
900070204,24,30,29,19,14,8,2,7,133
900070205,22,28,30,26,14,13,8,9,150
900070206,4,11,10,14,13,12,3,11,78
900070301,7,8,1,4,4,2,0,3,29
900070302,5,2,0,3,2,1,1,3,17
900070303,0,2,4,3,1,2,1,5,18
900070304,4,3,2,4,4,0,0,1,18
900070305,7,5,4,7,6,2,0,1,32
900070306,20,14,22,25,11,6,9,13,120
900070401,8,14,9,12,10,6,3,8,70
900070402,13,11,14,6,6,8,2,2,62
900070403,14,17,31,19,21,10,7,7,126
900070404,16,6,14,16,11,8,1,6,78
900070405,21,26,34,40,47,31,20,16,235
900070406,7,2,1,2,0,1,0,0,13
900070407,11,10,20,15,9,10,8,10,93
900070408,43,32,69,70,46,48,20,21,349
900070409,28,28,55,59,49,41,12,28,300
900070410,46,32,61,55,50,37,16,34,331
900070501,10,17,9,8,7,13,4,5,73
900070502,6,6,15,11,5,2,1,6,52
900070503,8,12,25,10,13,9,3,8,88
900070504,7,11,12,16,9,7,2,3,67
900070505,17,10,17,15,10,13,6,9,97
900070506,12,11,15,11,8,12,8,10,87
900070507,4,19,9,12,10,11,2,4,71
900070508,13,17,14,16,12,6,3,6,87
900070509,11,10,23,26,23,4,7,9,113
900070601,21,13,25,20,15,11,8,13,126
900070602,8,8,20,19,18,4,5,9,91
900070603,6,5,8,7,8,2,2,3,41
900070604,12,16,24,18,27,9,11,19,136
900070605,7,7,11,18,10,8,5,7,73
900070606,10,16,31,20,18,14,4,9,122
900070607,29,16,20,35,32,21,13,18,184
900070608,8,12,12,17,15,6,2,2,74
900070609,8,18,32,28,16,12,6,11,131
900070610,15,8,19,29,12,15,7,5,110
900070611,32,44,47,38,53,14,12,18,258
900070701,10,10,17,25,25,11,7,7,112
900070702,7,20,20,17,17,10,5,8,104
900070703,15,12,20,29,20,14,14,13,137
900070704,11,11,31,31,18,18,12,15,147
900070705,6,8,9,9,6,6,7,6,57
900070706,3,4,3,1,3,0,1,1,16
900070707,5,3,7,11,12,7,6,8,59
900070708,6,7,6,16,15,8,4,7,69
900070709,8,7,10,13,9,8,5,3,63
900070710,27,42,71,59,61,44,18,38,360
900070711,13,13,15,21,24,17,13,15,131
900070712,29,55,67,80,68,52,26,40,417
900070801,10,11,16,21,15,8,11,15,107
900070802,2,1,8,4,6,2,3,3,29
900070803,12,14,18,17,8,10,4,3,86
900070804,7,6,4,8,5,2,1,4,37
900070805,26,26,28,41,26,19,10,10,186
900070806,8,6,13,20,10,8,3,2,70
900070807,29,31,56,58,46,30,22,23,295
900070808,15,23,30,47,27,15,11,15,183
900070809,11,10,9,7,11,8,3,5,64
900070901,5,4,6,3,4,1,0,0,23
900070902,13,10,8,18,10,8,4,13,84
900070903,27,15,30,28,21,13,11,5,150
900070904,20,18,36,28,29,29,18,24,202
900070905,7,6,10,7,4,5,8,8,55
900071001,28,31,32,26,26,14,5,4,166
900071002,7,5,10,11,6,5,4,6,54
900071003,9,11,14,12,9,1,1,8,65
900071004,12,8,5,11,7,3,2,2,50
900071005,27,29,36,31,38,14,14,28,217
900071006,10,4,4,5,6,5,4,7,45
900071007,26,48,48,56,56,21,22,38,315
900140101,18,21,18,17,25,9,8,6,122
900140102,22,40,51,49,29,34,27,21,273
900140103,28,49,68,81,71,56,24,42,419
900140104,11,21,32,40,37,20,8,11,180
900140105,11,26,34,45,19,32,11,24,202
900140106,9,7,33,43,34,19,12,4,161
900140107,15,33,54,49,46,41,15,20,273
900140108,13,29,52,44,40,22,7,12,219
900140109,34,65,92,102,92,49,20,33,487
900140110,26,41,72,82,75,43,21,16,376
900140111,13,21,44,38,31,16,0,6,169
900140112,39,60,117,157,117,84,23,28,625
900140113,39,54,72,80,80,58,17,20,420
900140114,27,61,79,111,86,48,26,39,477
900140115,30,56,86,80,89,46,24,21,432
900140116,24,42,83,121,78,75,14,29,466
900140117,11,22,40,61,43,23,7,5,212
900140118,13,33,50,92,55,30,16,7,296
900140119,10,23,40,65,53,37,18,16,262
900140120,27,40,41,31,38,27,15,18,237
900140121,31,66,78,89,65,52,18,16,415
900140122,28,48,70,112,79,47,24,34,442
900140123,20,55,62,69,55,44,10,17,332
900140124,12,61,54,54,46,36,14,10,287
900140125,19,34,50,56,47,29,11,28,274
900140126,38,73,99,132,93,67,17,30,549
900140127,34,65,75,74,81,52,14,39,434
900140128,19,27,45,66,36,36,18,15,262
900140129,20,35,56,62,49,39,17,36,314
900140130,37,57,79,104,72,90,30,45,514
900140131,36,52,74,82,67,54,29,40,434
900140201,6,7,8,18,6,11,1,4,61
900140202,6,17,22,28,17,19,7,16,132
900140203,1,6,5,8,5,6,2,0,33
900140204,20,16,22,35,15,14,13,12,147
900140205,10,22,28,37,35,25,10,17,184
900140206,1,11,6,7,3,6,5,2,41
900140207,36,39,68,79,55,35,17,24,353
900140208,35,52,80,61,61,37,19,18,363
900140209,22,24,37,52,41,27,6,19,228
900140210,36,36,42,48,37,25,9,16,249
900140211,21,26,43,43,47,40,16,18,254
900140301,21,24,46,49,32,24,13,20,229
900140302,5,5,10,12,6,7,4,4,53
900140303,3,5,6,4,5,2,1,3,29
900140304,10,6,10,12,9,8,3,8,66
900140401,3,3,5,8,6,6,2,3,36
900140402,21,6,3,5,10,7,1,4,57
900140403,28,29,39,48,22,22,8,18,214
900140404,33,37,39,47,44,25,13,9,247
900140501,8,5,3,6,6,0,1,3,32
900140502,11,16,16,25,16,6,4,7,101
900140503,20,21,19,21,18,19,4,12,134
900140504,18,15,13,12,3,5,2,5,73
900140505,7,6,19,10,9,3,5,11,70
900140506,8,16,14,16,16,6,4,11,91
900140601,13,13,21,29,24,14,10,7,131
900140602,3,0,3,4,0,1,2,1,14
900140603,0,1,2,1,1,0,0,1,6
900140604,2,4,2,6,2,3,2,1,22
900140605,0,2,1,2,0,0,1,0,6
900140606,9,11,31,42,21,9,8,4,135
900140607,3,3,9,13,6,9,3,3,49
900140608,19,20,31,32,35,18,6,13,174
900140609,30,38,59,55,51,24,16,16,289
900140610,20,48,62,78,76,41,12,30,367
900140611,22,28,49,50,51,34,10,23,267
900140612,23,32,47,52,44,44,24,36,302
900140613,25,39,65,56,47,45,21,28,326
900140614,17,33,41,52,46,34,10,13,246
900140701,10,12,22,23,19,8,11,13,118
900140702,0,1,2,1,1,2,2,1,10
900140703,24,24,35,47,28,28,10,18,214
900140704,20,31,23,40,34,29,9,23,209
900140705,5,7,11,11,8,7,1,6,56
900140706,10,17,26,22,38,18,13,7,151
900140707,2,7,6,5,1,6,4,4,35
900140708,26,31,37,45,37,18,11,18,223
900140709,6,12,9,11,7,9,6,4,64
900140710,38,40,78,67,66,33,15,19,356
900140711,24,35,47,48,46,31,27,35,293
900140712,32,40,46,59,35,36,16,14,278
900140713,30,58,101,99,62,42,20,27,439
900140714,31,43,47,66,39,34,9,26,295
900140801,9,14,11,11,9,5,6,12,77
900140802,3,2,10,19,9,8,3,8,62
900140803,12,11,14,17,22,8,4,10,98
900140804,15,10,8,10,5,3,2,0,53
900140805,11,24,30,47,29,19,3,6,169
900140806,12,7,9,12,13,7,4,3,67
900140901,25,39,41,44,31,22,11,18,231
900140902,15,9,30,30,22,18,3,8,135
900140903,10,24,29,31,18,21,5,14,152
900140904,8,4,15,21,6,12,3,6,75
900140905,11,14,38,25,21,14,4,16,143
900140906,19,12,25,28,19,17,3,7,130
900141001,16,28,37,27,21,13,6,10,158
900141002,10,31,23,16,21,6,2,5,114
900141003,32,21,29,27,33,14,7,11,174
900141101,6,11,17,14,6,6,3,5,68
900141102,26,47,53,76,38,24,5,17,286
900141103,5,4,8,9,7,2,2,9,46
900141104,21,24,39,26,19,19,12,8,168
900141105,20,30,63,89,77,47,9,22,357
900141106,36,58,73,84,56,37,21,26,391
900141201,20,29,49,65,40,27,17,15,262
900141202,20,27,39,28,25,24,12,9,184
900141203,7,4,4,18,11,10,6,7,67
900141204,33,54,92,94,66,60,19,34,452
900141205,28,31,62,72,62,47,14,22,338
900141206,13,30,38,59,31,51,12,17,251
900141207,11,25,49,69,72,56,16,15,313
900141208,9,32,34,60,59,30,11,16,251
900141209,20,46,60,66,53,52,13,27,337
900141210,45,56,80,87,80,44,18,27,437
900141211,23,37,57,59,53,39,16,15,299
900141212,27,54,45,49,43,32,8,7,265
900141213,23,38,71,68,56,36,23,18,333
900141214,17,31,48,79,71,34,25,33,338
900141215,17,25,58,37,37,25,8,5,212
900141216,22,36,38,51,27,22,18,18,232
900141217,28,46,64,72,56,42,20,26,354
900141218,17,47,52,62,39,28,14,14,273
900141219,31,42,71,72,52,32,10,18,328
900141220,4,2,7,4,3,4,3,0,27
900141221,16,21,33,36,19,14,6,14,159
900141222,32,57,69,91,82,49,19,33,432
900141223,27,42,83,80,55,16,9,10,322
900141224,5,16,33,66,46,25,9,2,202
900141225,14,20,28,48,53,21,10,11,205
900141301,30,43,65,53,43,51,20,41,346
900141302,23,36,54,57,43,32,16,19,280
900141303,41,49,71,80,62,49,19,29,400
900141304,13,36,30,28,17,24,11,22,181
900141305,16,21,32,45,45,33,18,29,239
900141306,47,64,76,77,72,55,33,35,459
900141307,25,43,44,59,44,38,17,27,297
900141308,26,41,47,44,31,28,9,17,243
900141309,24,39,64,44,32,26,8,12,249
900141310,37,76,80,73,66,74,29,48,483
900141311,22,36,74,67,64,48,22,44,377
900141312,28,77,75,83,73,47,13,12,408
900141313,19,24,51,50,40,34,19,22,259
900141314,15,29,36,37,29,28,16,13,203
900141401,0,2,0,1,1,2,0,1,7
900141402,0,4,3,1,0,0,0,0,8
900141403,10,5,4,5,1,3,0,3,31
900141404,5,7,6,10,5,5,4,5,47
900141405,28,42,50,51,46,37,10,21,285
900141406,21,37,42,50,53,35,14,15,267
900141407,19,48,50,71,59,45,14,22,328
900141408,34,48,81,121,92,69,23,38,506
900141409,28,49,59,107,60,52,19,19,393
900141410,23,33,46,53,40,30,12,30,267
900141501,15,34,52,42,35,32,21,32,263
900141502,17,36,41,43,31,26,24,29,247
900141503,1,7,4,5,5,3,0,4,29
900141504,30,45,63,81,82,71,27,46,445
900141505,5,14,14,18,12,8,3,5,79
900141506,14,50,87,72,72,50,21,20,386
900141507,40,65,93,82,86,53,19,26,464
900141601,20,21,36,38,33,16,8,11,183
900141602,44,76,71,92,51,39,8,14,395
900141603,24,37,37,45,39,33,12,14,241
900141604,24,37,41,36,32,19,9,8,206
900141605,22,46,58,67,49,23,17,9,291
900141606,14,33,49,54,31,29,10,9,229
900141607,30,36,51,56,33,27,8,12,253
900141608,24,35,57,68,43,34,6,5,272
900141609,27,39,53,44,50,21,12,15,261
900141610,20,39,31,42,34,15,7,14,202
900141611,16,44,48,50,35,23,12,8,236
900141612,16,47,47,38,21,22,9,13,213
900141613,36,48,65,94,54,59,11,23,390
900141614,10,36,50,68,42,40,24,31,301
900141615,25,54,69,55,62,48,15,24,352
900141616,34,57,97,115,83,63,32,43,524
900141617,19,30,53,71,41,33,7,4,258
900141618,27,41,62,74,58,36,17,15,330
900210101,2,0,0,0,0,0,0,0,2
900210102,17,12,19,12,13,13,6,12,104
900210103,0,0,0,0,0,0,0,0,0
900210104,39,25,48,67,45,36,21,30,311
900210105,29,16,25,26,25,9,7,9,146
900210106,7,16,19,23,22,16,10,17,130
900210107,4,8,10,15,8,7,5,5,62
900210108,11,19,41,30,28,19,12,17,177
900210109,25,29,47,46,32,28,13,14,234
900210110,10,18,36,34,19,30,7,15,169
900210111,7,18,22,38,13,12,2,6,118
900210201,9,8,10,12,6,9,3,5,62
900210202,14,14,13,12,8,5,6,8,80
900210203,8,15,20,18,16,11,7,13,108
900210204,16,20,41,47,30,25,6,7,192
900210205,57,52,89,97,78,55,19,42,489
900210206,22,27,28,30,34,15,11,21,188
900210207,21,24,33,35,27,11,9,12,172
900210208,13,18,21,26,19,18,5,10,130
900210209,21,16,20,22,23,16,10,20,148
900210301,10,19,22,25,18,10,2,12,118
900210302,12,21,24,18,23,10,11,13,132
900210303,23,18,25,25,19,10,10,16,146
900210304,10,19,19,23,19,9,12,10,121
900210401,9,19,23,24,8,10,6,11,110
900210402,3,9,5,9,8,5,4,8,51
900210403,13,18,20,26,30,15,5,9,136
900210404,8,5,7,17,11,9,4,6,67
900210405,4,4,1,6,2,1,1,5,24
900210406,14,24,33,42,24,19,9,15,180
900210407,35,34,47,62,39,27,21,18,283
900210408,26,29,38,49,28,25,6,9,210
900210409,20,55,62,53,65,35,14,24,328
900210410,29,39,42,42,43,27,10,6,238
900210411,26,32,43,56,46,41,9,19,272
900210501,15,22,28,25,24,20,3,12,149
900210502,22,37,40,65,44,37,16,32,293
900210503,34,30,35,34,18,16,12,10,189
900210504,14,10,19,37,18,19,11,18,146
900210505,2,2,7,3,2,1,3,1,21
900210506,26,25,47,43,29,19,8,13,210
900210507,38,30,56,69,66,47,18,25,349
900210601,1,3,4,11,2,2,0,3,26
900210602,42,53,93,101,100,63,21,37,510
900210603,38,54,65,67,48,47,21,29,369
900210604,29,56,78,91,62,40,10,12,378
900210605,39,65,82,62,41,35,11,16,351
900210606,24,45,81,68,32,41,18,26,335
900210607,29,45,56,57,65,26,13,17,308
900210608,58,73,84,69,54,28,11,17,394
900210609,16,33,32,41,25,11,6,7,171
900210610,40,77,77,82,54,40,14,16,400
900210611,48,74,49,53,45,27,12,9,317
900210612,23,59,53,65,49,31,8,10,298
900210613,27,53,32,49,27,13,10,7,218
900210614,27,61,90,76,50,32,11,13,360
900210615,30,33,54,45,34,30,12,9,247
900210616,20,27,58,62,49,37,7,6,266
900210617,16,25,28,41,31,23,8,11,183
900210618,23,30,54,47,48,27,18,21,268
900210619,28,29,39,45,33,18,6,10,208
900210620,9,21,32,57,29,12,3,3,166
900210701,36,55,95,81,71,43,24,24,429
900210702,42,49,68,58,63,34,17,30,361
900210703,26,45,41,49,24,19,13,11,228
900210704,36,31,29,32,26,15,16,6,191
900210705,26,31,41,40,34,16,7,17,212
900210706,54,80,69,67,57,33,12,9,381
900210707,49,62,59,49,44,16,11,11,301
900210708,29,59,37,25,20,6,5,4,185
900210709,50,38,47,47,40,33,24,19,298
900210710,45,61,86,60,38,30,12,14,346
900210711,35,37,38,21,11,10,2,4,158
900210712,34,43,51,43,35,16,5,10,237
900210713,29,38,41,33,16,11,5,11,184
900210714,25,32,62,50,45,34,8,11,267
900210715,28,42,59,57,40,25,9,13,273
900210716,31,51,61,43,45,17,12,12,272
900210717,32,40,46,50,53,34,15,36,306
900210718,24,24,42,44,36,19,13,24,226
900210719,34,54,77,67,69,60,32,46,439
900210720,27,32,55,42,53,34,15,30,288
900210721,14,22,29,50,45,27,16,19,222
900210722,20,33,43,54,59,34,20,23,286
900210723,10,24,58,58,34,24,14,3,225
900210724,20,45,65,83,44,21,4,2,284
900210725,43,33,88,89,74,55,19,16,417
900210726,25,22,49,47,53,41,19,24,280
900280101,39,34,54,79,66,47,23,33,375
900280102,26,45,60,55,54,53,26,31,350
900280103,40,57,65,84,55,41,20,20,382
900280104,46,50,42,61,53,35,8,22,317
900280105,30,40,60,65,46,39,14,16,310
900280106,40,45,28,28,44,26,8,12,231
900280107,21,45,53,60,38,21,10,18,266
900280108,29,53,66,72,42,27,28,17,334
900280109,34,39,40,35,27,23,11,12,221
900280110,26,29,41,40,23,28,13,14,214
900280111,47,41,68,58,55,39,14,19,341
900280112,24,60,59,90,69,56,28,49,435
900280113,15,24,44,81,50,27,15,9,265
900280201,4,0,2,1,1,1,1,0,10
900280202,10,4,12,7,5,3,1,2,44
900280203,7,8,12,18,4,3,5,2,59
900280204,5,2,5,10,4,4,4,9,43
900280205,13,19,12,20,19,12,7,12,114
900280206,40,55,111,113,80,59,23,43,524
900280207,26,24,32,43,37,36,15,38,251
900280208,20,28,35,32,37,26,9,19,206
900280301,2,0,1,1,0,0,0,1,5
900280302,23,11,9,9,7,7,4,6,76
900280303,5,5,5,5,4,4,1,4,33
900280304,14,11,19,19,25,11,3,11,113
900280305,27,21,41,31,45,27,19,32,243
900280306,18,21,37,34,28,31,16,27,212
900280307,27,30,42,49,36,32,25,29,270
900280308,4,1,1,0,2,0,0,0,8
900280309,14,6,14,15,12,7,3,1,72
900280310,13,11,11,21,11,11,8,9,95
900280311,9,9,12,14,6,4,2,5,61
900280312,9,7,12,23,14,20,3,18,106
900280313,0,0,0,0,0,0,0,2,2
900280314,4,8,6,1,0,1,0,0,20
900280315,0,0,0,2,1,0,0,0,3
900280316,20,28,34,39,40,34,16,28,239
900280317,21,39,49,46,40,39,21,32,287
900280318,42,52,66,65,64,33,19,29,370
900280319,21,45,49,52,41,43,16,49,316
900280320,8,18,33,44,37,28,13,15,196
900350101,22,27,41,45,29,37,14,15,230
900350102,3,5,8,10,3,1,1,2,33
900350103,4,5,7,5,4,5,1,1,32
900350104,0,3,1,2,1,1,0,0,8
900350105,8,2,1,4,1,1,0,4,21
900350106,6,7,3,5,7,2,3,6,39
900350107,4,1,5,5,4,2,2,0,23
900350108,0,3,0,3,2,3,0,0,11
900350109,8,9,10,5,5,3,2,1,43
900350110,7,5,11,13,9,9,1,9,64
900350111,19,20,18,24,21,21,10,21,154
900350112,25,24,20,19,15,16,11,24,154
900350113,40,49,61,64,43,31,16,20,324
900350114,33,43,62,57,41,23,8,18,285
900350201,6,5,2,2,4,1,3,1,24
900350202,5,3,2,6,2,2,0,0,20
900350203,0,3,1,3,1,0,1,1,10
900350204,5,5,5,5,8,5,1,6,40
900350205,14,11,19,11,11,5,2,8,81
900350206,12,14,21,17,10,8,9,6,97
900350207,11,13,5,12,10,9,5,6,71
900350208,12,7,7,8,3,8,1,3,49
900350209,9,3,5,6,4,5,3,2,37
900350210,2,0,0,0,0,1,1,1,5
900350211,2,1,2,1,0,0,0,0,6
900350212,50,39,34,43,24,14,9,20,233
900350213,66,66,61,60,37,36,18,15,359
900350214,31,33,36,28,26,17,3,13,187
900350301,13,9,15,12,10,8,4,9,80
900350302,11,5,6,6,8,2,1,0,39
900350303,7,5,7,5,2,2,2,1,31
900350304,9,9,8,11,1,1,1,0,40
900350305,11,5,8,9,4,12,2,1,52
900350306,2,1,3,2,2,1,0,1,12
900350307,8,6,8,6,9,4,0,9,50
900350308,3,1,1,3,0,1,2,1,12
900350309,6,2,3,2,5,3,1,1,23
900350310,15,13,15,18,6,11,5,14,97
900350311,6,2,12,8,6,4,3,6,47
900350312,81,60,71,44,36,39,13,14,358
900420101,37,53,67,56,41,31,14,18,317
900420102,42,61,68,70,47,38,9,17,352
900420103,26,33,24,40,29,19,2,11,184
900420104,32,54,26,25,22,12,8,3,182
900420105,30,40,48,50,32,23,7,12,242
900420106,25,51,52,58,25,12,11,19,253
900420107,24,61,58,71,62,33,8,14,331
900420108,54,73,69,53,42,31,13,15,350
900420109,31,44,32,24,10,4,3,7,155
900420110,26,42,41,32,16,18,11,6,192
900420111,12,25,28,33,25,20,5,6,154
900420112,31,33,36,43,30,27,7,10,217
900420113,22,42,58,84,37,27,5,5,280
900420114,34,62,72,48,38,32,6,10,302
900420115,13,26,46,76,50,33,16,22,282
900420116,16,26,46,40,30,25,23,19,225
900420201,29,18,17,32,19,7,9,11,142
900420202,7,10,12,5,10,6,6,4,60
900420203,4,7,7,10,7,8,2,2,47
900420204,5,1,5,11,6,9,4,7,48
900420205,5,4,6,14,6,15,6,5,61
900420206,2,5,9,7,5,7,6,6,47
900420207,10,11,8,11,5,4,2,6,57
900420208,27,30,27,29,19,20,8,10,170
900420209,24,44,41,43,40,33,16,35,276
900420210,15,10,20,20,21,17,11,20,134
900420211,41,41,52,48,38,37,15,30,302
900420212,47,70,90,106,88,73,5,27,506
900420213,21,10,13,28,10,14,3,9,108
900420214,16,39,60,59,31,19,8,7,239
900420215,8,25,37,24,26,11,4,5,140
900420216,10,22,42,37,17,11,3,6,148
900420217,7,23,18,31,27,23,7,18,154
900420301,6,3,7,2,7,10,4,10,49
900420302,19,23,40,36,31,17,10,23,199
900420303,7,12,7,16,9,7,6,9,73
900420304,6,3,16,10,11,10,2,11,69
900420305,5,13,15,18,17,10,5,13,96
900420306,28,35,55,62,45,31,18,17,291
900420401,4,6,1,0,1,3,2,4,21
900420402,28,22,13,12,9,6,3,6,99
900490101,24,21,27,25,21,8,5,9,140
900490102,28,22,45,42,34,32,8,18,229
900490201,15,26,25,25,20,20,3,15,149
900490202,1,4,2,6,1,1,1,1,17
900490203,37,38,57,49,46,36,17,23,303
900490204,39,30,62,55,49,51,25,57,368
900490205,7,9,10,8,4,15,9,8,70
900490301,33,33,35,36,27,19,14,20,217
900490302,12,13,12,11,10,9,6,6,79
900490401,18,20,20,17,19,14,11,2,121
900490402,15,24,37,32,21,17,8,12,166
900490403,12,14,36,27,21,19,4,8,141
900490404,1,6,5,5,2,6,3,1,29
900490501,24,46,55,47,41,36,14,21,284
900490502,12,18,25,21,22,9,7,10,124
900490503,3,4,1,0,2,0,0,2,12
900490504,9,2,3,3,3,3,1,6,30
900490505,0,2,1,0,1,1,2,1,8
900490506,17,9,7,13,11,9,8,11,85
900490507,3,5,5,9,7,4,3,5,41
900490508,19,34,58,39,30,24,10,18,232
900490509,41,66,83,75,51,47,15,12,390
900490510,38,45,57,57,43,34,17,19,310
900490511,55,46,59,86,36,31,18,26,357
900490512,14,20,37,49,33,30,6,18,207
900490601,0,1,0,0,0,0,0,1,2
900490602,25,29,27,23,15,15,8,7,149
900490603,10,8,5,15,5,7,2,2,54
900490701,0,0,0,0,1,0,0,0,1
900490702,18,20,24,22,9,13,8,16,130
900490703,22,24,28,26,23,21,5,13,162
900560101,6,7,5,7,1,1,0,2,29
900560102,4,6,3,5,4,4,3,5,34
900560103,33,37,56,56,39,27,13,13,274
900560201,4,7,4,14,11,8,2,0,50
900560202,1,0,0,0,0,0,0,0,1
900560203,26,26,33,26,26,21,10,10,178
900560301,22,26,52,56,39,27,15,11,248
900560302,37,50,58,68,44,24,12,15,308
900560303,21,30,40,45,25,34,16,12,223
900560304,15,22,28,42,24,22,5,4,162
900560305,22,34,63,76,68,51,25,28,367
900560306,18,52,75,79,55,41,13,22,355
900560307,28,38,43,39,36,18,6,7,215
900560308,47,71,60,52,46,27,7,8,318
900560309,29,54,46,69,40,28,11,11,288
900560310,26,57,56,69,44,31,7,15,305
900560311,45,55,83,109,69,33,18,17,429
900560312,32,51,68,84,58,41,13,21,368
900560401,16,17,15,20,9,11,2,9,99
900560402,25,29,52,52,25,28,9,7,227
900560403,13,8,22,19,16,9,9,19,115
900560404,8,1,2,8,7,6,0,3,35
900560405,8,4,6,5,2,0,1,1,27
900560406,15,10,13,13,8,14,4,6,83
900560407,3,5,4,4,4,4,0,1,25
900560408,22,17,32,37,20,16,7,2,153
900560501,8,11,18,14,13,3,3,4,74
900560502,32,35,41,50,41,29,3,10,241
900560503,11,19,20,17,24,13,7,7,118
900560504,23,29,31,39,27,23,12,11,195
900560505,13,11,12,16,12,9,5,2,80
900560601,7,10,7,11,2,4,2,0,43
900560602,6,24,27,29,23,21,7,5,142
900560603,18,26,33,39,31,22,14,10,193
900560604,1,4,6,5,4,5,2,8,35
900560605,6,6,9,6,6,5,4,3,45
900560606,7,17,16,24,16,7,4,9,100
900560607,10,8,9,9,10,9,2,7,64
900560701,6,13,23,18,18,14,0,10,102
900560702,29,51,45,77,59,24,17,20,322
900560703,10,5,7,6,2,3,1,2,36
900560704,11,17,28,31,17,23,6,8,141
900560705,10,16,11,14,11,10,6,9,87
900560706,7,14,17,19,15,17,5,9,103
900560801,5,7,18,6,10,6,0,7,59
900560802,3,8,5,6,4,2,1,4,33
900560803,19,15,18,15,14,21,7,8,117
900560804,10,10,20,18,14,9,4,16,101
900560805,22,28,53,37,30,27,6,18,221
900560901,15,10,6,15,10,6,4,5,71
900560902,0,1,1,0,0,1,0,1,4
900560903,19,23,18,26,22,14,5,5,132
900560904,17,21,28,25,26,16,5,11,149
900560905,3,3,7,4,1,2,1,2,23
900560906,10,8,5,11,7,8,6,8,63
900560907,12,28,19,17,16,7,7,4,110
900560908,11,9,22,22,10,15,6,12,107
900560909,7,3,11,8,9,5,2,3,48
900560910,5,8,6,7,1,4,1,3,35
900560911,11,10,4,3,6,4,2,2,42
900561001,14,16,27,26,28,12,9,13,145
900561002,4,2,4,1,2,1,2,0,16
900561003,20,26,28,38,25,15,13,17,182
900561004,13,23,19,22,18,13,3,6,117
900561005,14,20,20,19,15,10,6,5,109
900561101,0,0,1,0,1,3,0,0,5
900561102,2,0,3,2,2,0,0,0,9
900561103,7,4,4,5,2,2,9,0,33
900561104,18,15,18,14,16,6,4,5,96
900561105,6,19,17,15,9,12,6,4,88
900561106,8,8,13,15,10,10,2,1,67
900561107,20,30,50,42,24,22,10,13,211
900561108,22,36,55,63,49,31,19,18,293
900561201,5,13,10,21,16,9,5,7,86
900561202,13,18,21,14,10,11,4,4,95
900561203,17,27,38,46,27,19,5,6,185
900561204,14,28,41,35,24,9,8,6,165
900561205,11,18,23,28,12,21,5,7,125
900561206,11,25,16,32,24,12,2,4,126
900561207,17,25,16,41,24,20,5,5,153
900561208,3,3,6,7,4,3,4,3,33
900561209,16,13,12,13,13,7,7,8,89
900561210,7,3,5,8,5,1,2,2,33
900561211,17,21,24,17,15,8,6,9,117
900561212,18,12,18,13,14,14,1,6,96
900561213,32,28,39,73,37,40,14,22,285
900561301,18,11,25,26,20,17,8,15,140
900561302,8,13,9,14,17,13,5,10,89
900561303,7,7,11,9,3,1,2,1,41
900561304,23,28,36,36,33,24,6,16,202
900561305,34,47,65,61,37,20,13,12,289
900561306,2,5,6,12,6,2,1,2,36
900561401,7,11,17,10,13,6,5,3,72
900561402,11,20,16,13,10,8,5,2,85
900561403,11,18,33,29,19,21,10,13,154
900561404,18,51,53,75,65,44,23,22,351
900561405,13,11,12,26,13,22,7,5,109
900561406,25,33,32,55,33,24,14,11,227
900561407,24,50,68,58,42,30,17,12,301
900561408,19,26,42,61,50,31,16,11,256
900630101,31,37,51,38,37,33,6,20,253
900630102,30,27,58,77,62,40,5,15,314
900630103,12,36,48,62,38,32,10,10,248
900630104,24,35,54,58,57,46,26,34,334
900630105,37,65,69,73,55,41,24,19,383
900630106,30,43,60,55,34,25,15,13,275
900630107,15,19,28,36,29,19,7,8,161
900630108,22,48,67,94,77,41,16,22,387
900630109,25,51,54,47,50,35,9,21,292
900630110,33,57,67,92,67,43,16,12,387
900630111,38,75,76,78,52,43,20,22,404
900630112,30,48,64,53,44,27,6,12,284
900630113,20,34,61,73,56,30,15,18,307
900630114,34,45,63,72,54,32,17,18,335
900630201,5,8,9,5,3,4,2,6,42
900630202,15,15,9,15,12,11,3,11,91
900630203,2,3,5,2,2,3,0,1,18
900630204,7,3,6,8,3,0,0,2,29
900630205,3,3,4,2,2,2,0,2,18
900630206,18,19,32,37,31,22,19,23,201
900630207,14,18,21,27,11,12,7,13,123
900630208,2,0,1,0,1,0,0,1,5
900630209,5,1,1,3,3,2,0,0,15
900630210,2,5,5,0,5,2,3,4,26
900630211,5,5,7,4,3,6,2,6,38
900630212,28,34,60,65,39,54,22,43,345
900630213,31,42,48,48,43,22,18,16,268
900630214,8,26,38,51,23,15,5,3,169
900630215,38,40,69,61,38,40,19,27,332
900630216,13,34,49,58,39,45,9,20,267
900630217,11,26,58,55,58,25,16,26,275
900630218,26,40,47,68,51,24,14,26,296
900630219,29,37,39,59,39,33,23,24,283
900630301,44,81,135,120,84,76,10,28,578
900630302,29,65,131,99,77,49,18,27,495
900630303,17,14,31,40,24,10,7,8,151
900630304,2,4,3,10,7,2,4,5,37
900630305,39,60,97,91,80,63,32,37,499
900630401,4,0,2,0,1,0,0,1,8
900630402,2,3,5,4,2,1,1,2,20
900630403,15,14,24,27,26,16,9,12,143
900630404,45,48,63,53,43,34,25,37,348
900630405,4,6,6,12,4,11,3,7,53
900630406,6,11,12,11,12,5,9,15,81
900630407,3,3,2,2,7,5,2,3,27
900630408,7,17,25,46,24,14,6,6,145
900630409,0,0,0,0,0,0,1,0,1
900630410,11,10,5,9,6,6,4,6,57
900630411,7,9,21,28,19,22,10,12,128
900630412,8,14,19,19,28,21,8,19,136
900630413,40,42,76,83,72,63,17,29,422
900630414,10,28,28,57,49,20,11,10,213
900630415,7,16,30,51,38,34,7,24,207
900630416,3,5,16,15,10,8,4,6,67
900630417,17,29,46,51,35,20,8,10,216
900630418,14,33,47,63,39,38,11,17,262
900630419,32,39,56,70,64,49,19,27,356
900630420,18,25,48,33,35,24,13,16,212
900630501,25,54,54,54,44,32,23,32,318
900630502,24,37,41,42,30,20,9,10,213
900630503,28,56,69,83,81,38,15,19,389
900630504,27,53,53,54,51,28,11,11,288
900630505,47,49,65,74,51,30,10,10,336
900630506,26,43,68,85,59,33,10,17,341
900630507,33,45,80,74,57,47,19,26,381
900630508,31,33,49,62,35,32,13,16,271
900630509,40,61,75,90,77,50,24,24,441
900630510,28,40,57,76,63,51,19,26,360
900630511,23,35,63,62,36,44,16,20,299
900630512,21,26,67,74,55,46,11,21,321
900630513,31,50,64,71,57,29,15,19,336
900700101,7,15,27,20,14,10,5,11,109
900700102,7,7,17,30,22,18,4,4,109
900700201,7,4,2,3,2,2,2,0,22
900700202,8,6,14,8,14,5,4,11,70
900700203,17,8,23,27,10,13,7,6,111
900700204,24,37,43,45,28,29,5,14,225
900700205,28,45,68,59,62,37,21,32,352
900700206,54,45,54,48,49,36,9,21,316
900700207,6,13,42,49,31,18,13,11,183
900700208,23,38,36,41,29,36,15,21,239
900700301,34,49,67,73,65,39,16,32,375
900700302,4,4,4,4,4,7,3,5,35
900700303,6,6,2,5,5,4,4,1,33
900700304,3,6,4,2,6,2,6,2,31
900700305,2,9,9,6,9,9,2,2,48
900700306,31,29,34,40,27,15,14,11,201
900700307,32,38,40,52,37,28,12,17,256
900700401,7,13,14,11,10,5,4,2,66
900700402,11,10,15,11,9,7,6,15,84
900700403,49,59,56,51,33,23,16,18,305
900700404,19,39,25,32,29,17,9,12,182
900700405,14,28,20,21,13,9,7,9,121
900700406,28,20,27,26,25,18,13,16,173
900700407,8,13,15,11,7,3,4,6,67
900700408,7,8,10,10,6,2,2,3,48
900700409,30,33,43,38,34,15,8,10,211
900700410,6,6,8,9,6,6,2,3,46
900700411,14,12,7,13,13,9,2,6,76
900700412,30,41,48,47,35,41,13,15,270
900700413,36,41,51,54,59,35,19,34,329
900700414,17,27,43,49,31,27,10,22,226
900700501,15,30,24,22,17,19,4,11,142
900700502,32,32,36,19,15,13,9,5,161
900700601,0,1,1,1,0,0,0,0,3
900700602,13,31,45,61,49,43,13,30,285
900700603,29,31,38,51,32,13,8,10,212
900700604,28,40,47,54,33,25,19,18,264
900700605,20,40,40,39,14,15,14,15,197
900700606,36,35,47,47,30,22,10,13,240
900700607,15,31,45,46,42,42,17,16,254
900700701,9,11,19,20,15,9,1,8,92
900700702,6,3,6,11,6,6,0,8,46
900700703,3,0,0,0,0,0,0,0,3
900700801,3,5,3,5,5,5,1,10,37
900700802,2,0,1,4,0,3,0,1,11
900700803,15,13,10,9,13,12,5,10,87
900700804,11,17,24,46,19,24,4,7,152
900700805,21,16,35,27,33,18,12,12,174
900700806,31,39,37,45,28,9,16,18,223
900700807,36,52,97,65,66,58,30,36,440
900700808,24,25,31,30,23,11,15,14,173
900700901,0,0,0,0,0,0,0,0,0
900700902,12,10,8,12,5,5,3,9,64
900700903,33,50,44,61,31,36,15,28,298
900700904,8,13,6,16,10,9,4,4,70
900701001,2,1,0,0,0,0,0,0,3
900701002,5,11,13,23,14,9,7,4,86
900701003,8,9,21,15,11,11,0,7,82
900701101,3,7,17,16,11,5,7,10,76
900701102,3,10,17,26,24,13,8,7,108
900701201,1,2,0,0,0,0,0,0,3
900701202,17,14,7,9,7,9,1,2,66
900701203,11,17,25,24,17,6,10,4,114
900701204,23,27,31,32,33,19,10,8,183
900701301,32,40,61,88,60,40,13,25,359
900701302,18,12,33,21,15,14,7,7,127
900701303,18,28,36,37,45,28,9,16,217
900701304,17,33,66,120,62,27,4,7,336
900701401,25,51,24,41,18,18,4,5,186
900701402,24,37,40,37,36,22,14,20,230
900701403,28,40,31,29,24,13,4,5,174
900701404,36,55,39,33,31,16,6,6,222
900701405,33,53,63,62,50,36,19,17,333
900701406,31,52,66,75,66,26,10,14,340
900701407,21,43,38,38,26,15,4,2,187
900701408,29,36,32,25,16,18,8,4,168
900701409,41,56,89,96,63,40,20,19,424
900701410,37,57,67,53,46,29,13,10,312
900701411,24,53,53,31,30,19,8,1,219
900701412,26,34,44,49,34,24,8,13,232
900701413,36,38,24,25,19,10,3,2,157
900701414,25,39,50,46,33,21,5,7,226
900701415,42,63,54,84,60,34,11,9,357
900701416,27,49,53,59,33,20,2,9,252
900701417,33,70,103,67,73,29,18,20,413
900701418,39,45,57,62,70,45,17,27,362
900701419,38,64,85,74,42,26,8,9,346
900701420,20,43,53,74,44,39,7,11,291
900701421,24,32,40,48,31,14,5,12,206
900770101,36,38,66,78,47,33,11,22,331
900770102,39,41,69,64,51,34,10,20,328
900770103,44,66,59,57,48,33,5,16,328
900770104,38,55,91,74,65,51,22,27,423
900770105,50,60,80,80,58,41,26,17,412
900770106,31,53,51,80,46,39,9,23,332
900770107,20,48,39,42,44,28,9,14,244
900770108,46,48,49,39,30,22,5,4,243
900770109,31,52,44,39,44,22,10,11,253
900770110,43,63,68,66,50,17,8,7,322
900770111,44,43,52,53,28,17,7,2,246
900770112,21,50,40,54,35,13,10,8,231
900770113,28,37,37,50,43,26,3,13,237
900770114,14,16,47,23,26,18,5,7,156
900770115,22,56,73,73,50,49,12,20,355
900770116,46,59,61,66,32,27,13,17,321
900770117,29,59,59,53,46,15,6,11,278
900770118,29,40,36,33,25,11,3,11,188
900770119,28,37,48,59,41,23,7,19,262
900770120,37,39,54,50,50,30,16,23,299
900770121,31,48,64,52,51,38,12,11,307
900770122,34,44,37,46,33,22,9,7,232
900770123,21,36,49,46,30,19,7,14,222
900770124,17,35,49,53,40,23,9,11,237
900770201,5,4,14,15,9,4,2,9,62
900770202,34,31,48,66,43,32,13,20,287
900770203,17,26,53,53,31,31,3,8,222
900770204,8,7,10,15,13,4,5,7,69
900770205,5,1,2,0,0,2,0,1,11
900770206,9,7,6,8,9,4,3,5,51
900770207,6,3,13,8,11,9,5,6,61
900770208,2,0,0,1,1,1,0,0,5
900770209,26,28,56,68,49,37,18,26,308
900770210,28,42,53,71,73,38,25,42,372
900770211,21,36,45,61,42,28,8,11,252
900770212,11,17,34,41,16,2,1,0,122
900770213,20,29,57,76,51,22,7,8,270
900770214,23,24,22,40,17,13,12,8,159
900770301,14,9,24,18,13,9,5,11,103
900770302,19,26,17,23,25,14,10,11,145
900770401,0,0,0,1,0,1,0,0,2
900770402,3,2,0,2,1,0,0,0,8
900770403,20,17,22,35,31,29,28,26,208
900770404,24,28,63,62,48,33,14,14,286
900770405,29,35,41,39,28,20,11,4,207
900770406,12,15,20,28,26,10,13,20,144
900770407,25,40,47,54,36,32,16,28,278
900770408,9,6,15,14,10,6,5,7,72
900770409,19,12,26,31,21,12,7,14,142
900770410,6,14,15,18,14,18,2,10,97
900770411,12,15,26,21,24,15,11,20,144
900770412,5,10,13,5,18,9,3,11,74
900770413,21,22,27,33,26,25,4,13,171
900770414,34,58,64,63,71,31,17,33,371
900770415,21,41,32,44,43,41,15,10,247
900770416,11,10,18,28,31,12,5,14,129
900770417,34,35,63,54,54,34,10,17,301
900770418,17,14,34,33,30,15,5,2,150
900770419,18,14,34,25,36,26,9,14,176
900770501,18,17,34,36,27,15,11,11,169
900770601,24,33,39,29,27,23,12,15,202
900770602,20,20,23,44,34,24,10,25,200
900770603,4,6,10,11,8,10,4,3,56
900770604,8,6,9,10,10,8,2,2,55
900770605,32,21,25,22,34,23,8,15,180
900770606,39,47,63,66,47,37,22,19,340
900770607,29,47,65,100,70,48,18,16,393
900840101,20,18,28,36,27,28,10,20,187
900840102,16,27,38,48,44,20,10,16,219
900840103,24,56,74,84,66,32,7,7,350
900840104,30,56,66,86,51,31,18,5,343
900840105,14,35,62,111,64,22,0,1,309
900840106,17,43,89,113,75,41,11,3,392
900840107,23,50,87,107,50,22,8,10,357
900840108,21,34,64,84,73,30,8,7,321
900840109,37,40,61,33,34,22,12,8,247
900840110,22,56,56,64,31,24,9,9,271
900840111,22,35,41,61,43,27,7,18,254
900840112,35,62,68,83,31,39,11,13,342
900840113,24,47,79,109,76,25,15,4,379
900840114,17,52,68,62,53,20,10,15,297
900840115,15,51,50,57,40,26,18,19,276
900840116,32,34,44,52,35,35,6,19,257
900840117,23,36,39,36,27,16,12,7,196
900840118,32,32,35,38,13,6,5,1,162
900840119,40,42,41,32,24,7,2,5,193
900840120,18,50,61,41,28,13,3,7,221
900840121,19,46,42,50,35,19,4,0,215
900840122,20,46,38,56,27,13,5,2,207
900840123,38,82,89,94,57,35,17,13,425
900840124,26,58,71,78,67,33,8,5,346
900840125,13,30,44,75,62,31,9,4,268
900840126,32,47,67,102,74,34,10,10,376
900840201,14,23,29,30,29,24,6,10,165
900840202,25,26,48,70,41,40,26,28,304
900840203,20,23,42,67,61,46,9,7,275
900840204,29,20,37,26,34,31,6,8,191
900840205,57,62,105,109,75,48,18,23,497
900840206,26,47,50,54,47,24,13,9,270
900840207,13,36,40,24,34,20,7,9,183
900840208,19,59,94,88,63,38,10,9,380
900840209,17,45,64,66,49,24,7,6,278
900840210,42,82,51,56,51,26,6,2,316
900840211,25,42,44,30,22,12,7,4,186
900840212,33,84,82,79,57,39,12,17,403
900840213,27,45,50,43,28,18,6,4,221
900840214,36,45,51,59,38,16,9,4,258
900840215,28,39,39,42,29,12,7,1,197
900840216,18,54,44,40,25,8,6,4,199
900840217,24,42,60,39,39,15,5,5,229
900840218,24,53,45,55,31,14,4,2,228
900840219,45,56,71,56,32,13,5,3,281
900840220,24,52,56,38,26,8,4,3,211
900840221,39,62,73,80,68,42,21,21,406
900840222,30,46,57,58,50,37,18,28,324
900840223,23,34,35,47,44,12,5,5,205
900840301,38,56,80,79,65,74,18,45,455
900840302,38,36,71,85,60,55,30,34,409
900840303,42,64,56,67,54,40,26,13,362
900840304,33,57,71,76,50,39,18,14,358
900840305,19,43,57,58,48,22,11,14,272
900840306,42,60,67,67,45,39,18,12,350
900840307,39,66,62,68,51,32,9,7,334
900840308,41,57,61,51,39,16,14,14,293
900840309,22,42,41,49,28,16,9,10,217
900840310,32,60,66,71,54,39,7,11,340
900840311,23,36,37,36,29,13,11,11,196
900840312,28,25,39,41,30,13,9,16,201
900840313,40,64,61,49,28,19,1,4,266
900840314,26,21,36,32,21,13,5,6,160
900840315,24,38,36,34,24,10,2,0,168
900840401,34,51,72,83,57,50,23,27,397
900840402,28,68,64,85,41,33,18,12,349
900840403,26,49,66,67,35,36,10,16,305
900840404,21,53,64,69,57,39,15,16,334
900840405,26,59,57,48,50,21,9,18,288
900840406,22,57,44,57,45,32,12,17,286
900840407,18,41,48,50,49,36,12,22,276
900840408,8,11,16,21,22,13,2,8,101
900840409,15,24,35,60,42,42,8,18,244
900840410,13,30,41,44,44,35,12,28,247
900840411,17,43,37,39,27,24,6,7,200
900840412,32,33,51,38,27,23,9,6,219
900840413,26,26,34,34,33,44,16,35,248
900840414,17,31,29,44,30,27,8,19,205
900840415,22,50,78,69,92,66,32,39,448
900840416,24,44,73,67,67,50,23,35,383
900840501,34,69,70,63,47,36,8,6,333
900840502,20,44,38,35,33,23,6,9,208
900840503,47,51,47,65,48,20,3,5,286
900840504,38,33,31,37,27,14,0,5,185
900840505,22,36,45,35,30,20,4,3,195
900840506,28,44,60,50,52,42,14,20,310
900840507,21,25,37,40,40,21,14,30,228
900840508,24,19,31,26,26,24,10,24,184
900840509,22,22,31,35,27,14,5,7,163
900840510,15,33,32,31,26,21,11,8,177
900840511,20,32,38,29,21,16,3,5,164
900840512,39,50,48,43,14,15,5,4,218
900840513,64,82,54,42,21,13,5,4,285
900840601,11,37,27,25,22,23,5,5,155
900840602,41,76,81,72,52,39,12,18,391
900840603,20,45,52,53,37,27,7,10,251
900840604,36,51,51,58,48,28,12,10,294
900840605,47,78,62,59,53,28,14,11,352
900840606,30,41,49,53,26,35,11,12,257
900840607,41,39,44,42,34,33,11,11,255
900840608,33,53,45,66,44,30,6,24,301
900840609,33,32,29,44,27,18,6,21,210
900840610,29,40,50,37,27,13,7,4,207
900840611,35,43,46,34,24,15,4,5,206
900840612,26,22,27,26,11,10,2,5,129
900840613,30,34,34,32,17,7,5,1,160
900840614,33,38,38,24,12,10,1,2,158
900840701,33,49,40,65,54,33,25,21,320
900840702,11,31,31,32,20,17,5,8,155
900840703,27,63,49,48,40,35,9,14,285
900840704,46,80,85,55,46,32,9,11,364
900840705,31,46,49,61,39,17,6,4,253
900840706,43,67,62,74,50,30,13,18,357
900840707,48,58,62,58,42,21,10,5,304
900840708,49,90,79,80,49,19,11,10,387
900840709,51,66,53,52,51,17,10,4,304
900840710,18,48,30,40,24,16,5,7,188
900840711,27,40,42,51,32,23,2,7,224
900840712,74,80,54,39,22,5,5,1,280
900840713,31,46,34,27,26,14,4,4,186
900840714,45,64,37,32,29,6,3,1,217
900840801,23,34,39,42,21,23,11,15,208
900840802,24,31,35,29,26,27,9,13,194
900840803,26,47,71,56,54,50,16,20,340
900840804,20,30,32,48,32,41,19,19,241
900840805,32,74,87,101,78,54,26,36,488
900840806,30,42,50,48,50,33,7,13,273
900840807,29,46,48,44,33,33,11,15,259
900840808,37,51,61,61,56,28,14,21,329
900840809,20,40,44,48,33,25,8,8,226
900840810,30,50,41,58,45,19,5,6,254
900840811,40,69,58,48,41,25,11,6,298
900840812,41,68,63,73,41,31,18,16,351
900840813,36,46,38,52,39,35,6,19,271
900840814,42,56,96,124,83,57,18,42,518
900840815,22,37,35,37,40,26,11,20,228
900840816,44,63,64,60,36,34,14,14,329
900840817,39,41,48,37,24,13,6,5,213
900840818,32,27,32,30,27,17,4,10,179
900840819,28,38,79,59,55,50,7,17,333
900840820,46,34,52,34,39,39,10,20,274
900840901,31,37,36,36,26,16,5,6,193
900840902,49,65,59,47,34,18,12,6,290
900840903,33,51,42,34,25,21,6,5,217
900840904,37,36,37,47,29,9,6,9,210
900840905,33,65,49,46,30,16,9,4,252
900840906,22,32,36,21,27,17,9,14,178
900840907,16,35,35,40,20,31,12,12,201
900840908,25,43,36,33,33,20,6,4,200
900840909,24,29,42,31,21,16,5,2,170
900840910,27,50,39,34,21,20,5,4,200
900840911,55,66,49,57,29,20,8,8,292
900840912,37,25,27,19,16,17,2,2,145
900840913,83,30,30,7,4,2,1,1,158
900840914,63,55,38,52,30,21,3,1,263
900840915,53,72,56,54,34,17,11,9,306
900841001,25,47,90,63,42,24,4,4,299
900841002,33,51,95,118,98,62,20,25,502
900841003,16,27,32,48,44,44,10,19,240
900841004,30,33,65,77,62,63,11,21,362
900841005,34,51,67,71,51,35,20,34,363
900841006,25,30,48,47,43,51,22,32,298
900841007,6,29,25,29,20,31,9,24,173
900841008,34,57,53,75,55,45,25,35,379
900841009,18,29,53,39,62,35,18,31,285
900841010,34,63,89,96,72,51,16,17,438
900841011,41,36,65,74,65,37,13,19,350
900841012,17,29,59,67,30,19,5,5,231
900841013,25,46,41,61,45,26,14,18,276
900841014,21,27,37,37,36,30,11,8,207
900841015,21,31,36,39,18,22,5,8,180
900841016,47,68,65,41,27,14,2,0,264
900841017,19,42,42,43,42,26,5,2,221
900841018,24,47,53,58,43,25,4,11,265
900841019,13,21,40,36,28,11,3,5,157
900841020,40,50,66,44,45,36,11,11,303
900841021,14,16,19,19,18,5,2,1,94
900841022,28,63,50,42,33,19,11,11,257
900841023,54,73,106,70,48,28,8,15,402
900841024,40,61,54,89,45,44,10,9,352
900841025,12,12,22,15,11,4,4,6,86
900841101,61,53,47,29,24,12,2,1,229
900841102,90,78,54,32,13,10,4,1,282
900841103,41,60,39,27,21,15,5,4,212
900841104,63,51,28,29,12,12,1,2,198
900841105,20,30,42,52,57,44,13,19,277
900841106,27,31,49,57,63,43,18,37,325
900841107,36,33,45,56,57,43,18,31,319
900841108,23,36,51,49,45,39,14,40,297
900841109,14,40,58,60,45,57,18,29,321
900841110,16,42,44,39,36,20,16,15,228
900841111,44,53,62,74,42,33,5,5,318
900841112,36,55,54,52,29,13,7,2,248
900841113,35,48,43,48,27,20,10,12,243
900841201,55,75,50,56,17,13,1,1,268
900841202,60,77,60,40,21,4,2,5,269
900841203,100,96,45,37,12,9,4,2,305
900841204,98,81,46,22,5,2,1,0,255
900841205,53,56,41,21,14,3,0,1,189
900841206,34,56,29,26,18,2,2,2,169
900841207,59,95,39,34,19,10,1,0,257
900841208,100,116,49,38,33,12,3,6,357
900841209,132,109,62,35,13,5,1,0,357
900841210,102,96,35,30,20,7,2,1,293
900841211,70,82,44,33,24,12,1,0,266
900841212,128,97,61,38,17,7,0,1,349
900841213,61,65,35,34,17,3,1,1,217
900841214,69,96,47,39,21,8,3,0,283
900841215,56,54,29,18,11,3,1,0,172
900841216,139,105,67,52,20,10,2,2,397
900841217,81,80,41,21,12,0,0,0,235
900841218,66,61,38,20,14,4,0,0,203
900841219,136,102,64,47,12,7,5,0,373
900841220,92,98,55,30,12,11,0,1,299
900841221,104,87,43,35,14,10,1,0,294
900841222,56,53,25,22,10,4,0,0,170
900841223,81,80,37,19,14,4,0,0,235
900841224,39,38,14,9,3,2,0,0,105
900841225,142,92,37,13,4,2,0,0,290
900841226,96,91,47,40,27,5,1,2,309
900841301,55,48,37,40,25,6,2,3,216
900841302,55,56,42,34,22,14,5,9,237
900841303,39,50,35,18,22,8,2,3,177
900841304,67,71,42,29,8,2,1,0,220
900841305,73,91,55,41,18,10,3,1,292
900841306,129,107,50,23,11,9,2,0,331
900841307,34,32,23,13,11,2,5,0,120
900841308,70,59,49,35,16,8,2,1,240
900841309,109,98,47,28,17,9,1,1,310
900841310,97,80,46,19,12,3,1,0,258
900841311,39,42,33,18,5,8,1,0,146
900841312,111,107,64,29,22,6,0,0,339
900841313,55,26,7,8,6,3,0,0,105
900841314,61,83,46,26,6,6,2,1,231
900841315,65,52,29,16,8,5,1,0,176
900841316,68,62,25,31,10,5,1,0,202
900841317,63,67,39,39,21,8,3,2,242
900841318,54,66,64,57,43,19,7,3,313
900841401,36,60,69,68,49,26,8,21,337
900841402,45,64,48,44,34,18,4,10,267
900841403,26,49,37,40,24,10,4,0,190
900841404,49,76,81,58,50,28,16,13,371
900841405,58,74,72,65,44,24,7,4,348
900841406,48,54,59,54,38,19,6,9,287
900841407,42,78,67,66,33,15,8,2,311
900841408,74,68,37,45,27,9,4,3,267
900841409,35,47,37,37,38,18,1,2,215
900841410,29,38,49,51,40,17,8,2,234
900841411,28,65,54,58,38,16,13,10,282
900841412,29,73,74,49,51,24,7,8,315
900841413,49,49,50,47,33,26,9,7,270
900841414,25,50,52,53,33,34,7,13,267
900841501,39,45,63,47,38,27,1,5,265
900841502,61,75,63,61,48,25,10,8,351
900841503,27,46,40,57,28,16,3,10,227
900841504,51,62,74,76,55,26,9,7,360
900841505,61,61,53,49,37,31,6,13,311
900841506,40,71,65,69,36,23,10,14,328
900841507,28,33,20,21,12,15,2,2,133
900841508,32,37,30,25,13,10,4,3,154
900841509,67,92,60,69,50,21,7,7,373
900841510,51,54,61,58,40,27,6,8,305
900841511,19,34,37,35,24,11,6,5,171
900841512,27,33,39,34,13,14,5,2,167
900841513,34,45,36,40,20,13,2,2,192
900841601,35,53,63,73,34,25,9,5,297
900841602,35,57,53,46,39,9,3,6,248
900841603,35,60,66,48,63,27,3,8,310
900841604,53,90,99,99,61,32,8,3,445
900841605,39,59,60,67,56,31,15,10,337
900841606,24,58,36,39,32,13,3,6,211
900841607,35,88,75,89,57,29,10,5,388
900841608,40,72,77,83,44,14,3,5,338
900841609,37,48,56,36,34,32,8,12,263
900841610,24,46,54,42,28,14,6,3,217
900841611,25,70,74,72,59,41,3,8,352
900841612,19,46,40,48,29,16,9,6,213
900841613,21,48,30,45,23,13,4,2,186
900841614,27,51,49,54,35,27,6,4,253
900841615,26,59,65,88,84,38,7,7,374
900841616,28,49,52,82,30,14,5,5,265
900841617,14,26,46,63,60,43,10,15,277
900841618,35,38,49,66,53,41,22,19,323
900841619,38,47,48,63,41,22,5,12,276
900841620,38,52,64,65,54,21,12,11,317
900841621,29,48,61,45,37,24,9,15,268
900841622,21,25,35,34,24,14,7,5,165
900841701,35,59,61,55,36,20,13,13,292
900841702,53,67,67,67,41,33,11,9,348
900841703,45,87,69,48,24,20,9,9,311
900841704,44,50,66,61,38,31,11,14,315
900841705,52,68,42,46,37,24,6,8,283
900841706,28,58,48,48,40,30,14,14,280
900841707,18,30,38,39,24,27,8,3,187
900841708,45,77,80,63,56,31,8,11,371
900841709,34,67,77,70,56,30,10,16,360
900841710,22,20,23,24,17,13,3,6,128
900841711,23,27,56,45,25,30,8,11,225
900841712,31,65,55,65,39,19,16,7,297
900841801,105,121,99,58,38,19,3,4,447
900841802,43,70,61,47,41,20,2,3,287
900841803,38,43,26,29,18,7,5,1,167
900841804,29,43,27,24,10,8,2,1,144
900841805,75,90,62,57,28,15,5,2,334
900841806,89,99,64,49,30,17,5,4,357
900841807,56,67,64,62,40,23,12,8,332
900841808,124,103,64,54,46,22,7,4,424
900841809,75,102,48,36,31,14,5,7,318
900841810,38,41,38,40,25,21,3,11,217
900841811,56,72,54,67,30,21,9,12,321
900841812,108,80,41,20,17,3,3,1,273
900841901,76,60,49,24,13,6,4,1,233
900841902,78,86,57,31,23,8,1,1,285
900841903,125,84,53,16,10,3,0,1,292
900841904,59,54,33,22,9,4,1,2,184
900841905,34,47,41,28,22,10,1,2,185
900841906,35,53,39,29,13,2,1,2,174
900841907,51,75,69,54,34,9,0,4,296
900841908,49,51,26,33,17,12,2,3,193
900841909,145,105,41,34,22,5,3,1,356
900841910,81,85,39,24,18,11,2,3,263
900841911,145,113,46,33,17,8,0,2,364
900841912,66,59,42,15,15,6,2,1,206
900841913,46,50,42,32,20,15,3,1,209
900841914,46,56,33,21,22,10,3,2,193
900841915,32,43,30,30,19,9,0,1,164
900841916,123,99,41,23,6,4,0,0,296
900841917,57,57,23,10,6,3,2,2,160
900841918,50,52,39,21,6,4,1,0,173
900841919,91,103,71,62,27,16,3,7,380
900842001,54,66,26,20,15,1,2,0,184
900842002,61,72,41,18,12,2,1,0,207
900842003,60,71,22,18,11,3,0,0,185
900842004,37,45,28,15,8,3,0,0,136
900842005,71,74,31,14,3,4,1,0,198
900842006,73,63,19,26,7,1,1,1,191
900842007,116,105,57,34,12,6,2,1,333
900842008,61,60,38,27,11,7,2,1,207
900842009,102,66,38,22,8,6,3,1,246
900842010,89,66,42,21,23,5,1,2,249
900842011,66,56,20,20,11,4,0,1,178
900842012,76,91,39,38,13,9,1,1,268
900842013,73,47,35,28,14,4,4,0,205
900842014,70,62,25,17,6,4,1,2,187
900842015,103,85,52,32,15,3,1,0,291
900842016,91,78,29,17,13,3,0,2,233
900842017,96,66,37,18,9,3,2,0,231
900842018,105,102,73,58,23,9,4,1,375
900842019,83,74,50,58,17,11,6,4,303
900842101,40,42,31,37,10,5,1,3,169
900842102,96,92,54,53,22,7,2,3,329
900842103,41,47,35,22,7,11,2,0,165
900842104,66,78,32,23,16,6,2,1,224
900842105,27,37,28,26,22,13,3,3,159
900842106,43,74,58,46,37,19,9,13,299
900842107,98,72,73,60,31,21,5,6,366
900842108,56,62,39,32,19,12,1,2,223
900842109,54,62,50,41,24,14,5,3,253
900842110,38,71,70,78,33,21,7,5,323
900842111,15,19,29,34,28,24,13,15,177
900842112,62,47,44,39,23,15,1,4,235
900842113,44,56,71,68,54,42,17,32,384
900842114,32,46,75,96,75,60,27,39,450
900842115,12,38,42,45,38,33,8,18,234
900842116,24,25,39,32,21,18,3,4,166
900842117,20,34,25,37,28,14,5,6,169
900842118,16,32,47,44,33,24,12,9,217
900842119,23,71,73,66,54,59,20,27,393
900842120,97,74,33,24,12,5,1,1,247
900842121,58,64,29,25,17,11,3,2,209
900842122,41,48,37,32,17,14,4,3,196
900842123,0,0,0,0,0,0,0,0,0
900842201,44,51,57,79,57,42,26,46,402
900842202,19,55,70,67,51,53,19,35,369
900842203,13,20,50,48,33,31,10,24,229
900842204,16,22,37,41,40,28,7,9,200
900842205,22,35,42,42,36,25,6,12,220
900842206,19,36,82,69,51,42,13,21,333
900842207,44,62,73,104,76,62,15,45,481
900842208,18,32,50,46,41,40,22,17,266
900842209,23,41,59,53,32,33,5,14,260
900842210,42,46,47,53,45,30,13,16,292
900842211,21,31,33,48,36,25,12,22,228
900842212,16,20,34,37,25,24,15,23,194
900842213,30,36,46,61,45,42,18,32,310
900842214,31,55,71,65,59,64,16,30,391
900842215,24,43,88,93,70,49,21,39,427
900842216,29,33,57,75,66,26,22,21,329
900842217,19,41,62,83,46,63,37,38,389
900842218,10,17,24,24,34,24,16,15,164
900842219,21,37,54,65,55,57,24,28,341
900842220,30,43,65,57,44,48,11,28,326
900842221,14,22,42,68,57,46,22,42,313
900842222,8,9,16,24,32,22,9,13,133
900842223,23,23,36,38,37,38,7,20,222
900842301,43,44,38,38,21,22,4,10,220
900842302,56,48,31,38,26,15,3,3,220
900842303,24,32,29,29,27,12,3,3,159
900842304,30,64,83,62,47,30,8,4,328
900842305,41,56,63,53,45,22,14,12,306
900842306,45,60,84,75,53,46,8,20,391
900842307,52,48,44,40,29,22,1,7,243
900842308,40,51,49,42,27,19,8,6,242
900842309,41,65,52,50,53,30,12,14,317
900842310,45,74,45,77,47,25,11,12,336
900842311,36,78,84,55,45,41,6,15,360
900842312,38,48,47,51,43,21,8,8,264
900842313,31,38,33,35,25,19,12,8,201
900842314,38,27,53,39,39,24,3,5,228
900842401,38,45,45,49,28,20,10,20,255
900842402,62,61,70,59,43,23,12,8,338
900842403,87,73,60,65,46,36,9,9,385
900842404,64,84,69,65,58,26,13,12,391
900842405,60,49,35,36,27,26,5,13,251
900842406,58,63,71,65,45,24,10,8,344
900842407,30,21,23,37,27,15,4,9,166
900842408,35,50,65,85,76,40,14,29,394
900842409,45,68,55,69,42,36,10,25,350
900842410,50,68,63,61,47,16,11,9,325
900842411,27,36,47,39,35,18,9,6,217
900842412,39,58,54,58,41,30,9,9,298
900842413,48,64,50,43,28,20,7,10,270
900842414,45,50,46,43,42,26,12,19,283
900842415,35,53,89,113,72,60,23,37,482
900842416,46,59,98,110,89,46,14,23,485
900842417,22,33,32,38,37,21,7,25,215
900842418,23,44,65,66,40,30,11,19,298
900842419,35,34,45,27,17,24,8,9,199
900842420,34,50,50,38,56,15,4,14,261
900842501,34,45,77,78,80,47,30,36,427
900842502,24,11,26,34,24,24,5,15,163
900842503,37,52,78,77,45,23,10,11,333
900842504,26,46,61,49,38,31,12,13,276
900842505,25,60,58,97,58,37,10,7,352
900842506,19,30,46,28,24,21,8,4,180
900842507,47,80,57,76,64,49,15,19,407
900842508,24,57,81,78,55,51,17,24,387
900842509,32,58,53,56,24,23,6,6,258
900842510,23,38,44,55,44,33,14,13,264
900842511,32,57,83,95,90,73,20,30,480
900842512,30,60,68,83,61,44,21,20,387
900842513,55,86,75,73,58,29,13,14,403
900842514,29,51,62,73,53,28,16,17,329
900842515,27,49,47,53,38,26,9,13,262
900842516,15,35,41,36,31,21,14,14,207
900842517,21,35,53,53,40,36,15,22,275
900842518,17,43,63,50,44,40,10,21,288
900842519,18,24,41,41,45,35,16,31,251
900842601,42,55,81,86,62,45,11,30,412
900842602,19,19,27,41,49,35,14,20,224
900842603,13,33,29,48,43,21,11,11,209
900842604,35,49,62,70,55,34,13,22,340
900842605,30,37,59,59,52,46,17,25,325
900842606,21,37,47,63,46,33,7,9,263
900842607,25,41,44,75,42,34,12,7,280
900842608,17,58,76,50,25,15,1,3,245
900842609,26,27,34,42,38,33,9,5,214
900842610,29,32,32,36,44,34,18,16,241
900842611,35,57,43,42,43,36,9,17,282
900842612,26,37,39,43,41,28,13,21,248
900842613,23,32,36,36,32,20,11,8,198
900842614,17,29,56,73,59,43,11,32,320
900842615,53,37,69,94,63,42,12,18,388
900842616,25,53,65,61,70,41,17,24,356
900842701,33,41,39,45,44,35,7,11,255
900842702,35,71,82,98,66,54,15,34,455
900842703,28,55,62,48,43,21,12,14,283
900842704,34,61,64,58,43,32,12,19,323
900842705,35,50,53,72,60,45,16,17,348
900842706,38,49,74,75,69,38,15,25,383
900842707,30,34,49,77,51,50,25,48,364
900842708,37,44,64,60,57,38,19,21,340
900842709,20,35,55,66,70,68,23,32,369
900842710,34,58,71,58,53,61,19,28,382
900842711,25,35,57,51,37,40,23,18,286
900842712,16,24,49,40,36,20,10,21,216
900842713,29,55,45,63,31,17,7,1,248
900842714,35,75,84,85,43,44,11,19,396
900842801,31,52,79,102,67,46,20,19,416
900842802,36,42,47,63,59,30,15,17,309
900842803,36,73,81,84,84,82,10,16,466
900842804,49,33,49,50,38,30,8,12,269
900842805,18,25,50,65,69,34,13,21,295
900842806,18,31,45,74,41,46,17,22,294
900842807,16,21,33,58,58,36,22,31,275
900842808,36,36,65,52,31,26,11,18,275
900842809,24,47,39,44,29,37,10,12,242
900842810,26,32,64,48,39,38,10,14,271
900842811,20,51,53,67,58,36,10,19,314
900842812,35,49,73,69,60,50,18,15,369
900842813,14,28,59,52,48,35,20,15,271
900842814,20,27,43,29,30,23,12,16,200
900842815,24,31,60,70,68,45,16,20,334
900842816,22,32,59,52,46,42,11,25,289
900842817,12,27,55,75,54,32,16,14,285
900842818,24,49,48,71,53,24,4,5,278
900842819,12,37,48,87,55,25,3,6,273
900842820,19,31,37,55,54,23,11,2,232
900842821,15,34,42,65,33,23,7,2,221
900842822,34,57,52,88,51,27,15,13,337
900842823,31,58,67,58,45,23,12,14,308
900842824,27,59,77,118,65,38,13,20,417
900842901,43,55,67,83,62,60,18,24,412
900842902,36,45,89,85,62,43,10,27,397
900842903,21,44,42,69,57,26,6,11,276
900842904,25,48,54,44,46,24,13,24,278
900842905,13,37,43,41,32,38,10,21,235
900842906,24,33,49,38,39,26,18,27,254
900842907,16,34,36,66,39,24,19,22,256
900842908,21,46,63,89,91,67,26,34,437
900842909,18,41,63,73,68,31,26,15,335
900842910,17,27,44,50,40,34,16,21,249
900842911,31,51,69,72,58,45,22,30,378
900842912,12,20,31,51,33,27,13,13,200
900842913,38,39,68,84,45,41,18,27,360
900842914,64,91,129,126,94,61,24,37,626
900842915,22,24,47,61,43,54,12,30,293
900842916,15,21,46,42,31,24,5,18,202
900843001,17,36,64,77,65,33,10,18,320
900843002,32,39,49,60,62,39,14,14,309
900843003,23,52,65,78,64,44,14,17,357
900843004,21,33,48,49,40,29,7,4,231
900843005,15,45,53,64,34,23,9,9,252
900843006,12,31,39,44,30,26,12,11,205
900843007,14,29,77,77,62,35,19,33,346
900843008,16,33,47,64,47,22,16,21,266
900843009,17,22,45,67,56,34,30,28,299
900843010,10,24,42,57,43,42,17,36,271
900843011,21,37,77,82,65,53,13,14,362
900843012,28,42,58,84,75,44,23,21,375
900843013,25,47,71,86,85,54,20,14,402
900843014,19,34,60,90,60,36,15,15,329
900843015,27,40,73,116,87,61,16,15,435
900843016,36,34,51,77,59,45,20,27,349
900843017,6,19,42,63,41,18,6,3,198
900843018,33,69,67,112,84,52,29,27,473
900843019,8,17,21,31,27,10,1,2,117
900910101,44,65,77,83,69,52,26,31,447
900910102,42,67,79,79,51,40,15,13,386
900910103,41,56,81,83,53,24,15,24,377
900910104,48,49,83,83,58,37,18,9,385
900910105,27,52,52,64,46,23,19,10,293
900910106,30,47,42,44,39,23,10,14,249
900910201,22,20,22,26,24,25,7,15,161
900910202,16,18,16,12,7,6,5,7,87
900910203,9,20,32,27,17,16,8,15,144
900910204,24,30,42,43,28,35,6,8,216
900910205,12,21,22,23,15,12,3,4,112
900910206,15,8,16,7,17,10,5,10,88
900910207,23,34,32,21,23,17,6,12,168
900910208,24,23,23,29,23,13,5,12,152
900910209,30,22,18,17,15,8,6,10,126
900910301,12,9,7,12,19,5,8,4,76
900910302,24,30,27,34,18,18,10,9,170
900910303,14,15,25,31,23,14,6,14,142
900910304,16,31,21,32,27,17,3,20,167
900910305,14,28,27,21,25,11,11,15,152
900910306,24,30,34,22,19,11,6,13,159
900910307,10,19,24,16,14,11,8,4,106
900910308,4,6,8,14,7,6,0,1,46
900910401,4,4,9,3,3,4,4,9,40
900910402,18,10,17,19,13,9,4,7,97
900910403,10,22,17,20,18,15,3,13,118
900910404,9,12,18,16,7,10,6,9,87
900910405,17,25,23,22,9,13,6,5,120
900910406,7,7,9,8,6,7,3,1,48
900910501,11,26,38,29,15,12,7,16,154
900910502,13,14,24,17,15,17,5,7,112
900910503,16,24,22,20,20,13,3,4,122
900910504,8,7,6,4,5,4,1,2,37
900910601,3,2,5,6,1,5,1,3,26
900910602,27,21,16,28,13,15,5,7,132
900910603,10,25,13,11,5,6,4,1,75
900910604,11,5,6,8,2,2,4,4,42
900910605,2,3,3,9,3,4,1,0,25
900910606,6,6,3,5,1,3,3,3,30
900910607,23,21,24,21,14,4,4,6,117
900910701,17,35,25,42,30,19,6,21,195
900910702,29,31,33,31,22,16,7,17,186
900910703,6,6,9,7,10,11,3,6,58
900910704,11,20,12,15,6,7,4,5,80
900910801,6,6,4,4,5,6,0,3,34
900910802,3,4,2,5,5,3,1,0,23
900910803,14,14,9,11,15,3,2,3,71
900910804,19,23,19,9,14,6,0,5,95
900910805,14,6,10,10,3,5,5,3,56
900910806,11,13,8,6,4,7,0,0,49
900910807,6,5,0,2,2,1,1,0,17
900910808,18,24,20,18,19,17,5,11,132
900910809,33,36,46,37,19,27,9,17,224
900910901,9,5,13,12,3,8,4,6,60
900910902,8,8,11,12,14,11,4,8,76
900910903,10,15,15,10,13,5,4,4,76
900910904,8,2,7,3,2,3,0,1,26
900911001,10,13,15,11,12,4,2,0,67
900911002,5,4,5,12,7,0,6,6,45
900911003,19,15,25,21,11,10,9,6,116
900911004,5,3,8,10,3,3,1,4,37
900911101,10,12,10,6,10,4,2,2,56
900911102,5,4,4,7,4,1,1,0,26
900911103,8,9,12,6,5,5,4,5,54
900911104,10,10,5,11,6,6,1,6,55
900911201,22,13,18,12,8,5,8,16,102
900911202,7,10,10,8,10,3,4,3,55
900911203,3,2,2,2,2,1,0,1,13
900980101,37,17,17,15,12,15,9,9,131
900980102,13,8,9,6,3,8,4,6,57
900980103,9,7,3,2,0,1,0,1,23
900980104,27,17,9,5,9,5,3,1,76
900980105,23,14,8,5,6,8,1,3,68
900980106,39,25,31,38,17,15,2,11,178
900980107,4,4,0,2,1,0,0,1,12
900980108,0,0,0,0,0,0,0,0,0
900980201,3,4,1,0,2,0,0,2,12
900980202,3,1,0,0,0,0,0,0,4
900980203,1,4,1,1,3,1,1,2,14
900980301,4,3,1,0,2,0,0,1,11
900980302,1,1,2,2,0,0,0,1,7
900980303,1,4,1,1,0,1,2,2,12
900980304,21,12,15,8,8,13,5,8,90
900980305,5,4,4,7,4,1,0,5,30
900980306,0,0,0,0,0,0,0,0,0
900980307,3,0,1,0,0,1,0,0,5
900980308,32,43,37,42,27,20,12,12,225
900980309,19,29,15,16,10,10,5,5,109
900980310,38,35,25,32,22,16,8,11,187
900980311,49,31,31,21,20,9,5,13,179
900980401,34,27,35,29,19,16,7,14,181
900980402,41,37,42,37,28,27,15,18,245
900980403,2,1,2,1,3,0,0,1,10
900980404,3,1,1,0,0,0,0,0,5
900980405,21,23,31,16,15,14,7,15,142
900980406,21,39,33,29,29,9,5,6,171
900980407,14,18,15,11,11,4,4,3,80
900980408,24,29,33,47,24,18,7,16,198
900980409,29,17,14,20,12,8,3,9,112
900980410,15,15,21,19,11,3,2,5,91
900980411,12,10,18,14,9,4,3,4,74
900980412,32,26,26,18,21,12,6,10,151
900980413,16,14,16,14,13,9,6,7,95
900980414,29,29,25,25,17,14,4,12,155
900980415,28,47,49,48,31,28,9,25,265
900980416,38,37,43,33,18,16,8,10,203
900980417,16,10,20,12,16,10,6,4,94
900980418,18,16,17,17,19,10,5,7,109
900980419,4,4,1,5,4,2,3,1,24
900980420,22,28,24,17,20,14,4,8,137
901050101,3,3,2,2,1,4,0,7,22
901050102,1,2,0,3,2,4,2,4,18
901050103,7,7,4,3,3,2,1,5,32
901050104,3,2,2,0,2,2,2,0,13
901050201,4,2,1,4,4,5,3,8,31
901050202,4,2,1,1,1,2,0,0,11
901050203,9,7,14,1,7,4,4,12,58
901050204,19,29,25,21,25,9,4,18,150
901050205,25,33,40,21,22,19,8,10,178
901050206,6,8,13,16,13,5,4,16,81
901050207,5,3,10,8,4,8,4,6,48
901050208,23,21,29,33,24,20,9,22,181
901050301,7,0,1,2,1,0,1,0,12
901050302,10,20,15,23,15,18,11,13,125
901050401,26,18,21,15,5,10,3,4,102
901050402,25,27,37,45,22,20,10,21,207
901050501,14,12,26,28,21,19,17,9,146
901050502,5,5,5,4,0,4,2,2,27
901050503,26,24,45,42,26,33,8,19,223
901050504,40,62,73,100,59,57,26,40,457
901050505,24,32,37,33,21,8,9,9,173
901050506,26,55,54,69,44,26,14,9,297
901050601,24,22,30,47,32,12,8,13,188
901050602,21,29,38,49,37,34,16,24,248
901050603,19,53,70,86,79,45,14,13,379
901050604,21,52,59,73,56,37,21,6,325
901050605,23,32,49,91,50,45,14,13,317
901050606,8,27,38,51,39,38,22,7,230
901050607,10,21,41,30,24,21,11,8,166
901050608,7,14,27,28,23,17,7,9,132
901050609,22,36,55,51,40,32,9,16,261
901050610,18,27,43,44,41,38,8,11,230
901050611,11,30,54,74,61,39,15,15,299
901050612,18,23,44,59,48,35,17,31,275
901050613,14,33,37,45,41,27,8,21,226
901050614,4,17,25,25,21,7,9,10,118
901050615,19,30,47,54,46,15,13,12,236
901050616,20,28,42,45,33,15,11,11,205
901050617,14,41,41,39,25,28,11,13,212
901050618,16,27,36,61,46,29,11,14,240
901050619,19,32,33,50,45,19,14,9,221
901050620,19,31,64,64,66,32,14,20,310
901050621,24,47,66,88,86,49,26,41,427
901050622,3,13,23,44,22,11,6,1,123
901050623,24,63,88,108,56,57,14,16,426
901050624,8,13,19,25,17,11,8,10,111
901050625,13,28,42,63,53,13,6,2,220
901050701,43,60,77,120,89,55,30,37,511
901050702,21,36,41,48,48,31,11,16,252
901050703,15,31,38,30,26,6,5,4,155
901050704,9,22,34,47,64,49,23,30,278
901050705,21,36,32,39,39,27,10,11,215
901050706,25,57,40,47,45,38,17,17,286
901050707,16,21,28,34,28,12,3,2,144
901050708,20,38,42,40,36,29,24,26,255
901050709,18,34,46,60,43,36,14,22,273
901050710,6,15,32,35,46,41,13,19,207
901050711,25,60,83,98,66,39,8,6,385
901050712,21,40,69,119,84,49,10,15,407
901050713,21,43,62,60,41,10,2,4,243
901050714,23,44,49,62,42,27,3,4,254
901050715,12,24,42,34,21,12,2,6,153
901050716,0,0,0,0,0,0,0,0,0
901050717,3,0,0,0,0,0,0,0,3
901050718,5,2,6,9,2,0,1,0,25
901050801,3,6,9,18,11,13,5,7,72
901050802,42,65,78,86,52,43,26,22,414
901050803,51,47,70,64,40,33,19,16,340
901050804,27,45,58,71,57,46,12,32,348
901050805,27,46,70,71,62,43,16,28,363
901050806,19,33,37,48,48,25,17,17,244
901050807,42,65,48,67,48,12,17,14,313
901050808,47,66,83,106,88,40,16,31,477
901050809,19,38,63,69,49,41,13,14,306
901050810,17,42,49,52,48,39,17,28,292
901050811,21,51,72,81,68,22,9,9,333
901050812,42,68,94,57,58,35,10,10,374
901050813,48,71,73,59,58,33,10,9,361
901050814,41,52,65,62,40,32,13,20,325
901050815,17,23,37,47,37,23,20,15,219
901050816,24,42,37,47,44,26,7,14,241
901050817,18,37,48,60,26,36,9,18,252
901050901,2,1,3,2,1,2,1,3,15
901050902,26,49,62,67,51,27,10,11,303
901050903,38,56,93,103,75,64,21,27,477
901050904,49,56,59,78,57,37,9,22,367
901050905,18,46,64,76,47,49,13,10,323
901050906,42,70,72,85,53,43,16,13,394
901050907,39,62,65,53,45,23,10,9,306
901050908,27,52,57,65,40,20,8,11,280
901050909,49,54,40,54,43,21,9,6,276
901050910,26,40,28,26,17,7,1,2,147
901050911,31,44,34,39,21,12,4,1,186
901050912,31,74,58,71,64,25,13,11,347
901050913,26,54,59,78,65,44,10,20,356
901050914,38,57,60,78,51,32,7,16,339
901050915,35,62,67,53,27,21,7,5,277
901050916,7,28,37,37,37,34,23,26,229
901050917,12,27,30,44,31,15,4,3,166
901051001,39,65,74,63,53,26,9,11,340
901051002,15,20,38,47,32,39,10,17,218
901051003,16,35,54,61,52,46,12,21,297
901051004,27,51,73,85,65,43,29,39,412
901051005,25,66,108,92,78,50,10,11,440
901051006,25,37,56,78,65,40,11,8,320
901051007,28,38,61,65,52,26,7,13,290
901051008,10,12,16,26,17,19,4,6,110
901051009,24,47,72,119,83,46,7,18,416
901051010,18,41,57,77,56,40,17,18,324
901051011,15,24,61,47,39,33,21,13,253
901051012,24,44,40,52,33,24,16,12,245
901051013,41,46,49,48,31,23,14,10,262
901051014,0,2,0,1,0,0,0,1,4
901051015,32,39,60,70,48,50,9,12,320
901051016,15,38,61,45,50,37,10,14,270
901051017,38,57,84,92,72,51,14,22,430
901051018,18,62,89,80,70,48,14,27,408
901051019,12,15,34,48,39,24,12,11,195
901051020,12,30,30,36,24,22,6,7,167
901051021,33,63,62,60,45,38,8,21,330
901051022,25,38,41,61,42,36,14,16,273
901051023,26,40,64,63,46,37,12,14,302
901051024,13,29,67,58,66,34,30,24,321
901120101,4,1,3,0,1,0,1,1,11
901120102,14,11,5,3,3,1,3,1,41
901120103,7,5,8,4,5,7,2,3,41
901120104,5,2,1,4,8,3,0,1,24
901120105,20,12,10,2,5,5,2,3,59
901120106,6,2,2,3,4,1,1,2,21
901120107,6,5,1,1,1,1,0,1,16
901120108,17,13,4,7,4,6,3,1,55
901120109,14,19,18,24,22,13,9,5,124
901120110,26,28,28,22,13,12,5,8,142
901120111,36,30,23,31,15,9,5,3,152
901120112,18,22,11,8,8,5,3,7,82
901120113,25,14,20,9,10,6,1,8,93
901120114,20,20,24,20,11,10,3,4,112
901120115,23,22,16,30,19,13,8,12,143
901120116,8,6,13,20,21,5,6,6,85
901120201,11,2,5,1,0,1,0,7,27
901120202,8,3,2,2,1,2,1,0,19
901120203,17,10,17,20,11,9,5,3,92
901120204,17,9,10,8,8,4,1,11,68
901120205,43,44,35,30,28,28,8,31,247
901120206,19,9,12,7,5,1,2,2,57
901120207,9,4,7,4,4,2,1,3,34
901120208,8,4,5,2,0,0,0,1,20
901120209,9,14,5,13,11,4,1,1,58
901120210,36,37,48,63,44,40,20,38,326
901120211,3,0,1,0,0,1,0,0,5
901120212,4,5,3,6,1,1,1,2,23
901120213,59,71,74,78,52,47,18,17,416
901120214,37,41,49,71,44,28,15,14,299
901120215,23,32,27,25,30,13,6,6,162
901120216,11,27,54,64,46,30,10,15,257
901120301,15,13,8,9,3,4,3,7,62
901120302,28,28,41,35,34,24,12,26,228
901120303,12,22,24,22,15,10,8,10,123
901120304,7,3,5,4,4,0,2,3,28
901120305,4,5,5,5,5,2,2,10,38
901120306,6,5,3,5,3,3,1,10,36
901120307,49,22,26,12,15,5,5,13,147
901120308,16,14,19,21,21,14,4,7,116
901120401,5,5,2,3,1,3,2,3,24
901120402,6,8,1,5,7,9,1,8,45
901120403,12,16,9,12,11,11,5,12,88
901120404,24,18,25,42,29,28,11,18,195
901190101,2,5,0,4,1,2,0,1,15
901190102,0,0,1,0,1,0,1,1,4
901190103,3,9,8,14,4,3,3,2,46
901190201,22,40,42,57,53,52,15,11,292
901190202,15,24,40,52,33,24,6,6,200
901190203,23,20,43,47,34,25,11,8,211
901190204,18,40,65,100,57,31,7,5,323
901190205,18,37,38,45,41,25,11,8,223
901190206,22,45,67,102,57,35,20,21,369
901190207,15,35,26,24,31,19,10,7,167
901190208,15,40,43,53,40,24,14,20,249
901190209,20,39,40,54,44,25,22,25,269
901190210,9,27,29,56,41,21,11,5,199
901190211,24,36,66,69,62,31,12,9,309
901190212,11,41,31,17,26,18,8,5,157
901190213,25,31,42,55,44,28,10,6,241
901190214,7,25,37,72,38,7,0,2,188
901190215,14,28,57,61,54,34,4,7,259
901190216,15,31,38,67,48,20,3,1,223
901190217,15,31,46,70,53,32,9,10,266
901190301,0,0,0,0,0,0,0,1,1
901190302,23,33,36,39,34,18,3,4,190
901190303,13,15,22,31,30,26,5,7,149
901190304,10,22,32,62,44,44,18,11,243
901190305,26,38,35,39,33,15,5,2,193
901190306,16,37,38,59,41,32,20,37,280
901190307,20,44,50,65,39,28,6,10,262
901190308,15,23,41,57,33,19,5,1,194
901190309,26,39,52,41,45,30,4,2,239
901190310,19,31,40,40,45,24,9,2,210
901190311,16,21,33,37,27,26,11,8,179
901190312,17,21,30,46,33,21,3,2,173
901190313,36,74,60,63,64,36,13,9,355
901190314,31,36,53,54,34,24,12,10,254
901190315,13,23,49,58,47,21,9,19,239
901190316,23,26,44,43,37,44,10,11,238
901190317,59,78,77,87,83,36,12,11,443
901190318,22,20,33,35,27,24,9,16,186
901190319,31,46,53,59,47,24,4,7,271
901190401,6,13,33,59,39,38,9,9,206
901190402,23,44,65,57,36,28,19,26,298
901190403,18,40,64,67,59,49,14,22,333
901190404,21,51,74,75,58,38,14,22,353
901190405,17,29,60,66,56,34,28,30,320
901190406,26,44,63,106,91,30,4,2,366
901190407,22,41,66,87,81,63,26,37,423
901190408,15,43,48,68,65,44,21,32,336
901190409,33,43,73,103,72,61,23,32,440
901190410,34,51,55,55,39,18,3,4,259
901190411,33,42,43,64,33,25,8,9,257
901190412,8,19,43,52,45,16,6,9,198
901190413,19,39,35,41,45,22,4,5,210
901190414,19,40,43,36,47,14,6,6,211
901190415,9,18,27,35,26,15,1,4,135
901190416,9,17,21,33,21,10,6,2,119
901190417,32,71,76,51,35,21,7,5,298
901190418,13,33,39,46,38,14,6,6,195
901190419,27,61,65,65,58,31,13,12,332
901190420,20,41,46,55,45,32,18,13,270
901190421,19,25,38,36,30,25,6,2,181
901190501,0,3,2,2,0,0,0,0,7
901190502,18,48,35,40,40,39,6,9,235
901190503,29,35,50,54,40,29,14,15,266
901190504,24,35,28,40,39,27,14,15,222
901190505,19,31,41,56,36,22,7,2,214
901190506,17,26,41,29,35,19,6,3,176
901190507,23,67,54,86,76,43,17,12,378
901190508,20,59,78,71,66,41,15,19,369
901190509,22,45,54,76,70,37,7,7,318
901190510,26,46,46,55,44,20,9,6,252
901190511,11,12,18,32,43,47,7,8,178
901190512,41,54,63,85,65,31,15,21,375
901190513,36,54,64,83,75,65,14,11,402
901190514,21,37,58,67,68,37,12,22,322
901190515,22,36,48,73,46,35,14,7,281
901190516,26,46,48,86,69,25,7,9,316
940070101,0,0,4,1,1,2,0,0,8
940070201,5,2,2,1,2,0,0,0,12
940070301,1,2,6,3,2,0,1,1,16
940070401,4,2,4,3,3,0,0,1,17
940070501,3,2,0,0,2,1,0,0,8
940070502,27,40,21,34,9,9,7,3,150
940070503,46,54,53,60,38,29,6,8,294
940070504,39,55,46,39,19,15,8,7,228
940070505,35,31,37,36,22,15,9,3,188
940070601,9,13,2,3,2,1,0,1,31
940070701,19,5,2,2,0,0,0,0,28
940070801,4,2,4,2,1,0,0,1,14
940071001,45,98,92,92,51,20,8,1,407
940071002,19,28,33,25,9,1,4,0,119
940071003,33,61,76,91,47,25,16,6,355
940071004,43,62,65,67,42,32,11,12,334
940071005,24,62,67,55,48,30,10,7,303
940071006,48,63,84,67,39,15,12,8,336
940071007,35,79,75,80,32,16,7,13,337
940071008,25,71,60,58,33,16,10,6,279
940071009,29,52,74,71,35,17,6,8,292
940071010,36,47,65,70,29,27,10,3,287
940071011,35,73,72,66,36,24,9,11,326
940071012,33,57,64,47,41,21,7,9,279
940071013,40,60,73,52,27,20,11,7,290
940071101,58,93,63,58,27,4,2,3,308
940071102,50,74,72,63,29,13,4,3,308
940071103,85,87,77,58,28,7,2,4,348
940071104,85,103,100,83,49,21,9,3,453
940071105,53,71,78,54,27,12,1,2,298
940071106,66,73,63,58,27,7,7,2,303
940071107,63,63,35,28,10,7,3,1,210
940071108,41,36,27,35,18,6,3,4,170
940071109,66,97,46,36,18,12,3,2,280
940071110,50,51,56,34,24,9,6,1,231
940071111,43,51,90,60,36,20,8,5,313
940071112,65,90,60,57,35,17,2,3,329
940071113,57,109,69,71,28,12,5,7,358
940071201,63,74,48,39,16,8,1,0,249
940071202,45,68,67,49,30,11,3,1,274
940071203,53,41,33,41,18,7,2,2,197
940071204,49,66,72,80,39,24,7,2,339
940071205,31,57,66,79,48,26,13,16,336
940071206,61,52,64,78,50,16,14,7,342
940071207,26,57,71,68,39,24,5,6,296
940071208,34,50,54,74,45,26,14,10,307
940071209,55,70,85,76,32,13,3,2,336
940071210,73,67,68,46,43,16,7,1,321
940071211,49,64,49,36,17,11,3,3,232
940071212,84,72,66,51,25,22,2,5,327
940071213,67,97,63,44,25,12,2,2,312
940071301,56,62,67,57,40,22,6,4,314
940071302,69,74,67,60,53,17,1,2,343
940071303,46,67,71,77,39,25,9,4,338
940071304,51,60,64,70,36,25,9,3,318
940071305,96,69,53,68,31,18,10,3,348
940071306,11,20,26,16,17,12,2,2,106
940071307,57,67,79,76,43,22,4,4,352
940071308,34,41,36,68,36,16,11,3,245
940071309,42,54,51,55,33,20,7,5,267
940071310,43,35,38,37,17,15,3,7,195
940071311,51,76,69,60,28,20,3,4,311
940071312,50,61,63,55,38,14,4,8,293
940071313,46,64,70,56,38,27,6,13,320
940071314,45,43,41,38,21,7,1,2,198
940071401,37,59,42,66,53,37,12,5,311
940071402,54,67,58,75,54,54,7,7,376
940071403,41,57,64,72,61,33,8,16,352
940071404,35,57,52,66,42,28,7,6,293
940071405,59,77,75,68,34,16,5,11,345
940071406,46,67,61,54,26,13,2,2,271
940071407,72,81,81,51,25,23,10,3,346
940071408,44,71,74,66,30,13,6,8,312
940071409,52,57,61,70,34,42,14,8,338
940071410,36,63,69,51,30,26,7,6,288
940071411,46,51,72,60,36,14,3,9,291
940071412,86,62,78,71,36,19,3,3,358
940071413,73,41,64,31,27,15,3,4,258
940071414,64,48,68,40,28,24,6,7,285
940071415,31,41,41,47,32,22,8,5,227
940071416,27,20,15,18,7,4,2,3,96
940140101,3,1,0,1,0,0,0,0,5
940140102,19,5,10,10,7,0,1,1,53
940140103,23,7,5,2,4,0,0,0,41
940140201,0,0,0,0,0,0,0,0,0
940140202,5,0,0,0,0,0,0,0,5
940140301,1,0,0,0,0,0,0,0,1
940140302,3,3,4,4,0,0,0,0,14
940140401,31,29,36,30,20,2,0,0,148
940140402,48,55,51,50,29,6,2,3,244
940140403,34,26,34,27,10,4,1,1,137
940140404,27,18,23,19,10,3,2,0,102
940140405,37,32,29,28,16,8,0,1,151
940140406,49,52,40,54,18,7,1,1,222
940140407,71,54,52,50,37,11,8,11,294
940140408,17,23,31,36,15,8,3,3,136
940140409,46,67,72,79,36,15,1,3,319
940140410,27,63,55,51,17,8,4,3,228
940140411,40,43,65,44,33,15,9,6,255
940140412,43,59,65,52,32,13,5,5,274
940140413,61,50,76,67,41,13,9,9,326
940140414,63,58,86,74,39,27,7,8,362
940140415,40,51,71,66,35,17,10,6,296
940140416,40,61,61,68,43,29,8,8,318
940140501,42,57,44,38,25,9,3,2,220
940140502,62,100,56,40,18,8,2,1,287
940140503,56,84,65,53,27,12,1,2,300
940140504,15,28,23,21,8,5,2,1,103
940140505,96,77,36,35,16,8,2,0,270
940140506,63,44,30,20,7,3,1,0,168
940140507,59,77,18,18,5,3,2,0,182
940140508,79,81,58,30,12,10,3,4,277
940140509,78,100,90,68,31,22,3,6,398
940140510,65,74,52,26,9,10,1,3,240
940140511,47,41,48,40,14,15,7,2,214
940140601,36,45,43,47,24,11,2,2,210
940140602,69,84,83,73,39,13,4,6,371
940140603,50,62,51,68,40,18,4,6,299
940140604,19,35,49,74,62,24,8,11,282
940140605,93,96,75,59,26,9,10,5,373
940140606,69,65,59,51,24,7,6,3,284
940140607,39,65,67,68,38,12,5,6,300
940140608,58,67,75,45,27,10,4,7,293
940140609,51,70,67,67,39,19,13,7,333
940140610,72,78,74,67,34,12,10,2,349
940140611,64,65,70,76,49,19,3,1,347
940140612,45,45,60,77,46,17,16,6,312
940140701,37,36,36,35,14,10,2,2,172
940140702,53,62,51,39,41,15,7,4,272
940140703,60,68,65,66,39,12,8,2,320
940140704,41,66,71,57,39,14,2,5,295
940140705,35,53,86,82,36,9,4,1,306
940140706,33,28,26,31,19,3,1,1,142
940140707,32,63,74,75,40,21,7,7,319
940140708,33,44,65,50,28,12,6,10,248
940140709,11,35,27,26,9,14,5,3,130
940140710,12,20,23,13,22,6,7,4,107
940140711,55,71,86,78,45,25,2,8,370
940140712,61,74,80,56,43,16,6,7,343
940140713,53,57,72,72,34,12,2,5,307
940140714,45,66,79,88,52,34,14,13,391
940140801,9,17,17,14,7,4,0,0,68
940140802,63,56,44,33,7,5,3,1,212
940140803,21,24,14,13,11,5,1,0,89
940140804,17,50,65,52,24,8,2,2,220
940140805,54,71,65,45,23,12,0,3,273
940140806,58,87,77,79,37,18,4,6,366
940140807,57,57,61,43,23,14,6,7,268
940140808,103,74,75,64,37,9,3,3,368
940140809,48,59,49,53,19,14,5,1,248
940140810,97,102,88,78,40,19,8,7,439
940140811,60,83,59,66,18,15,5,3,309
940140812,35,75,74,57,33,12,5,3,294
940140813,48,56,66,71,46,24,6,2,319
940210101,0,0,0,0,0,0,0,0,0
940280101,0,1,2,3,1,0,1,0,8